ID,Year,M,D,H,1,2,sum,sump
3405-000,2013,12,12,1,72,88,160,0
3405-000,2013,12,12,2,56,70,126,160
3405-000,2013,12,12,3,40,52,92,126
3405-000,2013,12,12,4,44,50,94,92
3405-000,2013,12,12,5,73,80,153,94
3405-000,2013,12,12,6,144,126,270,153
3405-000,2013,12,12,7,323,319,642,270
3405-000,2013,12,12,8,731,872,1603,642
3405-000,2013,12,12,9,922,963,1885,1603
3405-000,2013,12,12,10,796,658,1454,1885
3405-000,2013,12,12,11,817,540,1357,1454
3405-000,2013,12,12,12,835,679,1514,1357
3405-000,2013,12,12,13,631,578,1209,1514
3405-000,2013,12,12,14,804,668,1472,1209
3405-000,2013,12,12,15,788,719,1507,1472
3405-000,2013,12,12,16,747,665,1412,1507
3405-000,2013,12,12,17,691,787,1478,1412
3405-000,2013,12,12,18,671,619,1290,1478
3405-000,2013,12,12,19,647,543,1190,1290
3405-000,2013,12,12,20,435,397,832,1190
3405-000,2013,12,12,21,323,331,654,832
3405-000,2013,12,12,22,238,278,516,654
3405-000,2013,12,12,23,176,176,352,516
3405-000,2013,12,12,24,100,113,213,352
3405-000,2013,12,13,1,69,78,147,213
3405-000,2013,12,13,2,46,71,117,147
3405-000,2013,12,13,3,40,41,81,117
3405-000,2013,12,13,4,44,44,88,81
3405-000,2013,12,13,5,48,49,97,88
3405-000,2013,12,13,6,86,92,178,97
3405-000,2013,12,13,7,235,239,474,178
3405-000,2013,12,13,8,633,738,1371,474
3405-000,2013,12,13,9,897,865,1762,1371
3405-000,2013,12,13,10,775,640,1415,1762
3405-000,2013,12,13,11,776,700,1476,1415
3405-000,2013,12,13,12,812,742,1554,1476
3405-000,2013,12,13,13,716,609,1325,1554
3405-000,2013,12,13,14,784,727,1511,1325
3405-000,2013,12,13,15,840,812,1652,1511
3405-000,2013,12,13,16,906,787,1693,1652
3405-000,2013,12,13,17,954,738,1692,1693
3405-000,2013,12,13,18,1000,785,1785,1692
3405-000,2013,12,13,19,968,714,1682,1785
3405-000,2013,12,13,20,651,496,1147,1682
3405-000,2013,12,13,21,467,392,859,1147
3405-000,2013,12,13,22,310,286,596,859
3405-000,2013,12,13,23,203,185,388,596
3405-000,2013,12,13,24,131,116,247,388
3405-000,2013,12,14,1,72,91,163,247
3405-000,2013,12,14,2,67,66,133,163
3405-000,2013,12,14,3,54,53,107,133
3405-000,2013,12,14,4,38,51,89,107
3405-000,2013,12,14,5,55,67,122,89
3405-000,2013,12,14,6,90,102,192,122
3405-000,2013,12,14,7,191,141,332,192
3405-000,2013,12,14,8,475,344,819,332
3405-000,2013,12,14,9,597,493,1090,819
3405-000,2013,12,14,10,644,434,1078,1090
3405-000,2013,12,14,11,691,518,1209,1078
3405-000,2013,12,14,12,810,523,1333,1209
3405-000,2013,12,14,13,621,545,1166,1333
3405-000,2013,12,14,14,615,496,1111,1166
3405-000,2013,12,14,15,657,548,1205,1111
3405-000,2013,12,14,16,650,520,1170,1205
3405-000,2013,12,14,17,644,513,1157,1170
3405-000,2013,12,14,18,664,619,1283,1157
3405-000,2013,12,14,19,449,430,879,1283
3405-000,2013,12,14,20,311,300,611,879
3405-000,2013,12,14,21,203,206,409,611
3405-000,2013,12,14,22,183,170,353,409
3405-000,2013,12,14,23,126,151,277,353
3405-000,2013,12,14,24,109,119,228,277
3405-000,2013,12,15,1,84,89,173,228
3405-000,2013,12,15,2,53,61,114,173
3405-000,2013,12,15,3,39,36,75,114
3405-000,2013,12,15,4,34,39,73,75
3405-000,2013,12,15,5,31,39,70,73
3405-000,2013,12,15,6,58,62,120,70
3405-000,2013,12,15,7,125,109,234,120
3405-000,2013,12,15,8,206,184,390,234
3405-000,2013,12,15,9,272,216,488,390
3405-000,2013,12,15,10,348,240,588,488
3405-000,2013,12,15,11,363,297,660,588
3405-000,2013,12,15,12,381,381,762,660
3405-000,2013,12,15,13,341,392,733,762
3405-000,2013,12,15,14,382,392,774,733
3405-000,2013,12,15,15,471,418,889,774
3405-000,2013,12,15,16,434,507,941,889
3405-000,2013,12,15,17,442,458,900,941
3405-000,2013,12,15,18,429,472,901,900
3405-000,2013,12,15,19,323,358,681,901
3405-000,2013,12,15,20,243,297,540,681
3405-000,2013,12,15,21,199,253,452,540
3405-000,2013,12,15,22,180,226,406,452
3405-000,2013,12,15,23,129,174,303,406
3405-000,2013,12,15,24,95,139,234,303
3405-000,2013,12,16,1,62,90,152,234
3405-000,2013,12,16,2,24,63,87,152
3405-000,2013,12,16,3,21,43,64,87
3405-000,2013,12,16,4,42,58,100,64
3405-000,2013,12,16,5,53,73,126,100
3405-000,2013,12,16,6,149,155,304,126
3405-000,2013,12,16,7,372,393,765,304
3405-000,2013,12,16,8,827,1105,1932,765
3405-000,2013,12,16,9,1007,1140,2147,1932
3405-000,2013,12,16,10,807,702,1509,2147
3405-000,2013,12,16,11,838,715,1553,1509
3405-000,2013,12,16,12,784,716,1500,1553
3405-000,2013,12,16,13,681,661,1342,1500
3405-000,2013,12,16,14,785,787,1572,1342
3405-000,2013,12,16,15,866,863,1729,1572
3405-000,2013,12,16,16,882,870,1752,1729
3405-000,2013,12,16,17,909,740,1649,1752
3405-000,2013,12,16,18,1055,828,1883,1649
3405-000,2013,12,16,19,819,701,1520,1883
3405-000,2013,12,16,20,568,484,1052,1520
3405-000,2013,12,16,21,432,428,860,1052
3405-000,2013,12,16,22,299,326,625,860
3405-000,2013,12,16,23,200,205,405,625
3405-000,2013,12,16,24,149,148,297,405
3405-000,2013,12,17,1,82,105,187,297
3405-000,2013,12,17,2,61,80,141,187
3405-000,2013,12,17,3,37,65,102,141
3405-000,2013,12,17,4,54,67,121,102
3405-000,2013,12,17,5,67,82,149,121
3405-000,2013,12,17,6,174,151,325,149
3405-000,2013,12,17,7,337,334,671,325
3405-000,2013,12,17,8,815,894,1709,671
3405-000,2013,12,17,9,1001,1035,2036,1709
3405-000,2013,12,17,10,882,799,1681,2036
3405-000,2013,12,17,11,950,803,1753,1681
3405-000,2013,12,17,12,810,778,1588,1753
3405-000,2013,12,17,13,731,662,1393,1588
3405-000,2013,12,17,14,796,858,1654,1393
3405-000,2013,12,17,15,908,902,1810,1654
3405-000,2013,12,17,16,940,832,1772,1810
3405-000,2013,12,17,17,901,765,1666,1772
3405-000,2013,12,17,18,932,801,1733,1666
3405-000,2013,12,17,19,852,693,1545,1733
3405-000,2013,12,17,20,555,457,1012,1545
3405-000,2013,12,17,21,413,406,819,1012
3405-000,2013,12,17,22,322,298,620,819
3405-000,2013,12,17,23,193,211,404,620
3405-000,2013,12,17,24,132,143,275,404
3405-000,2013,12,18,1,79,96,175,275
3405-000,2013,12,18,2,49,82,131,175
3405-000,2013,12,18,3,51,53,104,131
3405-000,2013,12,18,4,57,57,114,104
3405-000,2013,12,18,5,72,77,149,114
3405-000,2013,12,18,6,158,155,313,149
3405-000,2013,12,18,7,345,307,652,313
3405-000,2013,12,18,8,817,944,1761,652
3405-000,2013,12,18,9,970,1025,1995,1761
3405-000,2013,12,18,10,904,792,1696,1995
3405-000,2013,12,18,11,949,823,1772,1696
3405-000,2013,12,18,12,813,754,1567,1772
3405-000,2013,12,18,13,681,661,1342,1567
3405-000,2013,12,18,14,766,773,1539,1342
3405-000,2013,12,18,15,914,890,1804,1539
3405-000,2013,12,18,16,927,826,1753,1804
3405-000,2013,12,18,17,925,788,1713,1753
3405-000,2013,12,18,18,956,810,1766,1713
3405-000,2013,12,18,19,873,749,1622,1766
3405-000,2013,12,18,20,532,465,997,1622
3405-000,2013,12,18,21,457,395,852,997
3405-000,2013,12,18,22,303,281,584,852
3405-000,2013,12,18,23,246,185,431,584
3405-000,2013,12,18,24,158,136,294,431
3405-000,2013,12,19,1,89,100,189,294
3405-000,2013,12,19,2,66,80,146,189
3405-000,2013,12,19,3,53,66,119,146
3405-000,2013,12,19,4,55,49,104,119
3405-000,2013,12,19,5,72,81,153,104
3405-000,2013,12,19,6,135,110,245,153
3405-000,2013,12,19,7,302,266,568,245
3405-000,2013,12,19,8,686,726,1412,568
3405-000,2013,12,19,9,886,883,1769,1412
3405-000,2013,12,19,10,734,601,1335,1769
3405-000,2013,12,19,11,772,666,1438,1335
3405-000,2013,12,19,12,789,745,1534,1438
3405-000,2013,12,19,13,745,620,1365,1534
3405-000,2013,12,19,14,925,588,1513,1365
3405-000,2013,12,19,15,900,651,1551,1513
3405-000,2013,12,19,16,819,603,1422,1551
3405-000,2013,12,19,17,727,591,1318,1422
3405-000,2013,12,19,18,592,503,1095,1318
3405-000,2013,12,19,19,668,502,1170,1095
3405-000,2013,12,19,20,633,475,1108,1170
3405-000,2013,12,19,21,395,301,696,1108
3405-000,2013,12,19,22,262,297,559,696
3405-000,2013,12,19,23,183,188,371,559
3405-000,2013,12,19,24,86,89,175,371
3405-000,2013,12,20,1,60,60,120,175
3405-000,2013,12,20,2,26,39,65,120
3405-000,2013,12,20,3,37,39,76,65
3405-000,2013,12,20,4,29,43,72,76
3405-000,2013,12,20,5,42,46,88,72
3405-000,2013,12,20,6,116,107,223,88
3405-000,2013,12,20,7,243,167,410,223
3405-000,2013,12,20,8,437,476,913,410
3405-000,2013,12,20,9,640,655,1295,913
3405-000,2013,12,20,10,607,534,1141,1295
3405-000,2013,12,20,11,712,564,1276,1141
3405-000,2013,12,20,12,754,544,1298,1276
3405-000,2013,12,20,13,647,538,1185,1298
3405-000,2013,12,20,14,686,658,1344,1185
3405-000,2013,12,20,15,822,709,1531,1344
3405-000,2013,12,20,16,837,729,1566,1531
3405-000,2013,12,20,17,888,666,1554,1566
3405-000,2013,12,20,18,991,753,1744,1554
3405-000,2013,12,20,19,1055,672,1727,1744
3405-000,2013,12,20,20,586,452,1038,1727
3405-000,2013,12,20,21,406,362,768,1038
3405-000,2013,12,20,22,254,243,497,768
3405-000,2013,12,20,23,206,152,358,497
3405-000,2013,12,20,24,126,125,251,358
3405-000,2013,12,21,1,100,77,177,251
3405-000,2013,12,21,2,57,60,117,177
3405-000,2013,12,21,3,62,50,112,117
3405-000,2013,12,21,4,46,51,97,112
3405-000,2013,12,21,5,59,77,136,97
3405-000,2013,12,21,6,122,92,214,136
3405-000,2013,12,21,7,213,184,397,214
3405-000,2013,12,21,8,449,323,772,397
3405-000,2013,12,21,9,592,430,1022,772
3405-000,2013,12,21,10,652,474,1126,1022
3405-000,2013,12,21,11,789,485,1274,1126
3405-000,2013,12,21,12,818,523,1341,1274
3405-000,2013,12,21,13,752,498,1250,1341
3405-000,2013,12,21,14,576,482,1058,1250
3405-000,2013,12,21,15,612,488,1100,1058
3405-000,2013,12,21,16,613,557,1170,1100
3405-000,2013,12,21,17,622,529,1151,1170
3405-000,2013,12,21,18,640,596,1236,1151
3405-000,2013,12,21,19,479,442,921,1236
3405-000,2013,12,21,20,298,291,589,921
3405-000,2013,12,21,21,226,218,444,589
3405-000,2013,12,21,22,186,206,392,444
3405-000,2013,12,21,23,150,141,291,392
3405-000,2013,12,21,24,100,90,190,291
3405-000,2013,12,22,1,60,75,135,190
3405-000,2013,12,22,2,43,43,86,135
3405-000,2013,12,22,3,26,25,51,86
3405-000,2013,12,22,4,29,33,62,51
3405-000,2013,12,22,5,42,30,72,62
3405-000,2013,12,22,6,54,52,106,72
3405-000,2013,12,22,7,113,95,208,106
3405-000,2013,12,22,8,198,142,340,208
3405-000,2013,12,22,9,275,216,491,340
3405-000,2013,12,22,10,296,230,526,491
3405-000,2013,12,22,11,363,290,653,526
3405-000,2013,12,22,12,399,321,720,653
3405-000,2013,12,22,13,390,366,756,720
3405-000,2013,12,22,14,373,444,817,756
3405-000,2013,12,22,15,438,424,862,817
3405-000,2013,12,22,16,411,487,898,862
3405-000,2013,12,22,17,452,530,982,898
3405-000,2013,12,22,18,395,473,868,982
3405-000,2013,12,22,19,321,417,738,868
3405-000,2013,12,22,20,227,304,531,738
3405-000,2013,12,22,21,202,242,444,531
3405-000,2013,12,22,22,191,199,390,444
3405-000,2013,12,22,23,120,185,305,390
3405-000,2013,12,22,24,84,127,211,305
3405-000,2013,12,23,1,48,86,134,211
3405-000,2013,12,23,2,40,50,90,134
3405-000,2013,12,23,3,24,42,66,90
3405-000,2013,12,23,4,47,64,111,66
3405-000,2013,12,23,5,65,66,131,111
3405-000,2013,12,23,6,132,177,309,131
3405-000,2013,12,23,7,364,433,797,309
3405-000,2013,12,23,8,816,1059,1875,797
3405-000,2013,12,23,9,946,1116,2062,1875
3405-000,2013,12,23,10,841,735,1576,2062
3405-000,2013,12,23,11,911,784,1695,1576
3405-000,2013,12,23,12,863,744,1607,1695
3405-000,2013,12,23,13,688,670,1358,1607
3405-000,2013,12,23,14,795,796,1591,1358
3405-000,2013,12,23,15,890,844,1734,1591
3405-000,2013,12,23,16,863,830,1693,1734
3405-000,2013,12,23,17,934,734,1668,1693
3405-000,2013,12,23,18,891,785,1676,1668
3405-000,2013,12,23,19,844,735,1579,1676
3405-000,2013,12,23,20,569,489,1058,1579
3405-000,2013,12,23,21,436,473,909,1058
3405-000,2013,12,23,22,333,343,676,909
3405-000,2013,12,23,23,223,203,426,676
3405-000,2013,12,23,24,150,130,280,426
3405-000,2013,12,24,1,81,111,192,280
3405-000,2013,12,24,2,49,54,103,192
3405-000,2013,12,24,3,58,60,118,103
3405-000,2013,12,24,4,48,82,130,118
3405-000,2013,12,24,5,74,96,170,130
3405-000,2013,12,24,6,153,138,291,170
3405-000,2013,12,24,7,289,320,609,291
3405-000,2013,12,24,8,769,857,1626,609
3405-000,2013,12,24,9,995,936,1931,1626
3405-000,2013,12,24,10,897,761,1658,1931
3405-000,2013,12,24,11,897,806,1703,1658
3405-000,2013,12,24,12,899,754,1653,1703
3405-000,2013,12,24,13,760,681,1441,1653
3405-000,2013,12,24,14,830,780,1610,1441
3405-000,2013,12,24,15,959,848,1807,1610
3405-000,2013,12,24,16,923,814,1737,1807
3405-000,2013,12,24,17,962,780,1742,1737
3405-000,2013,12,24,18,1234,911,2145,1742
3405-000,2013,12,24,19,1414,878,2292,2145
3405-000,2013,12,24,20,799,578,1377,2292
3405-000,2013,12,24,21,470,409,879,1377
3405-000,2013,12,24,22,335,269,604,879
3405-000,2013,12,24,23,227,189,416,604
3405-000,2013,12,24,24,131,117,248,416
3405-000,2013,12,25,1,118,93,211,248
3405-000,2013,12,25,2,55,66,121,211
3405-000,2013,12,25,3,46,41,87,121
3405-000,2013,12,25,4,34,54,88,87
3405-000,2013,12,25,5,65,63,128,88
3405-000,2013,12,25,6,112,91,203,128
3405-000,2013,12,25,7,181,167,348,203
3405-000,2013,12,25,8,340,261,601,348
3405-000,2013,12,25,9,415,363,778,601
3405-000,2013,12,25,10,452,332,784,778
3405-000,2013,12,25,11,490,418,908,784
3405-000,2013,12,25,12,451,414,865,908
3405-000,2013,12,25,13,404,422,826,865
3405-000,2013,12,25,14,454,462,916,826
3405-000,2013,12,25,15,474,408,882,916
3405-000,2013,12,25,16,526,484,1010,882
3405-000,2013,12,25,17,467,458,925,1010
3405-000,2013,12,25,18,479,473,952,925
3405-000,2013,12,25,19,377,368,745,952
3405-000,2013,12,25,20,267,301,568,745
3405-000,2013,12,25,21,224,266,490,568
3405-000,2013,12,25,22,253,260,513,490
3405-000,2013,12,25,23,169,160,329,513
3405-000,2013,12,25,24,89,115,204,329
3405-000,2013,12,26,1,55,77,132,204
3405-000,2013,12,26,2,46,60,106,132
3405-000,2013,12,26,3,27,38,65,106
3405-000,2013,12,26,4,32,51,83,65
3405-000,2013,12,26,5,74,79,153,83
3405-000,2013,12,26,6,152,143,295,153
3405-000,2013,12,26,7,344,372,716,295
3405-000,2013,12,26,8,776,1017,1793,716
3405-000,2013,12,26,9,957,1043,2000,1793
3405-000,2013,12,26,10,857,716,1573,2000
3405-000,2013,12,26,11,862,793,1655,1573
3405-000,2013,12,26,12,896,811,1707,1655
3405-000,2013,12,26,13,707,662,1369,1707
3405-000,2013,12,26,14,781,707,1488,1369
3405-000,2013,12,26,15,862,816,1678,1488
3405-000,2013,12,26,16,889,761,1650,1678
3405-000,2013,12,26,17,820,757,1577,1650
3405-000,2013,12,26,18,871,721,1592,1577
3405-000,2013,12,26,19,701,641,1342,1592
3405-000,2013,12,26,20,452,396,848,1342
3405-000,2013,12,26,21,375,351,726,848
3405-000,2013,12,26,22,265,323,588,726
3405-000,2013,12,26,23,242,162,404,588
3405-000,2013,12,26,24,135,139,274,404
3405-000,2013,12,27,1,75,94,169,274
3405-000,2013,12,27,2,47,72,119,169
3405-000,2013,12,27,3,51,53,104,119
3405-000,2013,12,27,4,46,57,103,104
3405-000,2013,12,27,5,78,72,150,103
3405-000,2013,12,27,6,142,127,269,150
3405-000,2013,12,27,7,279,266,545,269
3405-000,2013,12,27,8,704,784,1488,545
3405-000,2013,12,27,9,944,925,1869,1488
3405-000,2013,12,27,10,810,698,1508,1869
3405-000,2013,12,27,11,898,747,1645,1508
3405-000,2013,12,27,12,858,738,1596,1645
3405-000,2013,12,27,13,665,628,1293,1596
3405-000,2013,12,27,14,791,778,1569,1293
3405-000,2013,12,27,15,916,831,1747,1569
3405-000,2013,12,27,16,972,783,1755,1747
3405-000,2013,12,27,17,933,715,1648,1755
3405-000,2013,12,27,18,907,826,1733,1648
3405-000,2013,12,27,19,1127,692,1819,1733
3405-000,2013,12,27,20,653,491,1144,1819
3405-000,2013,12,27,21,466,326,792,1144
3405-000,2013,12,27,22,356,300,656,792
3405-000,2013,12,27,23,235,172,407,656
3405-000,2013,12,27,24,131,156,287,407
3405-000,2013,12,28,1,97,107,204,287
3405-000,2013,12,28,2,77,63,140,204
3405-000,2013,12,28,3,44,69,113,140
3405-000,2013,12,28,4,44,50,94,113
3405-000,2013,12,28,5,62,72,134,94
3405-000,2013,12,28,6,94,114,208,134
3405-000,2013,12,28,7,236,207,443,208
3405-000,2013,12,28,8,502,402,904,443
3405-000,2013,12,28,9,643,500,1143,904
3405-000,2013,12,28,10,677,551,1228,1143
3405-000,2013,12,28,11,725,595,1320,1228
3405-000,2013,12,28,12,743,561,1304,1320
3405-000,2013,12,28,13,569,522,1091,1304
3405-000,2013,12,28,14,597,538,1135,1091
3405-000,2013,12,28,15,721,537,1258,1135
3405-000,2013,12,28,16,630,531,1161,1258
3405-000,2013,12,28,17,636,515,1151,1161
3405-000,2013,12,28,18,702,612,1314,1151
3405-000,2013,12,28,19,510,461,971,1314
3405-000,2013,12,28,20,299,305,604,971
3405-000,2013,12,28,21,249,204,453,604
3405-000,2013,12,28,22,209,165,374,453
3405-000,2013,12,28,23,145,160,305,374
3405-000,2013,12,28,24,98,97,195,305
3405-000,2013,12,29,1,65,63,128,195
3405-000,2013,12,29,2,34,51,85,128
3405-000,2013,12,29,3,26,28,54,85
3405-000,2013,12,29,4,24,30,54,54
3405-000,2013,12,29,5,29,30,59,54
3405-000,2013,12,29,6,49,50,99,59
3405-000,2013,12,29,7,117,92,209,99
3405-000,2013,12,29,8,175,178,353,209
3405-000,2013,12,29,9,248,233,481,353
3405-000,2013,12,29,10,298,211,509,481
3405-000,2013,12,29,11,386,308,694,509
3405-000,2013,12,29,12,346,314,660,694
3405-000,2013,12,29,13,366,354,720,660
3405-000,2013,12,29,14,403,409,812,720
3405-000,2013,12,29,15,416,402,818,812
3405-000,2013,12,29,16,434,500,934,818
3405-000,2013,12,29,17,459,488,947,934
3405-000,2013,12,29,18,415,449,864,947
3405-000,2013,12,29,19,301,382,683,864
3405-000,2013,12,29,20,225,310,535,683
3405-000,2013,12,29,21,208,275,483,535
3405-000,2013,12,29,22,188,224,412,483
3405-000,2013,12,29,23,117,154,271,412
3405-000,2013,12,29,24,97,130,227,271
3405-000,2013,12,30,1,37,93,130,227
3405-000,2013,12,30,2,34,64,98,130
3405-000,2013,12,30,3,29,41,70,98
3405-000,2013,12,30,4,35,56,91,70
3405-000,2013,12,30,5,56,76,132,91
3405-000,2013,12,30,6,139,141,280,132
3405-000,2013,12,30,7,322,348,670,280
3405-000,2013,12,30,8,742,989,1731,670
3405-000,2013,12,30,9,911,946,1857,1731
3405-000,2013,12,30,10,778,673,1451,1857
3405-000,2013,12,30,11,885,757,1642,1451
3405-000,2013,12,30,12,805,734,1539,1642
3405-000,2013,12,30,13,662,657,1319,1539
3405-000,2013,12,30,14,769,769,1538,1319
3405-000,2013,12,30,15,858,741,1599,1538
3405-000,2013,12,30,16,906,794,1700,1599
3405-000,2013,12,30,17,848,717,1565,1700
3405-000,2013,12,30,18,885,780,1665,1565
3405-000,2013,12,30,19,789,670,1459,1665
3405-000,2013,12,30,20,493,447,940,1459
3405-000,2013,12,30,21,348,364,712,940
3405-000,2013,12,30,22,313,291,604,712
3405-000,2013,12,30,23,198,181,379,604
3405-000,2013,12,30,24,132,152,284,379
3405-000,2013,12,31,1,93,115,208,284
3405-000,2013,12,31,2,61,71,132,208
3405-000,2013,12,31,3,39,63,102,132
3405-000,2013,12,31,4,61,73,134,102
3405-000,2013,12,31,5,69,54,123,134
3405-000,2013,12,31,6,122,114,236,123
3405-000,2013,12,31,7,261,250,511,236
3405-000,2013,12,31,8,642,689,1331,511
3405-000,2013,12,31,9,862,782,1644,1331
3405-000,2013,12,31,10,786,535,1321,1644
3405-000,2013,12,31,11,764,613,1377,1321
3405-000,2013,12,31,12,721,671,1392,1377
3405-000,2013,12,31,13,617,593,1210,1392
3405-000,2013,12,31,14,739,662,1401,1210
3405-000,2013,12,31,15,842,671,1513,1401
3405-000,2013,12,31,16,844,703,1547,1513
3405-000,2013,12,31,17,863,731,1594,1547
3405-000,2013,12,31,18,979,743,1722,1594
3405-000,2013,12,31,19,821,524,1345,1722
3405-000,2013,12,31,20,551,359,910,1345
3405-000,2013,12,31,21,293,287,580,910
3405-000,2013,12,31,22,244,184,428,580
3405-000,2013,12,31,23,202,142,344,428
3405-000,2013,12,31,24,112,120,232,344
3405-000,2014,1,1,1,100,86,186,232
3405-000,2014,1,1,2,78,74,152,186
3405-000,2014,1,1,3,57,57,114,152
3405-000,2014,1,1,4,43,42,85,114
3405-000,2014,1,1,5,49,55,104,85
3405-000,2014,1,1,6,87,79,166,104
3405-000,2014,1,1,7,165,100,265,166
3405-000,2014,1,1,8,180,118,298,265
3405-000,2014,1,1,9,237,194,431,298
3405-000,2014,1,1,10,296,231,527,431
3405-000,2014,1,1,11,384,297,681,527
3405-000,2014,1,1,12,423,381,804,681
3405-000,2014,1,1,13,352,354,706,804
3405-000,2014,1,1,14,357,429,786,706
3405-000,2014,1,1,15,408,416,824,786
3405-000,2014,1,1,16,455,466,921,824
3405-000,2014,1,1,17,432,443,875,921
3405-000,2014,1,1,18,408,452,860,875
3405-000,2014,1,1,19,314,377,691,860
3405-000,2014,1,1,20,248,320,568,691
3405-000,2014,1,1,21,223,284,507,568
3405-000,2014,1,1,22,173,240,413,507
3405-000,2014,1,1,23,135,194,329,413
3405-000,2014,1,1,24,71,121,192,329
3405-000,2014,1,2,1,52,101,153,192
3405-000,2014,1,2,2,34,49,83,153
3405-000,2014,1,2,3,25,47,72,83
3405-000,2014,1,2,4,35,40,75,72
3405-000,2014,1,2,5,58,59,117,75
3405-000,2014,1,2,6,121,134,255,117
3405-000,2014,1,2,7,297,385,682,255
3405-000,2014,1,2,8,817,986,1803,682
3405-000,2014,1,2,9,863,972,1835,1803
3405-000,2014,1,2,10,705,616,1321,1835
3405-000,2014,1,2,11,790,668,1458,1321
3405-000,2014,1,2,12,749,694,1443,1458
3405-000,2014,1,2,13,621,599,1220,1443
3405-000,2014,1,2,14,667,738,1405,1220
3405-000,2014,1,2,15,831,776,1607,1405
3405-000,2014,1,2,16,755,710,1465,1607
3405-000,2014,1,2,17,772,661,1433,1465
3405-000,2014,1,2,18,754,744,1498,1433
3405-000,2014,1,2,19,730,647,1377,1498
3405-000,2014,1,2,20,534,415,949,1377
3405-000,2014,1,2,21,351,408,759,949
3405-000,2014,1,2,22,271,298,569,759
3405-000,2014,1,2,23,162,200,362,569
3405-000,2014,1,2,24,93,109,202,362
3405-000,2014,1,3,1,77,105,182,202
3405-000,2014,1,3,2,49,57,106,182
3405-000,2014,1,3,3,31,68,99,106
3405-000,2014,1,3,4,34,70,104,99
3405-000,2014,1,3,5,65,84,149,104
3405-000,2014,1,3,6,135,158,293,149
3405-000,2014,1,3,7,313,342,655,293
3405-000,2014,1,3,8,764,850,1614,655
3405-000,2014,1,3,9,965,924,1889,1614
3405-000,2014,1,3,10,837,709,1546,1889
3405-000,2014,1,3,11,943,801,1744,1546
3405-000,2014,1,3,12,862,722,1584,1744
3405-000,2014,1,3,13,753,678,1431,1584
3405-000,2014,1,3,14,778,770,1548,1431
3405-000,2014,1,3,15,937,817,1754,1548
3405-000,2014,1,3,16,921,828,1749,1754
3405-000,2014,1,3,17,880,712,1592,1749
3405-000,2014,1,3,18,953,801,1754,1592
3405-000,2014,1,3,19,1058,698,1756,1754
3405-000,2014,1,3,20,651,501,1152,1756
3405-000,2014,1,3,21,510,435,945,1152
3405-000,2014,1,3,22,340,288,628,945
3405-000,2014,1,3,23,227,208,435,628
3405-000,2014,1,3,24,121,139,260,435
3405-000,2014,1,4,1,88,102,190,260
3405-000,2014,1,4,2,69,67,136,190
3405-000,2014,1,4,3,53,57,110,136
3405-000,2014,1,4,4,51,45,96,110
3405-000,2014,1,4,5,63,65,128,96
3405-000,2014,1,4,6,118,123,241,128
3405-000,2014,1,4,7,269,221,490,241
3405-000,2014,1,4,8,509,403,912,490
3405-000,2014,1,4,9,666,539,1205,912
3405-000,2014,1,4,10,673,548,1221,1205
3405-000,2014,1,4,11,700,503,1203,1221
3405-000,2014,1,4,12,710,533,1243,1203
3405-000,2014,1,4,13,552,476,1028,1243
3405-000,2014,1,4,14,585,487,1072,1028
3405-000,2014,1,4,15,577,485,1062,1072
3405-000,2014,1,4,16,622,565,1187,1062
3405-000,2014,1,4,17,665,507,1172,1187
3405-000,2014,1,4,18,674,606,1280,1172
3405-000,2014,1,4,19,489,432,921,1280
3405-000,2014,1,4,20,325,304,629,921
3405-000,2014,1,4,21,251,256,507,629
3405-000,2014,1,4,22,184,202,386,507
3405-000,2014,1,4,23,148,118,266,386
3405-000,2014,1,4,24,105,117,222,266
3405-000,2014,1,5,1,59,59,118,222
3405-000,2014,1,5,2,41,35,76,118
3405-000,2014,1,5,3,32,26,58,76
3405-000,2014,1,5,4,24,25,49,58
3405-000,2014,1,5,5,36,41,77,49
3405-000,2014,1,5,6,58,46,104,77
3405-000,2014,1,5,7,139,105,244,104
3405-000,2014,1,5,8,198,183,381,244
3405-000,2014,1,5,9,267,228,495,381
3405-000,2014,1,5,10,320,230,550,495
3405-000,2014,1,5,11,386,265,651,550
3405-000,2014,1,5,12,355,319,674,651
3405-000,2014,1,5,13,347,356,703,674
3405-000,2014,1,5,14,411,376,787,703
3405-000,2014,1,5,15,453,407,860,787
3405-000,2014,1,5,16,437,538,975,860
3405-000,2014,1,5,17,397,543,940,975
3405-000,2014,1,5,18,431,515,946,940
3405-000,2014,1,5,19,366,364,730,946
3405-000,2014,1,5,20,217,320,537,730
3405-000,2014,1,5,21,216,245,461,537
3405-000,2014,1,5,22,186,227,413,461
3405-000,2014,1,5,23,119,187,306,413
3405-000,2014,1,5,24,78,115,193,306
3405-000,2014,1,6,1,49,94,143,193
3405-000,2014,1,6,2,31,58,89,143
3405-000,2014,1,6,3,17,45,62,89
3405-000,2014,1,6,4,41,49,90,62
3405-000,2014,1,6,5,59,72,131,90
3405-000,2014,1,6,6,134,167,301,131
3405-000,2014,1,6,7,361,421,782,301
3405-000,2014,1,6,8,818,1085,1903,782
3405-000,2014,1,6,9,993,1108,2101,1903
3405-000,2014,1,6,10,775,698,1473,2101
3405-000,2014,1,6,11,882,775,1657,1473
3405-000,2014,1,6,12,798,731,1529,1657
3405-000,2014,1,6,13,680,666,1346,1529
3405-000,2014,1,6,14,774,723,1497,1346
3405-000,2014,1,6,15,936,859,1795,1497
3405-000,2014,1,6,16,837,802,1639,1795
3405-000,2014,1,6,17,875,757,1632,1639
3405-000,2014,1,6,18,879,744,1623,1632
3405-000,2014,1,6,19,790,679,1469,1623
3405-000,2014,1,6,20,541,464,1005,1469
3405-000,2014,1,6,21,425,435,860,1005
3405-000,2014,1,6,22,290,307,597,860
3405-000,2014,1,6,23,180,194,374,597
3405-000,2014,1,6,24,100,125,225,374
3405-000,2014,1,7,1,70,93,163,225
3405-000,2014,1,7,2,38,76,114,163
3405-000,2014,1,7,3,40,59,99,114
3405-000,2014,1,7,4,37,59,96,99
3405-000,2014,1,7,5,83,83,166,96
3405-000,2014,1,7,6,113,130,243,166
3405-000,2014,1,7,7,337,344,681,243
3405-000,2014,1,7,8,731,861,1592,681
3405-000,2014,1,7,9,1036,999,2035,1592
3405-000,2014,1,7,10,896,771,1667,2035
3405-000,2014,1,7,11,910,739,1649,1667
3405-000,2014,1,7,12,892,764,1656,1649
3405-000,2014,1,7,13,751,644,1395,1656
3405-000,2014,1,7,14,833,733,1566,1395
3405-000,2014,1,7,15,903,846,1749,1566
3405-000,2014,1,7,16,886,807,1693,1749
3405-000,2014,1,7,17,900,810,1710,1693
3405-000,2014,1,7,18,904,769,1673,1710
3405-000,2014,1,7,19,852,688,1540,1673
3405-000,2014,1,7,20,541,502,1043,1540
3405-000,2014,1,7,21,406,430,836,1043
3405-000,2014,1,7,22,301,318,619,836
3405-000,2014,1,7,23,200,210,410,619
3405-000,2014,1,7,24,132,130,262,410
3405-000,2014,1,8,1,75,89,164,262
3405-000,2014,1,8,2,48,95,143,164
3405-000,2014,1,8,3,44,48,92,143
3405-000,2014,1,8,4,31,67,98,92
3405-000,2014,1,8,5,57,62,119,98
3405-000,2014,1,8,6,124,118,242,119
3405-000,2014,1,8,7,307,288,595,242
3405-000,2014,1,8,8,716,847,1563,595
3405-000,2014,1,8,9,1035,946,1981,1563
3405-000,2014,1,8,10,841,697,1538,1981
3405-000,2014,1,8,11,876,769,1645,1538
3405-000,2014,1,8,12,847,699,1546,1645
3405-000,2014,1,8,13,710,618,1328,1546
3405-000,2014,1,8,14,724,757,1481,1328
3405-000,2014,1,8,15,906,817,1723,1481
3405-000,2014,1,8,16,856,758,1614,1723
3405-000,2014,1,8,17,808,704,1512,1614
3405-000,2014,1,8,18,863,738,1601,1512
3405-000,2014,1,8,19,769,709,1478,1601
3405-000,2014,1,8,20,547,475,1022,1478
3405-000,2014,1,8,21,398,369,767,1022
3405-000,2014,1,8,22,272,276,548,767
3405-000,2014,1,8,23,199,189,388,548
3405-000,2014,1,8,24,114,145,259,388
3405-000,2014,1,9,1,80,82,162,259
3405-000,2014,1,9,2,61,58,119,162
3405-000,2014,1,9,3,36,40,76,119
3405-000,2014,1,9,4,40,57,97,76
3405-000,2014,1,9,5,62,69,131,97
3405-000,2014,1,9,6,117,136,253,131
3405-000,2014,1,9,7,339,306,645,253
3405-000,2014,1,9,8,736,892,1628,645
3405-000,2014,1,9,9,998,961,1959,1628
3405-000,2014,1,9,10,859,701,1560,1959
3405-000,2014,1,9,11,850,720,1570,1560
3405-000,2014,1,9,12,817,728,1545,1570
3405-000,2014,1,9,13,683,645,1328,1545
3405-000,2014,1,9,14,806,732,1538,1328
3405-000,2014,1,9,15,834,846,1680,1538
3405-000,2014,1,9,16,834,757,1591,1680
3405-000,2014,1,9,17,821,733,1554,1591
3405-000,2014,1,9,18,837,701,1538,1554
3405-000,2014,1,9,19,817,666,1483,1538
3405-000,2014,1,9,20,523,463,986,1483
3405-000,2014,1,9,21,462,437,899,986
3405-000,2014,1,9,22,313,306,619,899
3405-000,2014,1,9,23,185,184,369,619
3405-000,2014,1,9,24,121,128,249,369
3405-000,2014,1,10,1,71,83,154,249
3405-000,2014,1,10,2,48,62,110,154
3405-000,2014,1,10,3,42,47,89,110
3405-000,2014,1,10,4,36,53,89,89
3405-000,2014,1,10,5,58,84,142,89
3405-000,2014,1,10,6,116,119,235,142
3405-000,2014,1,10,7,298,288,586,235
3405-000,2014,1,10,8,742,813,1555,586
3405-000,2014,1,10,9,955,943,1898,1555
3405-000,2014,1,10,10,778,770,1548,1898
3405-000,2014,1,10,11,884,782,1666,1548
3405-000,2014,1,10,12,846,727,1573,1666
3405-000,2014,1,10,13,705,626,1331,1573
3405-000,2014,1,10,14,823,775,1598,1331
3405-000,2014,1,10,15,906,846,1752,1598
3405-000,2014,1,10,16,887,753,1640,1752
3405-000,2014,1,10,17,958,711,1669,1640
3405-000,2014,1,10,18,1052,733,1785,1669
3405-000,2014,1,10,19,1089,809,1898,1785
3405-000,2014,1,10,20,671,473,1144,1898
3405-000,2014,1,10,21,476,420,896,1144
3405-000,2014,1,10,22,347,326,673,896
3405-000,2014,1,10,23,214,187,401,673
3405-000,2014,1,10,24,146,128,274,401
3405-000,2014,1,11,1,95,106,201,274
3405-000,2014,1,11,2,59,51,110,201
3405-000,2014,1,11,3,51,51,102,110
3405-000,2014,1,11,4,41,54,95,102
3405-000,2014,1,11,5,56,88,144,95
3405-000,2014,1,11,6,100,117,217,144
3405-000,2014,1,11,7,222,168,390,217
3405-000,2014,1,11,8,486,405,891,390
3405-000,2014,1,11,9,620,562,1182,891
3405-000,2014,1,11,10,695,551,1246,1182
3405-000,2014,1,11,11,748,576,1324,1246
3405-000,2014,1,11,12,658,550,1208,1324
3405-000,2014,1,11,13,655,537,1192,1208
3405-000,2014,1,11,14,639,551,1190,1192
3405-000,2014,1,11,15,680,515,1195,1190
3405-000,2014,1,11,16,644,554,1198,1195
3405-000,2014,1,11,17,667,570,1237,1198
3405-000,2014,1,11,18,700,618,1318,1237
3405-000,2014,1,11,19,541,423,964,1318
3405-000,2014,1,11,20,308,280,588,964
3405-000,2014,1,11,21,269,240,509,588
3405-000,2014,1,11,22,196,181,377,509
3405-000,2014,1,11,23,143,161,304,377
3405-000,2014,1,11,24,124,99,223,304
3405-000,2014,1,12,1,50,75,125,223
3405-000,2014,1,12,2,35,46,81,125
3405-000,2014,1,12,3,34,23,57,81
3405-000,2014,1,12,4,21,35,56,57
3405-000,2014,1,12,5,27,40,67,56
3405-000,2014,1,12,6,51,66,117,67
3405-000,2014,1,12,7,121,81,202,117
3405-000,2014,1,12,8,177,156,333,202
3405-000,2014,1,12,9,276,217,493,333
3405-000,2014,1,12,10,353,228,581,493
3405-000,2014,1,12,11,379,289,668,581
3405-000,2014,1,12,12,393,328,721,668
3405-000,2014,1,12,13,382,345,727,721
3405-000,2014,1,12,14,380,412,792,727
3405-000,2014,1,12,15,415,417,832,792
3405-000,2014,1,12,16,409,500,909,832
3405-000,2014,1,12,17,442,503,945,909
3405-000,2014,1,12,18,404,508,912,945
3405-000,2014,1,12,19,333,369,702,912
3405-000,2014,1,12,20,234,319,553,702
3405-000,2014,1,12,21,213,246,459,553
3405-000,2014,1,12,22,183,235,418,459
3405-000,2014,1,12,23,122,189,311,418
3405-000,2014,1,12,24,101,120,221,311
3405-000,2014,1,13,1,58,74,132,221
3405-000,2014,1,13,2,30,65,95,132
3405-000,2014,1,13,3,30,34,64,95
3405-000,2014,1,13,4,38,56,94,64
3405-000,2014,1,13,5,51,77,128,94
3405-000,2014,1,13,6,154,160,314,128
3405-000,2014,1,13,7,329,415,744,314
3405-000,2014,1,13,8,812,1104,1916,744
3405-000,2014,1,13,9,899,1076,1975,1916
3405-000,2014,1,13,10,806,694,1500,1975
3405-000,2014,1,13,11,835,715,1550,1500
3405-000,2014,1,13,12,829,729,1558,1550
3405-000,2014,1,13,13,663,662,1325,1558
3405-000,2014,1,13,14,757,755,1512,1325
3405-000,2014,1,13,15,925,840,1765,1512
3405-000,2014,1,13,16,834,789,1623,1765
3405-000,2014,1,13,17,871,719,1590,1623
3405-000,2014,1,13,18,819,742,1561,1590
3405-000,2014,1,13,19,786,702,1488,1561
3405-000,2014,1,13,20,568,471,1039,1488
3405-000,2014,1,13,21,423,410,833,1039
3405-000,2014,1,13,22,279,357,636,833
3405-000,2014,1,13,23,209,180,389,636
3405-000,2014,1,13,24,125,151,276,389
3405-000,2014,1,14,1,69,97,166,276
3405-000,2014,1,14,2,47,62,109,166
3405-000,2014,1,14,3,30,41,71,109
3405-000,2014,1,14,4,41,63,104,71
3405-000,2014,1,14,5,57,89,146,104
3405-000,2014,1,14,6,128,136,264,146
3405-000,2014,1,14,7,285,296,581,264
3405-000,2014,1,14,8,739,828,1567,581
3405-000,2014,1,14,9,1015,976,1991,1567
3405-000,2014,1,14,10,805,727,1532,1991
3405-000,2014,1,14,11,883,732,1615,1532
3405-000,2014,1,14,12,799,704,1503,1615
3405-000,2014,1,14,13,693,680,1373,1503
3405-000,2014,1,14,14,814,764,1578,1373
3405-000,2014,1,14,15,847,844,1691,1578
3405-000,2014,1,14,16,867,824,1691,1691
3405-000,2014,1,14,17,902,748,1650,1691
3405-000,2014,1,14,18,864,745,1609,1650
3405-000,2014,1,14,19,787,652,1439,1609
3405-000,2014,1,14,20,530,503,1033,1439
3405-000,2014,1,14,21,420,415,835,1033
3405-000,2014,1,14,22,295,335,630,835
3405-000,2014,1,14,23,174,176,350,630
3405-000,2014,1,14,24,123,137,260,350
3405-000,2014,1,15,1,68,87,155,260
3405-000,2014,1,15,2,53,66,119,155
3405-000,2014,1,15,3,46,58,104,119
3405-000,2014,1,15,4,38,41,79,104
3405-000,2014,1,15,5,55,70,125,79
3405-000,2014,1,15,6,129,129,258,125
3405-000,2014,1,15,7,283,297,580,258
3405-000,2014,1,15,8,726,851,1577,580
3405-000,2014,1,15,9,982,903,1885,1577
3405-000,2014,1,15,10,828,778,1606,1885
3405-000,2014,1,15,11,913,786,1699,1606
3405-000,2014,1,15,12,845,694,1539,1699
3405-000,2014,1,15,13,697,619,1316,1539
3405-000,2014,1,15,14,778,761,1539,1316
3405-000,2014,1,15,15,873,798,1671,1539
3405-000,2014,1,15,16,898,816,1714,1671
3405-000,2014,1,15,17,856,682,1538,1714
3405-000,2014,1,15,18,917,786,1703,1538
3405-000,2014,1,15,19,845,738,1583,1703
3405-000,2014,1,15,20,519,490,1009,1583
3405-000,2014,1,15,21,390,375,765,1009
3405-000,2014,1,15,22,322,302,624,765
3405-000,2014,1,15,23,217,186,403,624
3405-000,2014,1,15,24,131,133,264,403
3405-000,2014,1,16,1,68,98,166,264
3405-000,2014,1,16,2,49,65,114,166
3405-000,2014,1,16,3,38,40,78,114
3405-000,2014,1,16,4,52,58,110,78
3405-000,2014,1,16,5,65,83,148,110
3405-000,2014,1,16,6,128,117,245,148
3405-000,2014,1,16,7,316,301,617,245
3405-000,2014,1,16,8,730,821,1551,617
3405-000,2014,1,16,9,978,976,1954,1551
3405-000,2014,1,16,10,858,755,1613,1954
3405-000,2014,1,16,11,924,838,1762,1613
3405-000,2014,1,16,12,849,781,1630,1762
3405-000,2014,1,16,13,732,642,1374,1630
3405-000,2014,1,16,14,791,772,1563,1374
3405-000,2014,1,16,15,928,860,1788,1563
3405-000,2014,1,16,16,861,879,1740,1788
3405-000,2014,1,16,17,873,799,1672,1740
3405-000,2014,1,16,18,916,722,1638,1672
3405-000,2014,1,16,19,774,680,1454,1638
3405-000,2014,1,16,20,580,461,1041,1454
3405-000,2014,1,16,21,461,446,907,1041
3405-000,2014,1,16,22,324,330,654,907
3405-000,2014,1,16,23,195,191,386,654
3405-000,2014,1,16,24,146,156,302,386
3405-000,2014,1,17,1,75,109,184,302
3405-000,2014,1,17,2,54,52,106,184
3405-000,2014,1,17,3,30,45,75,106
3405-000,2014,1,17,4,45,59,104,75
3405-000,2014,1,17,5,69,83,152,104
3405-000,2014,1,17,6,150,130,280,152
3405-000,2014,1,17,7,298,269,567,280
3405-000,2014,1,17,8,710,832,1542,567
3405-000,2014,1,17,9,981,954,1935,1542
3405-000,2014,1,17,10,859,735,1594,1935
3405-000,2014,1,17,11,906,804,1710,1594
3405-000,2014,1,17,12,862,763,1625,1710
3405-000,2014,1,17,13,708,676,1384,1625
3405-000,2014,1,17,14,815,760,1575,1384
3405-000,2014,1,17,15,947,769,1716,1575
3405-000,2014,1,17,16,890,833,1723,1716
3405-000,2014,1,17,17,950,688,1638,1723
3405-000,2014,1,17,18,1018,821,1839,1638
3405-000,2014,1,17,19,1092,827,1919,1839
3405-000,2014,1,17,20,694,572,1266,1919
3405-000,2014,1,17,21,541,464,1005,1266
3405-000,2014,1,17,22,384,337,721,1005
3405-000,2014,1,17,23,232,201,433,721
3405-000,2014,1,17,24,157,137,294,433
3405-000,2014,1,18,1,95,116,211,294
3405-000,2014,1,18,2,76,73,149,211
3405-000,2014,1,18,3,43,55,98,149
3405-000,2014,1,18,4,56,68,124,98
3405-000,2014,1,18,5,72,75,147,124
3405-000,2014,1,18,6,101,111,212,147
3405-000,2014,1,18,7,284,228,512,212
3405-000,2014,1,18,8,568,437,1005,512
3405-000,2014,1,18,9,742,540,1282,1005
3405-000,2014,1,18,10,769,518,1287,1282
3405-000,2014,1,18,11,743,543,1286,1287
3405-000,2014,1,18,12,722,569,1291,1286
3405-000,2014,1,18,13,596,547,1143,1291
3405-000,2014,1,18,14,625,559,1184,1143
3405-000,2014,1,18,15,645,570,1215,1184
3405-000,2014,1,18,16,642,568,1210,1215
3405-000,2014,1,18,17,682,536,1218,1210
3405-000,2014,1,18,18,677,710,1387,1218
3405-000,2014,1,18,19,532,492,1024,1387
3405-000,2014,1,18,20,365,314,679,1024
3405-000,2014,1,18,21,272,231,503,679
3405-000,2014,1,18,22,191,208,399,503
3405-000,2014,1,18,23,145,161,306,399
3405-000,2014,1,18,24,115,99,214,306
3405-000,2014,1,19,1,67,54,121,214
3405-000,2014,1,19,2,37,45,82,121
3405-000,2014,1,19,3,34,34,68,82
3405-000,2014,1,19,4,28,23,51,68
3405-000,2014,1,19,5,36,37,73,51
3405-000,2014,1,19,6,72,54,126,73
3405-000,2014,1,19,7,133,107,240,126
3405-000,2014,1,19,8,197,191,388,240
3405-000,2014,1,19,9,307,219,526,388
3405-000,2014,1,19,10,356,243,599,526
3405-000,2014,1,19,11,407,321,728,599
3405-000,2014,1,19,12,356,354,710,728
3405-000,2014,1,19,13,327,391,718,710
3405-000,2014,1,19,14,404,371,775,718
3405-000,2014,1,19,15,455,461,916,775
3405-000,2014,1,19,16,477,474,951,916
3405-000,2014,1,19,17,425,516,941,951
3405-000,2014,1,19,18,465,551,1016,941
3405-000,2014,1,19,19,355,442,797,1016
3405-000,2014,1,19,20,245,350,595,797
3405-000,2014,1,19,21,219,261,480,595
3405-000,2014,1,19,22,223,266,489,480
3405-000,2014,1,19,23,126,224,350,489
3405-000,2014,1,19,24,97,143,240,350
3405-000,2014,1,20,1,68,113,181,240
3405-000,2014,1,20,2,32,76,108,181
3405-000,2014,1,20,3,25,34,59,108
3405-000,2014,1,20,4,34,59,93,59
3405-000,2014,1,20,5,51,68,119,93
3405-000,2014,1,20,6,129,118,247,119
3405-000,2014,1,20,7,289,291,580,247
3405-000,2014,1,20,8,665,802,1467,580
3405-000,2014,1,20,9,893,922,1815,1467
3405-000,2014,1,20,10,702,571,1273,1815
3405-000,2014,1,20,11,745,659,1404,1273
3405-000,2014,1,20,12,780,716,1496,1404
3405-000,2014,1,20,13,643,628,1271,1496
3405-000,2014,1,20,14,704,687,1391,1271
3405-000,2014,1,20,15,861,793,1654,1391
3405-000,2014,1,20,16,793,745,1538,1654
3405-000,2014,1,20,17,846,680,1526,1538
3405-000,2014,1,20,18,705,659,1364,1526
3405-000,2014,1,20,19,690,663,1353,1364
3405-000,2014,1,20,20,451,443,894,1353
3405-000,2014,1,20,21,362,376,738,894
3405-000,2014,1,20,22,252,255,507,738
3405-000,2014,1,20,23,144,167,311,507
3405-000,2014,1,20,24,92,125,217,311
3405-000,2014,1,21,1,61,70,131,217
3405-000,2014,1,21,2,30,48,78,131
3405-000,2014,1,21,3,21,32,53,78
3405-000,2014,1,21,4,42,43,85,53
3405-000,2014,1,21,5,54,63,117,85
3405-000,2014,1,21,6,94,91,185,117
3405-000,2014,1,21,7,263,202,465,185
3405-000,2014,1,21,8,640,687,1327,465
3405-000,2014,1,21,9,846,827,1673,1327
3405-000,2014,1,21,10,734,633,1367,1673
3405-000,2014,1,21,11,804,697,1501,1367
3405-000,2014,1,21,12,779,679,1458,1501
3405-000,2014,1,21,13,669,653,1322,1458
3405-000,2014,1,21,14,722,735,1457,1322
3405-000,2014,1,21,15,863,791,1654,1457
3405-000,2014,1,21,16,949,778,1727,1654
3405-000,2014,1,21,17,840,693,1533,1727
3405-000,2014,1,21,18,795,708,1503,1533
3405-000,2014,1,21,19,736,596,1332,1503
3405-000,2014,1,21,20,507,464,971,1332
3405-000,2014,1,21,21,409,378,787,971
3405-000,2014,1,21,22,266,326,592,787
3405-000,2014,1,21,23,193,204,397,592
3405-000,2014,1,21,24,102,127,229,397
3405-000,2014,1,22,1,89,83,172,229
3405-000,2014,1,22,2,47,71,118,172
3405-000,2014,1,22,3,35,54,89,118
3405-000,2014,1,22,4,44,52,96,89
3405-000,2014,1,22,5,68,73,141,96
3405-000,2014,1,22,6,120,111,231,141
3405-000,2014,1,22,7,289,254,543,231
3405-000,2014,1,22,8,693,797,1490,543
3405-000,2014,1,22,9,969,914,1883,1490
3405-000,2014,1,22,10,897,742,1639,1883
3405-000,2014,1,22,11,841,740,1581,1639
3405-000,2014,1,22,12,831,734,1565,1581
3405-000,2014,1,22,13,686,627,1313,1565
3405-000,2014,1,22,14,810,739,1549,1313
3405-000,2014,1,22,15,919,814,1733,1549
3405-000,2014,1,22,16,825,790,1615,1733
3405-000,2014,1,22,17,859,738,1597,1615
3405-000,2014,1,22,18,855,833,1688,1597
3405-000,2014,1,22,19,924,718,1642,1688
3405-000,2014,1,22,20,557,464,1021,1642
3405-000,2014,1,22,21,421,405,826,1021
3405-000,2014,1,22,22,307,296,603,826
3405-000,2014,1,22,23,230,205,435,603
3405-000,2014,1,22,24,136,133,269,435
3405-000,2014,1,23,1,84,94,178,269
3405-000,2014,1,23,2,36,78,114,178
3405-000,2014,1,23,3,47,49,96,114
3405-000,2014,1,23,4,56,56,112,96
3405-000,2014,1,23,5,78,82,160,112
3405-000,2014,1,23,6,144,111,255,160
3405-000,2014,1,23,7,304,293,597,255
3405-000,2014,1,23,8,760,774,1534,597
3405-000,2014,1,23,9,985,978,1963,1534
3405-000,2014,1,23,10,886,724,1610,1963
3405-000,2014,1,23,11,902,794,1696,1610
3405-000,2014,1,23,12,850,774,1624,1696
3405-000,2014,1,23,13,775,684,1459,1624
3405-000,2014,1,23,14,770,770,1540,1459
3405-000,2014,1,23,15,934,863,1797,1540
3405-000,2014,1,23,16,949,833,1782,1797
3405-000,2014,1,23,17,875,782,1657,1782
3405-000,2014,1,23,18,915,788,1703,1657
3405-000,2014,1,23,19,837,698,1535,1703
3405-000,2014,1,23,20,607,503,1110,1535
3405-000,2014,1,23,21,462,439,901,1110
3405-000,2014,1,23,22,346,299,645,901
3405-000,2014,1,23,23,217,208,425,645
3405-000,2014,1,23,24,115,150,265,425
3405-000,2014,1,24,1,72,115,187,265
3405-000,2014,1,24,2,69,72,141,187
3405-000,2014,1,24,3,38,64,102,141
3405-000,2014,1,24,4,42,53,95,102
3405-000,2014,1,24,5,77,82,159,95
3405-000,2014,1,24,6,139,117,256,159
3405-000,2014,1,24,7,333,333,666,256
3405-000,2014,1,24,8,754,802,1556,666
3405-000,2014,1,24,9,1044,960,2004,1556
3405-000,2014,1,24,10,906,752,1658,2004
3405-000,2014,1,24,11,927,789,1716,1658
3405-000,2014,1,24,12,874,734,1608,1716
3405-000,2014,1,24,13,752,698,1450,1608
3405-000,2014,1,24,14,792,767,1559,1450
3405-000,2014,1,24,15,942,864,1806,1559
3405-000,2014,1,24,16,948,761,1709,1806
3405-000,2014,1,24,17,921,810,1731,1709
3405-000,2014,1,24,18,994,861,1855,1731
3405-000,2014,1,24,19,1166,806,1972,1855
3405-000,2014,1,24,20,738,521,1259,1972
3405-000,2014,1,24,21,550,467,1017,1259
3405-000,2014,1,24,22,379,334,713,1017
3405-000,2014,1,24,23,246,213,459,713
3405-000,2014,1,24,24,137,141,278,459
3405-000,2014,1,25,1,101,112,213,278
3405-000,2014,1,25,2,60,82,142,213
3405-000,2014,1,25,3,56,59,115,142
3405-000,2014,1,25,4,45,70,115,115
3405-000,2014,1,25,5,71,81,152,115
3405-000,2014,1,25,6,125,126,251,152
3405-000,2014,1,25,7,255,193,448,251
3405-000,2014,1,25,8,463,437,900,448
3405-000,2014,1,25,9,717,532,1249,900
3405-000,2014,1,25,10,725,539,1264,1249
3405-000,2014,1,25,11,725,550,1275,1264
3405-000,2014,1,25,12,731,587,1318,1275
3405-000,2014,1,25,13,567,514,1081,1318
3405-000,2014,1,25,14,597,533,1130,1081
3405-000,2014,1,25,15,634,564,1198,1130
3405-000,2014,1,25,16,630,537,1167,1198
3405-000,2014,1,25,17,610,512,1122,1167
3405-000,2014,1,25,18,617,604,1221,1122
3405-000,2014,1,25,19,543,443,986,1221
3405-000,2014,1,25,20,323,330,653,986
3405-000,2014,1,25,21,244,243,487,653
3405-000,2014,1,25,22,217,226,443,487
3405-000,2014,1,25,23,143,141,284,443
3405-000,2014,1,25,24,104,114,218,284
3405-000,2014,1,26,1,56,60,116,218
3405-000,2014,1,26,2,45,44,89,116
3405-000,2014,1,26,3,34,25,59,89
3405-000,2014,1,26,4,33,33,66,59
3405-000,2014,1,26,5,25,35,60,66
3405-000,2014,1,26,6,54,43,97,60
3405-000,2014,1,26,7,118,98,216,97
3405-000,2014,1,26,8,209,184,393,216
3405-000,2014,1,26,9,317,280,597,393
3405-000,2014,1,26,10,369,266,635,597
3405-000,2014,1,26,11,386,308,694,635
3405-000,2014,1,26,12,351,335,686,694
3405-000,2014,1,26,13,429,388,817,686
3405-000,2014,1,26,14,422,378,800,817
3405-000,2014,1,26,15,426,421,847,800
3405-000,2014,1,26,16,433,466,899,847
3405-000,2014,1,26,17,432,464,896,899
3405-000,2014,1,26,18,468,492,960,896
3405-000,2014,1,26,19,366,403,769,960
3405-000,2014,1,26,20,261,281,542,769
3405-000,2014,1,26,21,197,253,450,542
3405-000,2014,1,26,22,212,227,439,450
3405-000,2014,1,26,23,160,168,328,439
3405-000,2014,1,26,24,94,115,209,328
3405-000,2014,1,27,1,57,114,171,209
3405-000,2014,1,27,2,38,69,107,171
3405-000,2014,1,27,3,24,44,68,107
3405-000,2014,1,27,4,42,54,96,68
3405-000,2014,1,27,5,55,84,139,96
3405-000,2014,1,27,6,136,139,275,139
3405-000,2014,1,27,7,330,414,744,275
3405-000,2014,1,27,8,783,1060,1843,744
3405-000,2014,1,27,9,1022,984,2006,1843
3405-000,2014,1,27,10,758,716,1474,2006
3405-000,2014,1,27,11,968,786,1754,1474
3405-000,2014,1,27,12,899,775,1674,1754
3405-000,2014,1,27,13,728,691,1419,1674
3405-000,2014,1,27,14,834,793,1627,1419
3405-000,2014,1,27,15,913,853,1766,1627
3405-000,2014,1,27,16,907,902,1809,1766
3405-000,2014,1,27,17,916,814,1730,1809
3405-000,2014,1,27,18,881,794,1675,1730
3405-000,2014,1,27,19,912,713,1625,1675
3405-000,2014,1,27,20,576,551,1127,1625
3405-000,2014,1,27,21,474,438,912,1127
3405-000,2014,1,27,22,334,355,689,912
3405-000,2014,1,27,23,221,211,432,689
3405-000,2014,1,27,24,126,166,292,432
3405-000,2014,1,28,1,84,103,187,292
3405-000,2014,1,28,2,58,64,122,187
3405-000,2014,1,28,3,41,51,92,122
3405-000,2014,1,28,4,51,68,119,92
3405-000,2014,1,28,5,67,83,150,119
3405-000,2014,1,28,6,127,122,249,150
3405-000,2014,1,28,7,315,256,571,249
3405-000,2014,1,28,8,733,804,1537,571
3405-000,2014,1,28,9,1002,956,1958,1537
3405-000,2014,1,28,10,915,741,1656,1958
3405-000,2014,1,28,11,906,850,1756,1656
3405-000,2014,1,28,12,936,859,1795,1756
3405-000,2014,1,28,13,765,685,1450,1795
3405-000,2014,1,28,14,897,807,1704,1450
3405-000,2014,1,28,15,1025,921,1946,1704
3405-000,2014,1,28,16,1005,937,1942,1946
3405-000,2014,1,28,17,915,845,1760,1942
3405-000,2014,1,28,18,976,806,1782,1760
3405-000,2014,1,28,19,1001,778,1779,1782
3405-000,2014,1,28,20,730,570,1300,1779
3405-000,2014,1,28,21,485,441,926,1300
3405-000,2014,1,28,22,355,332,687,926
3405-000,2014,1,28,23,251,234,485,687
3405-000,2014,1,28,24,141,163,304,485
3405-000,2014,1,29,1,84,126,210,304
3405-000,2014,1,29,2,67,87,154,210
3405-000,2014,1,29,3,37,44,81,154
3405-000,2014,1,29,4,48,49,97,81
3405-000,2014,1,29,5,67,91,158,97
3405-000,2014,1,29,6,128,119,247,158
3405-000,2014,1,29,7,255,240,495,247
3405-000,2014,1,29,8,687,662,1349,495
3405-000,2014,1,29,9,873,826,1699,1349
3405-000,2014,1,29,10,784,612,1396,1699
3405-000,2014,1,29,11,805,657,1462,1396
3405-000,2014,1,29,12,832,684,1516,1462
3405-000,2014,1,29,13,761,569,1330,1516
3405-000,2014,1,29,14,944,605,1549,1330
3405-000,2014,1,29,15,1065,662,1727,1549
3405-000,2014,1,29,16,1010,732,1742,1727
3405-000,2014,1,29,17,1202,840,2042,1742
3405-000,2014,1,29,18,1194,826,2020,2042
3405-000,2014,1,29,19,1063,827,1890,2020
3405-000,2014,1,29,20,735,605,1340,1890
3405-000,2014,1,29,21,666,774,1440,1340
3405-000,2014,1,29,22,410,348,758,1440
3405-000,2014,1,29,23,293,377,670,758
3405-000,2014,1,29,24,158,279,437,670
3405-000,2014,1,30,1,97,97,194,437
3405-000,2014,1,30,2,57,76,133,194
3405-000,2014,1,30,3,61,52,113,133
3405-000,2014,1,30,4,73,45,118,113
3405-000,2014,1,30,5,82,68,150,118
3405-000,2014,1,30,6,205,110,315,150
3405-000,2014,1,30,7,471,118,589,315
3405-000,2014,1,30,8,577,153,730,589
3405-000,2014,1,30,9,549,246,795,730
3405-000,2014,1,30,10,608,308,916,795
3405-000,2014,1,30,11,645,407,1052,916
3405-000,2014,1,30,12,577,688,1265,1052
3405-000,2014,1,30,13,513,363,876,1265
3405-000,2014,1,30,14,459,338,797,876
3405-000,2014,1,30,15,401,322,723,797
3405-000,2014,1,30,16,324,302,626,723
3405-000,2014,1,30,17,314,268,582,626
3405-000,2014,1,30,18,307,240,547,582
3405-000,2014,1,30,19,212,191,403,547
3405-000,2014,1,30,20,195,139,334,403
3405-000,2014,1,30,21,151,125,276,334
3405-000,2014,1,30,22,111,115,226,276
3405-000,2014,1,30,23,93,74,167,226
3405-000,2014,1,30,24,66,60,126,167
3405-000,2014,1,31,1,32,39,71,126
3405-000,2014,1,31,2,24,24,48,71
3405-000,2014,1,31,3,13,12,25,48
3405-000,2014,1,31,4,21,16,37,25
3405-000,2014,1,31,5,27,18,45,37
3405-000,2014,1,31,6,56,38,94,45
3405-000,2014,1,31,7,189,99,288,94
3405-000,2014,1,31,8,284,210,494,288
3405-000,2014,1,31,9,278,160,438,494
3405-000,2014,1,31,10,341,167,508,438
3405-000,2014,1,31,11,621,303,924,508
3405-000,2014,1,31,12,762,485,1247,924
3405-000,2014,1,31,13,646,715,1361,1247
3405-000,2014,1,31,14,800,667,1467,1361
3405-000,2014,1,31,15,879,740,1619,1467
3405-000,2014,1,31,16,1053,817,1870,1619
3405-000,2014,1,31,17,1054,788,1842,1870
3405-000,2014,1,31,18,825,696,1521,1842
3405-000,2014,1,31,19,685,566,1251,1521
3405-000,2014,1,31,20,460,521,981,1251
3405-000,2014,1,31,21,319,308,627,981
3405-000,2014,1,31,22,201,278,479,627
3405-000,2014,1,31,23,120,203,323,479
3405-000,2014,1,31,24,99,140,239,323
3405-000,2014,2,1,1,52,65,117,239
3405-000,2014,2,1,2,54,48,102,117
3405-000,2014,2,1,3,17,37,54,102
3405-000,2014,2,1,4,21,24,45,54
3405-000,2014,2,1,5,16,28,44,45
3405-000,2014,2,1,6,52,39,91,44
3405-000,2014,2,1,7,67,47,114,91
3405-000,2014,2,1,8,109,93,202,114
3405-000,2014,2,1,9,144,104,248,202
3405-000,2014,2,1,10,207,154,361,248
3405-000,2014,2,1,11,356,245,601,361
3405-000,2014,2,1,12,491,323,814,601
3405-000,2014,2,1,13,474,377,851,814
3405-000,2014,2,1,14,487,419,906,851
3405-000,2014,2,1,15,468,466,934,906
3405-000,2014,2,1,16,491,502,993,934
3405-000,2014,2,1,17,480,488,968,993
3405-000,2014,2,1,18,539,418,957,968
3405-000,2014,2,1,19,427,400,827,957
3405-000,2014,2,1,20,388,324,712,827
3405-000,2014,2,1,21,343,267,610,712
3405-000,2014,2,1,22,201,256,457,610
3405-000,2014,2,1,23,224,152,376,457
3405-000,2014,2,1,24,123,136,259,376
3405-000,2014,2,2,1,62,118,180,259
3405-000,2014,2,2,2,47,53,100,180
3405-000,2014,2,2,3,38,46,84,100
3405-000,2014,2,2,4,24,28,52,84
3405-000,2014,2,2,5,26,28,54,52
3405-000,2014,2,2,6,49,53,102,54
3405-000,2014,2,2,7,64,73,137,102
3405-000,2014,2,2,8,129,102,231,137
3405-000,2014,2,2,9,215,158,373,231
3405-000,2014,2,2,10,255,175,430,373
3405-000,2014,2,2,11,307,277,584,430
3405-000,2014,2,2,12,297,342,639,584
3405-000,2014,2,2,13,302,367,669,639
3405-000,2014,2,2,14,356,424,780,669
3405-000,2014,2,2,15,355,419,774,780
3405-000,2014,2,2,16,352,462,814,774
3405-000,2014,2,2,17,414,475,889,814
3405-000,2014,2,2,18,338,410,748,889
3405-000,2014,2,2,19,245,363,608,748
3405-000,2014,2,2,20,193,274,467,608
3405-000,2014,2,2,21,196,214,410,467
3405-000,2014,2,2,22,151,194,345,410
3405-000,2014,2,2,23,114,205,319,345
3405-000,2014,2,2,24,77,139,216,319
3405-000,2014,2,3,1,53,95,148,216
3405-000,2014,2,3,2,28,67,95,148
3405-000,2014,2,3,3,25,45,70,95
3405-000,2014,2,3,4,33,45,78,70
3405-000,2014,2,3,5,44,75,119,78
3405-000,2014,2,3,6,115,132,247,119
3405-000,2014,2,3,7,298,315,613,247
3405-000,2014,2,3,8,738,942,1680,613
3405-000,2014,2,3,9,857,915,1772,1680
3405-000,2014,2,3,10,645,569,1214,1772
3405-000,2014,2,3,11,783,648,1431,1214
3405-000,2014,2,3,12,643,632,1275,1431
3405-000,2014,2,3,13,614,548,1162,1275
3405-000,2014,2,3,14,668,652,1320,1162
3405-000,2014,2,3,15,746,748,1494,1320
3405-000,2014,2,3,16,726,697,1423,1494
3405-000,2014,2,3,17,673,629,1302,1423
3405-000,2014,2,3,18,707,748,1455,1302
3405-000,2014,2,3,19,729,642,1371,1455
3405-000,2014,2,3,20,494,467,961,1371
3405-000,2014,2,3,21,353,367,720,961
3405-000,2014,2,3,22,290,286,576,720
3405-000,2014,2,3,23,190,166,356,576
3405-000,2014,2,3,24,110,167,277,356
3405-000,2014,2,4,1,80,84,164,277
3405-000,2014,2,4,2,45,71,116,164
3405-000,2014,2,4,3,36,52,88,116
3405-000,2014,2,4,4,36,46,82,88
3405-000,2014,2,4,5,60,68,128,82
3405-000,2014,2,4,6,128,121,249,128
3405-000,2014,2,4,7,291,315,606,249
3405-000,2014,2,4,8,753,873,1626,606
3405-000,2014,2,4,9,971,967,1938,1626
3405-000,2014,2,4,10,831,660,1491,1938
3405-000,2014,2,4,11,843,761,1604,1491
3405-000,2014,2,4,12,813,731,1544,1604
3405-000,2014,2,4,13,604,575,1179,1544
3405-000,2014,2,4,14,710,711,1421,1179
3405-000,2014,2,4,15,851,791,1642,1421
3405-000,2014,2,4,16,852,722,1574,1642
3405-000,2014,2,4,17,769,671,1440,1574
3405-000,2014,2,4,18,835,675,1510,1440
3405-000,2014,2,4,19,799,705,1504,1510
3405-000,2014,2,4,20,530,533,1063,1504
3405-000,2014,2,4,21,461,445,906,1063
3405-000,2014,2,4,22,314,361,675,906
3405-000,2014,2,4,23,195,190,385,675
3405-000,2014,2,4,24,115,130,245,385
3405-000,2014,2,5,1,60,113,173,245
3405-000,2014,2,5,2,60,61,121,173
3405-000,2014,2,5,3,41,58,99,121
3405-000,2014,2,5,4,53,51,104,99
3405-000,2014,2,5,5,61,69,130,104
3405-000,2014,2,5,6,122,117,239,130
3405-000,2014,2,5,7,267,286,553,239
3405-000,2014,2,5,8,753,801,1554,553
3405-000,2014,2,5,9,985,952,1937,1554
3405-000,2014,2,5,10,815,736,1551,1937
3405-000,2014,2,5,11,856,766,1622,1551
3405-000,2014,2,5,12,796,819,1615,1622
3405-000,2014,2,5,13,707,601,1308,1615
3405-000,2014,2,5,14,757,732,1489,1308
3405-000,2014,2,5,15,898,812,1710,1489
3405-000,2014,2,5,16,846,793,1639,1710
3405-000,2014,2,5,17,820,754,1574,1639
3405-000,2014,2,5,18,881,761,1642,1574
3405-000,2014,2,5,19,798,748,1546,1642
3405-000,2014,2,5,20,541,489,1030,1546
3405-000,2014,2,5,21,366,415,781,1030
3405-000,2014,2,5,22,316,323,639,781
3405-000,2014,2,5,23,193,168,361,639
3405-000,2014,2,5,24,123,149,272,361
3405-000,2014,2,6,1,81,92,173,272
3405-000,2014,2,6,2,62,67,129,173
3405-000,2014,2,6,3,42,62,104,129
3405-000,2014,2,6,4,50,54,104,104
3405-000,2014,2,6,5,58,73,131,104
3405-000,2014,2,6,6,118,108,226,131
3405-000,2014,2,6,7,289,293,582,226
3405-000,2014,2,6,8,732,798,1530,582
3405-000,2014,2,6,9,1026,1005,2031,1530
3405-000,2014,2,6,10,881,739,1620,2031
3405-000,2014,2,6,11,882,774,1656,1620
3405-000,2014,2,6,12,809,710,1519,1656
3405-000,2014,2,6,13,698,623,1321,1519
3405-000,2014,2,6,14,779,696,1475,1321
3405-000,2014,2,6,15,905,824,1729,1475
3405-000,2014,2,6,16,883,796,1679,1729
3405-000,2014,2,6,17,874,777,1651,1679
3405-000,2014,2,6,18,881,756,1637,1651
3405-000,2014,2,6,19,794,734,1528,1637
3405-000,2014,2,6,20,543,499,1042,1528
3405-000,2014,2,6,21,423,425,848,1042
3405-000,2014,2,6,22,336,345,681,848
3405-000,2014,2,6,23,183,215,398,681
3405-000,2014,2,6,24,128,138,266,398
3405-000,2014,2,7,1,91,103,194,266
3405-000,2014,2,7,2,59,70,129,194
3405-000,2014,2,7,3,39,59,98,129
3405-000,2014,2,7,4,33,65,98,98
3405-000,2014,2,7,5,58,80,138,98
3405-000,2014,2,7,6,126,106,232,138
3405-000,2014,2,7,7,269,310,579,232
3405-000,2014,2,7,8,770,820,1590,579
3405-000,2014,2,7,9,1026,1007,2033,1590
3405-000,2014,2,7,10,876,708,1584,2033
3405-000,2014,2,7,11,882,789,1671,1584
3405-000,2014,2,7,12,846,757,1603,1671
3405-000,2014,2,7,13,754,639,1393,1603
3405-000,2014,2,7,14,782,786,1568,1393
3405-000,2014,2,7,15,928,886,1814,1568
3405-000,2014,2,7,16,951,813,1764,1814
3405-000,2014,2,7,17,910,774,1684,1764
3405-000,2014,2,7,18,1020,770,1790,1684
3405-000,2014,2,7,19,1101,834,1935,1790
3405-000,2014,2,7,20,753,515,1268,1935
3405-000,2014,2,7,21,477,468,945,1268
3405-000,2014,2,7,22,326,320,646,945
3405-000,2014,2,7,23,231,200,431,646
3405-000,2014,2,7,24,128,180,308,431
3405-000,2014,2,8,1,96,100,196,308
3405-000,2014,2,8,2,52,79,131,196
3405-000,2014,2,8,3,47,54,101,131
3405-000,2014,2,8,4,47,49,96,101
3405-000,2014,2,8,5,66,66,132,96
3405-000,2014,2,8,6,114,103,217,132
3405-000,2014,2,8,7,245,184,429,217
3405-000,2014,2,8,8,495,378,873,429
3405-000,2014,2,8,9,725,527,1252,873
3405-000,2014,2,8,10,616,491,1107,1252
3405-000,2014,2,8,11,712,498,1210,1107
3405-000,2014,2,8,12,635,527,1162,1210
3405-000,2014,2,8,13,554,519,1073,1162
3405-000,2014,2,8,14,572,539,1111,1073
3405-000,2014,2,8,15,592,487,1079,1111
3405-000,2014,2,8,16,549,499,1048,1079
3405-000,2014,2,8,17,550,486,1036,1048
3405-000,2014,2,8,18,603,536,1139,1036
3405-000,2014,2,8,19,501,435,936,1139
3405-000,2014,2,8,20,320,274,594,936
3405-000,2014,2,8,21,239,202,441,594
3405-000,2014,2,8,22,165,158,323,441
3405-000,2014,2,8,23,130,126,256,323
3405-000,2014,2,8,24,107,115,222,256
3405-000,2014,2,9,1,60,57,117,222
3405-000,2014,2,9,2,30,30,60,117
3405-000,2014,2,9,3,34,28,62,60
3405-000,2014,2,9,4,22,27,49,62
3405-000,2014,2,9,5,34,31,65,49
3405-000,2014,2,9,6,51,36,87,65
3405-000,2014,2,9,7,118,75,193,87
3405-000,2014,2,9,8,189,142,331,193
3405-000,2014,2,9,9,266,197,463,331
3405-000,2014,2,9,10,325,191,516,463
3405-000,2014,2,9,11,355,268,623,516
3405-000,2014,2,9,12,337,344,681,623
3405-000,2014,2,9,13,304,320,624,681
3405-000,2014,2,9,14,352,345,697,624
3405-000,2014,2,9,15,385,358,743,697
3405-000,2014,2,9,16,375,435,810,743
3405-000,2014,2,9,17,382,427,809,810
3405-000,2014,2,9,18,365,425,790,809
3405-000,2014,2,9,19,301,363,664,790
3405-000,2014,2,9,20,240,253,493,664
3405-000,2014,2,9,21,204,211,415,493
3405-000,2014,2,9,22,155,205,360,415
3405-000,2014,2,9,23,116,150,266,360
3405-000,2014,2,9,24,77,115,192,266
3405-000,2014,2,10,1,59,105,164,192
3405-000,2014,2,10,2,36,60,96,164
3405-000,2014,2,10,3,21,30,51,96
3405-000,2014,2,10,4,30,47,77,51
3405-000,2014,2,10,5,39,55,94,77
3405-000,2014,2,10,6,121,124,245,94
3405-000,2014,2,10,7,301,245,546,245
3405-000,2014,2,10,8,526,421,947,546
3405-000,2014,2,10,9,809,939,1748,947
3405-000,2014,2,10,10,833,711,1544,1748
3405-000,2014,2,10,11,788,734,1522,1544
3405-000,2014,2,10,12,839,713,1552,1522
3405-000,2014,2,10,13,657,644,1301,1552
3405-000,2014,2,10,14,742,755,1497,1301
3405-000,2014,2,10,15,911,776,1687,1497
3405-000,2014,2,10,16,812,752,1564,1687
3405-000,2014,2,10,17,748,684,1432,1564
3405-000,2014,2,10,18,773,676,1449,1432
3405-000,2014,2,10,19,805,720,1525,1449
3405-000,2014,2,10,20,574,518,1092,1525
3405-000,2014,2,10,21,437,405,842,1092
3405-000,2014,2,10,22,320,345,665,842
3405-000,2014,2,10,23,186,209,395,665
3405-000,2014,2,10,24,123,135,258,395
3405-000,2014,2,11,1,68,99,167,258
3405-000,2014,2,11,2,62,60,122,167
3405-000,2014,2,11,3,28,39,67,122
3405-000,2014,2,11,4,34,57,91,67
3405-000,2014,2,11,5,63,68,131,91
3405-000,2014,2,11,6,129,105,234,131
3405-000,2014,2,11,7,289,284,573,234
3405-000,2014,2,11,8,784,822,1606,573
3405-000,2014,2,11,9,1002,950,1952,1606
3405-000,2014,2,11,10,865,752,1617,1952
3405-000,2014,2,11,11,874,787,1661,1617
3405-000,2014,2,11,12,800,777,1577,1661
3405-000,2014,2,11,13,670,642,1312,1577
3405-000,2014,2,11,14,774,711,1485,1312
3405-000,2014,2,11,15,876,835,1711,1485
3405-000,2014,2,11,16,895,784,1679,1711
3405-000,2014,2,11,17,844,772,1616,1679
3405-000,2014,2,11,18,823,728,1551,1616
3405-000,2014,2,11,19,825,744,1569,1551
3405-000,2014,2,11,20,557,489,1046,1569
3405-000,2014,2,11,21,429,417,846,1046
3405-000,2014,2,11,22,340,283,623,846
3405-000,2014,2,11,23,185,176,361,623
3405-000,2014,2,11,24,135,149,284,361
3405-000,2014,2,12,1,76,99,175,284
3405-000,2014,2,12,2,52,68,120,175
3405-000,2014,2,12,3,49,42,91,120
3405-000,2014,2,12,4,39,47,86,91
3405-000,2014,2,12,5,60,52,112,86
3405-000,2014,2,12,6,123,116,239,112
3405-000,2014,2,12,7,276,317,593,239
3405-000,2014,2,12,8,793,764,1557,593
3405-000,2014,2,12,9,1000,956,1956,1557
3405-000,2014,2,12,10,867,743,1610,1956
3405-000,2014,2,12,11,880,727,1607,1610
3405-000,2014,2,12,12,811,766,1577,1607
3405-000,2014,2,12,13,659,629,1288,1577
3405-000,2014,2,12,14,767,678,1445,1288
3405-000,2014,2,12,15,898,791,1689,1445
3405-000,2014,2,12,16,861,772,1633,1689
3405-000,2014,2,12,17,851,705,1556,1633
3405-000,2014,2,12,18,850,836,1686,1556
3405-000,2014,2,12,19,841,712,1553,1686
3405-000,2014,2,12,20,546,478,1024,1553
3405-000,2014,2,12,21,401,438,839,1024
3405-000,2014,2,12,22,311,308,619,839
3405-000,2014,2,12,23,229,210,439,619
3405-000,2014,2,12,24,126,150,276,439
3405-000,2014,2,13,1,76,114,190,276
3405-000,2014,2,13,2,59,68,127,190
3405-000,2014,2,13,3,48,49,97,127
3405-000,2014,2,13,4,42,73,115,97
3405-000,2014,2,13,5,58,64,122,115
3405-000,2014,2,13,6,114,111,225,122
3405-000,2014,2,13,7,281,272,553,225
3405-000,2014,2,13,8,759,775,1534,553
3405-000,2014,2,13,9,982,1021,2003,1534
3405-000,2014,2,13,10,878,831,1709,2003
3405-000,2014,2,13,11,938,1294,2232,1709
3405-000,2014,2,13,12,941,813,1754,2232
3405-000,2014,2,13,13,700,609,1309,1754
3405-000,2014,2,13,14,805,727,1532,1309
3405-000,2014,2,13,15,886,795,1681,1532
3405-000,2014,2,13,16,864,759,1623,1681
3405-000,2014,2,13,17,845,749,1594,1623
3405-000,2014,2,13,18,837,712,1549,1594
3405-000,2014,2,13,19,841,731,1572,1549
3405-000,2014,2,13,20,562,487,1049,1572
3405-000,2014,2,13,21,455,437,892,1049
3405-000,2014,2,13,22,339,322,661,892
3405-000,2014,2,13,23,237,202,439,661
3405-000,2014,2,13,24,126,141,267,439
3405-000,2014,2,14,1,73,112,185,267
3405-000,2014,2,14,2,56,68,124,185
3405-000,2014,2,14,3,42,48,90,124
3405-000,2014,2,14,4,47,58,105,90
3405-000,2014,2,14,5,65,63,128,105
3405-000,2014,2,14,6,125,109,234,128
3405-000,2014,2,14,7,275,268,543,234
3405-000,2014,2,14,8,770,792,1562,543
3405-000,2014,2,14,9,996,1000,1996,1562
3405-000,2014,2,14,10,940,700,1640,1996
3405-000,2014,2,14,11,916,814,1730,1640
3405-000,2014,2,14,12,893,708,1601,1730
3405-000,2014,2,14,13,697,701,1398,1601
3405-000,2014,2,14,14,754,783,1537,1398
3405-000,2014,2,14,15,951,830,1781,1537
3405-000,2014,2,14,16,883,804,1687,1781
3405-000,2014,2,14,17,937,727,1664,1687
3405-000,2014,2,14,18,953,789,1742,1664
3405-000,2014,2,14,19,1062,804,1866,1742
3405-000,2014,2,14,20,746,548,1294,1866
3405-000,2014,2,14,21,547,468,1015,1294
3405-000,2014,2,14,22,393,510,903,1015
3405-000,2014,2,14,23,225,369,594,903
3405-000,2014,2,14,24,134,174,308,594
3405-000,2014,2,15,1,113,103,216,308
3405-000,2014,2,15,2,66,72,138,216
3405-000,2014,2,15,3,54,37,91,138
3405-000,2014,2,15,4,44,54,98,91
3405-000,2014,2,15,5,76,81,157,98
3405-000,2014,2,15,6,102,101,203,157
3405-000,2014,2,15,7,258,223,481,203
3405-000,2014,2,15,8,545,431,976,481
3405-000,2014,2,15,9,700,534,1234,976
3405-000,2014,2,15,10,782,563,1345,1234
3405-000,2014,2,15,11,773,532,1305,1345
3405-000,2014,2,15,12,701,574,1275,1305
3405-000,2014,2,15,13,558,521,1079,1275
3405-000,2014,2,15,14,648,546,1194,1079
3405-000,2014,2,15,15,559,545,1104,1194
3405-000,2014,2,15,16,658,572,1230,1104
3405-000,2014,2,15,17,648,591,1239,1230
3405-000,2014,2,15,18,686,634,1320,1239
3405-000,2014,2,15,19,607,530,1137,1320
3405-000,2014,2,15,20,330,345,675,1137
3405-000,2014,2,15,21,271,270,541,675
3405-000,2014,2,15,22,243,208,451,541
3405-000,2014,2,15,23,169,163,332,451
3405-000,2014,2,15,24,94,100,194,332
3405-000,2014,2,16,1,64,71,135,194
3405-000,2014,2,16,2,38,44,82,135
3405-000,2014,2,16,3,28,30,58,82
3405-000,2014,2,16,4,27,24,51,58
3405-000,2014,2,16,5,39,35,74,51
3405-000,2014,2,16,6,73,68,141,74
3405-000,2014,2,16,7,140,111,251,141
3405-000,2014,2,16,8,205,192,397,251
3405-000,2014,2,16,9,318,251,569,397
3405-000,2014,2,16,10,371,250,621,569
3405-000,2014,2,16,11,417,370,787,621
3405-000,2014,2,16,12,379,381,760,787
3405-000,2014,2,16,13,371,369,740,760
3405-000,2014,2,16,14,412,480,892,740
3405-000,2014,2,16,15,452,425,877,892
3405-000,2014,2,16,16,452,526,978,877
3405-000,2014,2,16,17,476,480,956,978
3405-000,2014,2,16,18,437,526,963,956
3405-000,2014,2,16,19,349,449,798,963
3405-000,2014,2,16,20,288,303,591,798
3405-000,2014,2,16,21,212,267,479,591
3405-000,2014,2,16,22,238,261,499,479
3405-000,2014,2,16,23,117,208,325,499
3405-000,2014,2,16,24,123,145,268,325
3405-000,2014,2,17,1,39,95,134,268
3405-000,2014,2,17,2,26,60,86,134
3405-000,2014,2,17,3,32,36,68,86
3405-000,2014,2,17,4,36,53,89,68
3405-000,2014,2,17,5,61,70,131,89
3405-000,2014,2,17,6,155,163,318,131
3405-000,2014,2,17,7,395,421,816,318
3405-000,2014,2,17,8,880,1124,2004,816
3405-000,2014,2,17,9,982,1000,1982,2004
3405-000,2014,2,17,10,834,732,1566,1982
3405-000,2014,2,17,11,876,804,1680,1566
3405-000,2014,2,17,12,854,765,1619,1680
3405-000,2014,2,17,13,690,634,1324,1619
3405-000,2014,2,17,14,778,767,1545,1324
3405-000,2014,2,17,15,844,845,1689,1545
3405-000,2014,2,17,16,910,843,1753,1689
3405-000,2014,2,17,17,870,711,1581,1753
3405-000,2014,2,17,18,846,726,1572,1581
3405-000,2014,2,17,19,773,735,1508,1572
3405-000,2014,2,17,20,548,490,1038,1508
3405-000,2014,2,17,21,408,429,837,1038
3405-000,2014,2,17,22,305,341,646,837
3405-000,2014,2,17,23,204,194,398,646
3405-000,2014,2,17,24,103,141,244,398
3405-000,2014,2,18,1,58,96,154,244
3405-000,2014,2,18,2,57,77,134,154
3405-000,2014,2,18,3,42,36,78,134
3405-000,2014,2,18,4,44,50,94,78
3405-000,2014,2,18,5,75,95,170,94
3405-000,2014,2,18,6,145,130,275,170
3405-000,2014,2,18,7,359,328,687,275
3405-000,2014,2,18,8,825,922,1747,687
3405-000,2014,2,18,9,983,942,1925,1747
3405-000,2014,2,18,10,908,791,1699,1925
3405-000,2014,2,18,11,911,770,1681,1699
3405-000,2014,2,18,12,836,796,1632,1681
3405-000,2014,2,18,13,682,616,1298,1632
3405-000,2014,2,18,14,755,777,1532,1298
3405-000,2014,2,18,15,910,786,1696,1532
3405-000,2014,2,18,16,942,780,1722,1696
3405-000,2014,2,18,17,806,698,1504,1722
3405-000,2014,2,18,18,815,738,1553,1504
3405-000,2014,2,18,19,826,709,1535,1553
3405-000,2014,2,18,20,555,501,1056,1535
3405-000,2014,2,18,21,427,416,843,1056
3405-000,2014,2,18,22,294,306,600,843
3405-000,2014,2,18,23,188,171,359,600
3405-000,2014,2,18,24,144,131,275,359
3405-000,2014,2,19,1,66,106,172,275
3405-000,2014,2,19,2,47,62,109,172
3405-000,2014,2,19,3,35,56,91,109
3405-000,2014,2,19,4,43,47,90,91
3405-000,2014,2,19,5,68,88,156,90
3405-000,2014,2,19,6,146,122,268,156
3405-000,2014,2,19,7,304,305,609,268
3405-000,2014,2,19,8,819,933,1752,609
3405-000,2014,2,19,9,1007,968,1975,1752
3405-000,2014,2,19,10,894,725,1619,1975
3405-000,2014,2,19,11,929,729,1658,1619
3405-000,2014,2,19,12,843,717,1560,1658
3405-000,2014,2,19,13,669,647,1316,1560
3405-000,2014,2,19,14,789,784,1573,1316
3405-000,2014,2,19,15,860,754,1614,1573
3405-000,2014,2,19,16,842,759,1601,1614
3405-000,2014,2,19,17,858,705,1563,1601
3405-000,2014,2,19,18,929,802,1731,1563
3405-000,2014,2,19,19,812,762,1574,1731
3405-000,2014,2,19,20,583,486,1069,1574
3405-000,2014,2,19,21,421,396,817,1069
3405-000,2014,2,19,22,308,312,620,817
3405-000,2014,2,19,23,207,214,421,620
3405-000,2014,2,19,24,111,169,280,421
3405-000,2014,2,20,1,56,78,134,280
3405-000,2014,2,20,2,62,81,143,134
3405-000,2014,2,20,3,42,35,77,143
3405-000,2014,2,20,4,51,56,107,77
3405-000,2014,2,20,5,73,68,141,107
3405-000,2014,2,20,6,158,120,278,141
3405-000,2014,2,20,7,339,303,642,278
3405-000,2014,2,20,8,812,912,1724,642
3405-000,2014,2,20,9,1073,983,2056,1724
3405-000,2014,2,20,10,923,786,1709,2056
3405-000,2014,2,20,11,891,792,1683,1709
3405-000,2014,2,20,12,844,760,1604,1683
3405-000,2014,2,20,13,698,631,1329,1604
3405-000,2014,2,20,14,774,759,1533,1329
3405-000,2014,2,20,15,928,793,1721,1533
3405-000,2014,2,20,16,848,813,1661,1721
3405-000,2014,2,20,17,821,742,1563,1661
3405-000,2014,2,20,18,826,795,1621,1563
3405-000,2014,2,20,19,817,704,1521,1621
3405-000,2014,2,20,20,570,505,1075,1521
3405-000,2014,2,20,21,430,409,839,1075
3405-000,2014,2,20,22,280,358,638,839
3405-000,2014,2,20,23,199,219,418,638
3405-000,2014,2,20,24,136,143,279,418
3405-000,2014,2,21,1,71,89,160,279
3405-000,2014,2,21,2,55,63,118,160
3405-000,2014,2,21,3,40,48,88,118
3405-000,2014,2,21,4,50,56,106,88
3405-000,2014,2,21,5,67,73,140,106
3405-000,2014,2,21,6,148,137,285,140
3405-000,2014,2,21,7,345,301,646,285
3405-000,2014,2,21,8,821,895,1716,646
3405-000,2014,2,21,9,1032,969,2001,1716
3405-000,2014,2,21,10,904,785,1689,2001
3405-000,2014,2,21,11,903,773,1676,1689
3405-000,2014,2,21,12,846,729,1575,1676
3405-000,2014,2,21,13,707,643,1350,1575
3405-000,2014,2,21,14,825,803,1628,1350
3405-000,2014,2,21,15,899,822,1721,1628
3405-000,2014,2,21,16,945,714,1659,1721
3405-000,2014,2,21,17,909,714,1623,1659
3405-000,2014,2,21,18,1056,815,1871,1623
3405-000,2014,2,21,19,1045,841,1886,1871
3405-000,2014,2,21,20,760,580,1340,1886
3405-000,2014,2,21,21,490,467,957,1340
3405-000,2014,2,21,22,366,326,692,957
3405-000,2014,2,21,23,237,175,412,692
3405-000,2014,2,21,24,156,171,327,412
3405-000,2014,2,22,1,105,103,208,327
3405-000,2014,2,22,2,59,59,118,208
3405-000,2014,2,22,3,51,58,109,118
3405-000,2014,2,22,4,45,64,109,109
3405-000,2014,2,22,5,56,93,149,109
3405-000,2014,2,22,6,127,109,236,149
3405-000,2014,2,22,7,255,204,459,236
3405-000,2014,2,22,8,568,474,1042,459
3405-000,2014,2,22,9,725,555,1280,1042
3405-000,2014,2,22,10,709,530,1239,1280
3405-000,2014,2,22,11,769,494,1263,1239
3405-000,2014,2,22,12,789,616,1405,1263
3405-000,2014,2,22,13,693,450,1143,1405
3405-000,2014,2,22,14,623,564,1187,1143
3405-000,2014,2,22,15,646,559,1205,1187
3405-000,2014,2,22,16,655,587,1242,1205
3405-000,2014,2,22,17,700,558,1258,1242
3405-000,2014,2,22,18,687,663,1350,1258
3405-000,2014,2,22,19,556,562,1118,1350
3405-000,2014,2,22,20,398,406,804,1118
3405-000,2014,2,22,21,294,291,585,804
3405-000,2014,2,22,22,229,203,432,585
3405-000,2014,2,22,23,179,157,336,432
3405-000,2014,2,22,24,108,124,232,336
3405-000,2014,2,23,1,73,77,150,232
3405-000,2014,2,23,2,36,51,87,150
3405-000,2014,2,23,3,30,43,73,87
3405-000,2014,2,23,4,28,38,66,73
3405-000,2014,2,23,5,31,30,61,66
3405-000,2014,2,23,6,77,50,127,61
3405-000,2014,2,23,7,135,102,237,127
3405-000,2014,2,23,8,241,190,431,237
3405-000,2014,2,23,9,326,251,577,431
3405-000,2014,2,23,10,407,258,665,577
3405-000,2014,2,23,11,435,346,781,665
3405-000,2014,2,23,12,400,344,744,781
3405-000,2014,2,23,13,375,383,758,744
3405-000,2014,2,23,14,375,385,760,758
3405-000,2014,2,23,15,418,426,844,760
3405-000,2014,2,23,16,490,485,975,844
3405-000,2014,2,23,17,429,481,910,975
3405-000,2014,2,23,18,470,589,1059,910
3405-000,2014,2,23,19,378,426,804,1059
3405-000,2014,2,23,20,291,387,678,804
3405-000,2014,2,23,21,205,320,525,678
3405-000,2014,2,23,22,190,270,460,525
3405-000,2014,2,23,23,134,196,330,460
3405-000,2014,2,23,24,80,143,223,330
3405-000,2014,2,24,1,48,93,141,223
3405-000,2014,2,24,2,33,48,81,141
3405-000,2014,2,24,3,26,39,65,81
3405-000,2014,2,24,4,42,55,97,65
3405-000,2014,2,24,5,49,73,122,97
3405-000,2014,2,24,6,155,168,323,122
3405-000,2014,2,24,7,407,426,833,323
3405-000,2014,2,24,8,931,1137,2068,833
3405-000,2014,2,24,9,1003,1013,2016,2068
3405-000,2014,2,24,10,836,760,1596,2016
3405-000,2014,2,24,11,887,812,1699,1596
3405-000,2014,2,24,12,779,742,1521,1699
3405-000,2014,2,24,13,713,739,1452,1521
3405-000,2014,2,24,14,836,831,1667,1452
3405-000,2014,2,24,15,916,847,1763,1667
3405-000,2014,2,24,16,895,817,1712,1763
3405-000,2014,2,24,17,810,757,1567,1712
3405-000,2014,2,24,18,898,796,1694,1567
3405-000,2014,2,24,19,834,745,1579,1694
3405-000,2014,2,24,20,581,533,1114,1579
3405-000,2014,2,24,21,459,439,898,1114
3405-000,2014,2,24,22,317,364,681,898
3405-000,2014,2,24,23,208,189,397,681
3405-000,2014,2,24,24,117,145,262,397
3405-000,2014,2,25,1,55,87,142,262
3405-000,2014,2,25,2,58,70,128,142
3405-000,2014,2,25,3,35,38,73,128
3405-000,2014,2,25,4,38,70,108,73
3405-000,2014,2,25,5,71,79,150,108
3405-000,2014,2,25,6,142,137,279,150
3405-000,2014,2,25,7,343,291,634,279
3405-000,2014,2,25,8,827,923,1750,634
3405-000,2014,2,25,9,976,954,1930,1750
3405-000,2014,2,25,10,985,772,1757,1930
3405-000,2014,2,25,11,1000,795,1795,1757
3405-000,2014,2,25,12,843,815,1658,1795
3405-000,2014,2,25,13,708,701,1409,1658
3405-000,2014,2,25,14,842,814,1656,1409
3405-000,2014,2,25,15,869,884,1753,1656
3405-000,2014,2,25,16,919,790,1709,1753
3405-000,2014,2,25,17,888,825,1713,1709
3405-000,2014,2,25,18,924,808,1732,1713
3405-000,2014,2,25,19,845,750,1595,1732
3405-000,2014,2,25,20,569,579,1148,1595
3405-000,2014,2,25,21,498,463,961,1148
3405-000,2014,2,25,22,353,366,719,961
3405-000,2014,2,25,23,225,198,423,719
3405-000,2014,2,25,24,126,158,284,423
3405-000,2014,2,26,1,76,120,196,284
3405-000,2014,2,26,2,53,86,139,196
3405-000,2014,2,26,3,44,44,88,139
3405-000,2014,2,26,4,48,70,118,88
3405-000,2014,2,26,5,99,80,179,118
3405-000,2014,2,26,6,119,136,255,179
3405-000,2014,2,26,7,339,300,639,255
3405-000,2014,2,26,8,874,945,1819,639
3405-000,2014,2,26,9,971,961,1932,1819
3405-000,2014,2,26,10,921,761,1682,1932
3405-000,2014,2,26,11,931,818,1749,1682
3405-000,2014,2,26,12,890,766,1656,1749
3405-000,2014,2,26,13,754,700,1454,1656
3405-000,2014,2,26,14,814,832,1646,1454
3405-000,2014,2,26,15,925,844,1769,1646
3405-000,2014,2,26,16,912,830,1742,1769
3405-000,2014,2,26,17,859,737,1596,1742
3405-000,2014,2,26,18,946,811,1757,1596
3405-000,2014,2,26,19,871,800,1671,1757
3405-000,2014,2,26,20,614,581,1195,1671
3405-000,2014,2,26,21,430,422,852,1195
3405-000,2014,2,26,22,353,346,699,852
3405-000,2014,2,26,23,229,198,427,699
3405-000,2014,2,26,24,144,136,280,427
3405-000,2014,2,27,1,76,120,196,280
3405-000,2014,2,27,2,46,69,115,196
3405-000,2014,2,27,3,46,56,102,115
3405-000,2014,2,27,4,55,52,107,102
3405-000,2014,2,27,5,80,81,161,107
3405-000,2014,2,27,6,148,141,289,161
3405-000,2014,2,27,7,356,315,671,289
3405-000,2014,2,27,8,862,933,1795,671
3405-000,2014,2,27,9,1070,988,2058,1795
3405-000,2014,2,27,10,901,790,1691,2058
3405-000,2014,2,27,11,959,826,1785,1691
3405-000,2014,2,27,12,867,778,1645,1785
3405-000,2014,2,27,13,702,635,1337,1645
3405-000,2014,2,27,14,856,781,1637,1337
3405-000,2014,2,27,15,963,821,1784,1637
3405-000,2014,2,27,16,924,826,1750,1784
3405-000,2014,2,27,17,838,761,1599,1750
3405-000,2014,2,27,18,940,859,1799,1599
3405-000,2014,2,27,19,851,765,1616,1799
3405-000,2014,2,27,20,570,500,1070,1616
3405-000,2014,2,27,21,469,505,974,1070
3405-000,2014,2,27,22,308,461,769,974
3405-000,2014,2,27,23,220,261,481,769
3405-000,2014,2,27,24,149,169,318,481
3405-000,2014,2,28,1,88,107,195,318
3405-000,2014,2,28,2,50,91,141,195
3405-000,2014,2,28,3,41,45,86,141
3405-000,2014,2,28,4,55,55,110,86
3405-000,2014,2,28,5,73,93,166,110
3405-000,2014,2,28,6,153,131,284,166
3405-000,2014,2,28,7,349,327,676,284
3405-000,2014,2,28,8,873,891,1764,676
3405-000,2014,2,28,9,1012,1006,2018,1764
3405-000,2014,2,28,10,933,769,1702,2018
3405-000,2014,2,28,11,956,795,1751,1702
3405-000,2014,2,28,12,894,779,1673,1751
3405-000,2014,2,28,13,729,713,1442,1673
3405-000,2014,2,28,14,794,785,1579,1442
3405-000,2014,2,28,15,929,822,1751,1579
3405-000,2014,2,28,16,980,794,1774,1751
3405-000,2014,2,28,17,927,765,1692,1774
3405-000,2014,2,28,18,1018,861,1879,1692
3405-000,2014,2,28,19,1103,847,1950,1879
3405-000,2014,2,28,20,741,645,1386,1950
3405-000,2014,2,28,21,578,505,1083,1386
3405-000,2014,2,28,22,409,363,772,1083
3405-000,2014,2,28,23,286,221,507,772
3405-000,2014,2,28,24,167,151,318,507
3405-000,2014,3,1,1,85,118,203,318
3405-000,2014,3,1,2,81,74,155,203
3405-000,2014,3,1,3,62,57,119,155
3405-000,2014,3,1,4,53,57,110,119
3405-000,2014,3,1,5,60,79,139,110
3405-000,2014,3,1,6,131,124,255,139
3405-000,2014,3,1,7,295,219,514,255
3405-000,2014,3,1,8,539,432,971,514
3405-000,2014,3,1,9,640,503,1143,971
3405-000,2014,3,1,10,676,512,1188,1143
3405-000,2014,3,1,11,719,556,1275,1188
3405-000,2014,3,1,12,753,645,1398,1275
3405-000,2014,3,1,13,677,580,1257,1398
3405-000,2014,3,1,14,629,571,1200,1257
3405-000,2014,3,1,15,658,574,1232,1200
3405-000,2014,3,1,16,635,563,1198,1232
3405-000,2014,3,1,17,620,600,1220,1198
3405-000,2014,3,1,18,693,728,1421,1220
3405-000,2014,3,1,19,559,547,1106,1421
3405-000,2014,3,1,20,425,475,900,1106
3405-000,2014,3,1,21,286,324,610,900
3405-000,2014,3,1,22,216,260,476,610
3405-000,2014,3,1,23,167,184,351,476
3405-000,2014,3,1,24,113,142,255,351
3405-000,2014,3,2,1,65,66,131,255
3405-000,2014,3,2,2,38,50,88,131
3405-000,2014,3,2,3,27,23,50,88
3405-000,2014,3,2,4,25,26,51,50
3405-000,2014,3,2,5,33,34,67,51
3405-000,2014,3,2,6,61,47,108,67
3405-000,2014,3,2,7,147,104,251,108
3405-000,2014,3,2,8,240,191,431,251
3405-000,2014,3,2,9,312,244,556,431
3405-000,2014,3,2,10,383,284,667,556
3405-000,2014,3,2,11,457,388,845,667
3405-000,2014,3,2,12,464,424,888,845
3405-000,2014,3,2,13,412,404,816,888
3405-000,2014,3,2,14,460,483,943,816
3405-000,2014,3,2,15,463,524,987,943
3405-000,2014,3,2,16,522,597,1119,987
3405-000,2014,3,2,17,552,629,1181,1119
3405-000,2014,3,2,18,517,626,1143,1181
3405-000,2014,3,2,19,451,583,1034,1143
3405-000,2014,3,2,20,392,474,866,1034
3405-000,2014,3,2,21,314,457,771,866
3405-000,2014,3,2,22,271,448,719,771
3405-000,2014,3,2,23,160,236,396,719
3405-000,2014,3,2,24,116,170,286,396
3405-000,2014,3,3,1,55,84,139,286
3405-000,2014,3,3,2,32,63,95,139
3405-000,2014,3,3,3,27,46,73,95
3405-000,2014,3,3,4,27,50,77,73
3405-000,2014,3,3,5,64,83,147,77
3405-000,2014,3,3,6,167,202,369,147
3405-000,2014,3,3,7,412,469,881,369
3405-000,2014,3,3,8,920,1243,2163,881
3405-000,2014,3,3,9,973,1045,2018,2163
3405-000,2014,3,3,10,898,744,1642,2018
3405-000,2014,3,3,11,862,772,1634,1642
3405-000,2014,3,3,12,818,802,1620,1634
3405-000,2014,3,3,13,675,662,1337,1620
3405-000,2014,3,3,14,800,830,1630,1337
3405-000,2014,3,3,15,909,866,1775,1630
3405-000,2014,3,3,16,836,799,1635,1775
3405-000,2014,3,3,17,850,771,1621,1635
3405-000,2014,3,3,18,953,836,1789,1621
3405-000,2014,3,3,19,869,726,1595,1789
3405-000,2014,3,3,20,588,566,1154,1595
3405-000,2014,3,3,21,466,477,943,1154
3405-000,2014,3,3,22,328,349,677,943
3405-000,2014,3,3,23,214,208,422,677
3405-000,2014,3,3,24,128,133,261,422
3405-000,2014,3,4,1,67,90,157,261
3405-000,2014,3,4,2,45,67,112,157
3405-000,2014,3,4,3,37,49,86,112
3405-000,2014,3,4,4,50,64,114,86
3405-000,2014,3,4,5,78,93,171,114
3405-000,2014,3,4,6,142,160,302,171
3405-000,2014,3,4,7,353,348,701,302
3405-000,2014,3,4,8,856,959,1815,701
3405-000,2014,3,4,9,1042,1038,2080,1815
3405-000,2014,3,4,10,934,763,1697,2080
3405-000,2014,3,4,11,971,766,1737,1697
3405-000,2014,3,4,12,828,757,1585,1737
3405-000,2014,3,4,13,697,670,1367,1585
3405-000,2014,3,4,14,809,786,1595,1367
3405-000,2014,3,4,15,917,872,1789,1595
3405-000,2014,3,4,16,966,853,1819,1789
3405-000,2014,3,4,17,831,732,1563,1819
3405-000,2014,3,4,18,886,789,1675,1563
3405-000,2014,3,4,19,802,746,1548,1675
3405-000,2014,3,4,20,586,532,1118,1548
3405-000,2014,3,4,21,452,457,909,1118
3405-000,2014,3,4,22,322,331,653,909
3405-000,2014,3,4,23,199,186,385,653
3405-000,2014,3,4,24,131,128,259,385
3405-000,2014,3,5,1,78,82,160,259
3405-000,2014,3,5,2,57,81,138,160
3405-000,2014,3,5,3,40,62,102,138
3405-000,2014,3,5,4,43,54,97,102
3405-000,2014,3,5,5,79,78,157,97
3405-000,2014,3,5,6,150,155,305,157
3405-000,2014,3,5,7,344,318,662,305
3405-000,2014,3,5,8,859,975,1834,662
3405-000,2014,3,5,9,1039,987,2026,1834
3405-000,2014,3,5,10,929,793,1722,2026
3405-000,2014,3,5,11,962,784,1746,1722
3405-000,2014,3,5,12,883,779,1662,1746
3405-000,2014,3,5,13,685,629,1314,1662
3405-000,2014,3,5,14,790,776,1566,1314
3405-000,2014,3,5,15,927,844,1771,1566
3405-000,2014,3,5,16,918,827,1745,1771
3405-000,2014,3,5,17,848,760,1608,1745
3405-000,2014,3,5,18,882,816,1698,1608
3405-000,2014,3,5,19,892,797,1689,1698
3405-000,2014,3,5,20,559,580,1139,1689
3405-000,2014,3,5,21,427,409,836,1139
3405-000,2014,3,5,22,359,287,646,836
3405-000,2014,3,5,23,197,193,390,646
3405-000,2014,3,5,24,138,147,285,390
3405-000,2014,3,6,1,76,74,150,285
3405-000,2014,3,6,2,44,66,110,150
3405-000,2014,3,6,3,46,55,101,110
3405-000,2014,3,6,4,43,55,98,101
3405-000,2014,3,6,5,70,84,154,98
3405-000,2014,3,6,6,148,129,277,154
3405-000,2014,3,6,7,338,357,695,277
3405-000,2014,3,6,8,823,978,1801,695
3405-000,2014,3,6,9,1016,1049,2065,1801
3405-000,2014,3,6,10,908,813,1721,2065
3405-000,2014,3,6,11,938,822,1760,1721
3405-000,2014,3,6,12,844,838,1682,1760
3405-000,2014,3,6,13,709,645,1354,1682
3405-000,2014,3,6,14,796,784,1580,1354
3405-000,2014,3,6,15,930,901,1831,1580
3405-000,2014,3,6,16,938,819,1757,1831
3405-000,2014,3,6,17,879,759,1638,1757
3405-000,2014,3,6,18,897,822,1719,1638
3405-000,2014,3,6,19,830,821,1651,1719
3405-000,2014,3,6,20,586,495,1081,1651
3405-000,2014,3,6,21,453,470,923,1081
3405-000,2014,3,6,22,346,341,687,923
3405-000,2014,3,6,23,204,209,413,687
3405-000,2014,3,6,24,119,135,254,413
3405-000,2014,3,7,1,87,94,181,254
3405-000,2014,3,7,2,46,66,112,181
3405-000,2014,3,7,3,37,52,89,112
3405-000,2014,3,7,4,43,55,98,89
3405-000,2014,3,7,5,83,92,175,98
3405-000,2014,3,7,6,130,124,254,175
3405-000,2014,3,7,7,334,328,662,254
3405-000,2014,3,7,8,816,989,1805,662
3405-000,2014,3,7,9,1073,986,2059,1805
3405-000,2014,3,7,10,931,787,1718,2059
3405-000,2014,3,7,11,925,790,1715,1718
3405-000,2014,3,7,12,847,721,1568,1715
3405-000,2014,3,7,13,751,670,1421,1568
3405-000,2014,3,7,14,835,738,1573,1421
3405-000,2014,3,7,15,904,912,1816,1573
3405-000,2014,3,7,16,971,860,1831,1816
3405-000,2014,3,7,17,998,761,1759,1831
3405-000,2014,3,7,18,1091,803,1894,1759
3405-000,2014,3,7,19,1053,865,1918,1894
3405-000,2014,3,7,20,724,593,1317,1918
3405-000,2014,3,7,21,549,482,1031,1317
3405-000,2014,3,7,22,401,351,752,1031
3405-000,2014,3,7,23,228,227,455,752
3405-000,2014,3,7,24,164,159,323,455
3405-000,2014,3,8,1,97,79,176,323
3405-000,2014,3,8,2,74,73,147,176
3405-000,2014,3,8,3,51,47,98,147
3405-000,2014,3,8,4,44,62,106,98
3405-000,2014,3,8,5,67,85,152,106
3405-000,2014,3,8,6,137,113,250,152
3405-000,2014,3,8,7,307,227,534,250
3405-000,2014,3,8,8,594,469,1063,534
3405-000,2014,3,8,9,719,628,1347,1063
3405-000,2014,3,8,10,740,569,1309,1347
3405-000,2014,3,8,11,756,605,1361,1309
3405-000,2014,3,8,12,701,565,1266,1361
3405-000,2014,3,8,13,629,566,1195,1266
3405-000,2014,3,8,14,604,542,1146,1195
3405-000,2014,3,8,15,687,573,1260,1146
3405-000,2014,3,8,16,676,587,1263,1260
3405-000,2014,3,8,17,669,535,1204,1263
3405-000,2014,3,8,18,729,667,1396,1204
3405-000,2014,3,8,19,578,522,1100,1396
3405-000,2014,3,8,20,417,346,763,1100
3405-000,2014,3,8,21,280,252,532,763
3405-000,2014,3,8,22,201,210,411,532
3405-000,2014,3,8,23,153,147,300,411
3405-000,2014,3,8,24,99,102,201,300
3405-000,2014,3,9,1,47,72,119,201
3405-000,2014,3,9,2,42,36,78,119
3405-000,2014,3,9,3,28,20,48,78
3405-000,2014,3,9,4,23,28,51,48
3405-000,2014,3,9,5,28,25,53,51
3405-000,2014,3,9,6,68,45,113,53
3405-000,2014,3,9,7,113,76,189,113
3405-000,2014,3,9,8,212,174,386,189
3405-000,2014,3,9,9,249,222,471,386
3405-000,2014,3,9,10,307,252,559,471
3405-000,2014,3,9,11,386,302,688,559
3405-000,2014,3,9,12,351,355,706,688
3405-000,2014,3,9,13,352,363,715,706
3405-000,2014,3,9,14,409,368,777,715
3405-000,2014,3,9,15,421,388,809,777
3405-000,2014,3,9,16,461,463,924,809
3405-000,2014,3,9,17,457,465,922,924
3405-000,2014,3,9,18,379,438,817,922
3405-000,2014,3,9,19,362,410,772,817
3405-000,2014,3,9,20,276,343,619,772
3405-000,2014,3,9,21,255,282,537,619
3405-000,2014,3,9,22,196,267,463,537
3405-000,2014,3,9,23,125,188,313,463
3405-000,2014,3,9,24,85,124,209,313
3405-000,2014,3,10,1,42,96,138,209
3405-000,2014,3,10,2,32,52,84,138
3405-000,2014,3,10,3,20,43,63,84
3405-000,2014,3,10,4,43,52,95,63
3405-000,2014,3,10,5,60,71,131,95
3405-000,2014,3,10,6,157,142,299,131
3405-000,2014,3,10,7,389,486,875,299
3405-000,2014,3,10,8,884,1243,2127,875
3405-000,2014,3,10,9,975,1033,2008,2127
3405-000,2014,3,10,10,839,726,1565,2008
3405-000,2014,3,10,11,865,749,1614,1565
3405-000,2014,3,10,12,869,787,1656,1614
3405-000,2014,3,10,13,687,682,1369,1656
3405-000,2014,3,10,14,730,791,1521,1369
3405-000,2014,3,10,15,883,799,1682,1521
3405-000,2014,3,10,16,892,825,1717,1682
3405-000,2014,3,10,17,840,744,1584,1717
3405-000,2014,3,10,18,930,808,1738,1584
3405-000,2014,3,10,19,850,728,1578,1738
3405-000,2014,3,10,20,618,581,1199,1578
3405-000,2014,3,10,21,475,432,907,1199
3405-000,2014,3,10,22,372,348,720,907
3405-000,2014,3,10,23,208,253,461,720
3405-000,2014,3,10,24,152,121,273,461
3405-000,2014,3,11,1,64,94,158,273
3405-000,2014,3,11,2,40,74,114,158
3405-000,2014,3,11,3,38,60,98,114
3405-000,2014,3,11,4,52,58,110,98
3405-000,2014,3,11,5,64,77,141,110
3405-000,2014,3,11,6,148,152,300,141
3405-000,2014,3,11,7,380,344,724,300
3405-000,2014,3,11,8,872,1004,1876,724
3405-000,2014,3,11,9,1050,1014,2064,1876
3405-000,2014,3,11,10,891,749,1640,2064
3405-000,2014,3,11,11,949,820,1769,1640
3405-000,2014,3,11,12,875,758,1633,1769
3405-000,2014,3,11,13,692,666,1358,1633
3405-000,2014,3,11,14,842,708,1550,1358
3405-000,2014,3,11,15,852,862,1714,1550
3405-000,2014,3,11,16,916,825,1741,1714
3405-000,2014,3,11,17,857,803,1660,1741
3405-000,2014,3,11,18,877,775,1652,1660
3405-000,2014,3,11,19,918,772,1690,1652
3405-000,2014,3,11,20,603,548,1151,1690
3405-000,2014,3,11,21,497,453,950,1151
3405-000,2014,3,11,22,359,331,690,950
3405-000,2014,3,11,23,206,208,414,690
3405-000,2014,3,11,24,120,133,253,414
3405-000,2014,3,12,1,83,100,183,253
3405-000,2014,3,12,2,53,75,128,183
3405-000,2014,3,12,3,29,53,82,128
3405-000,2014,3,12,4,46,50,96,82
3405-000,2014,3,12,5,58,77,135,96
3405-000,2014,3,12,6,146,135,281,135
3405-000,2014,3,12,7,339,335,674,281
3405-000,2014,3,12,8,795,959,1754,674
3405-000,2014,3,12,9,1028,1028,2056,1754
3405-000,2014,3,12,10,876,774,1650,2056
3405-000,2014,3,12,11,940,822,1762,1650
3405-000,2014,3,12,12,872,769,1641,1762
3405-000,2014,3,12,13,647,629,1276,1641
3405-000,2014,3,12,14,734,721,1455,1276
3405-000,2014,3,12,15,851,805,1656,1455
3405-000,2014,3,12,16,858,732,1590,1656
3405-000,2014,3,12,17,820,681,1501,1590
3405-000,2014,3,12,18,840,750,1590,1501
3405-000,2014,3,12,19,805,745,1550,1590
3405-000,2014,3,12,20,533,541,1074,1550
3405-000,2014,3,12,21,382,373,755,1074
3405-000,2014,3,12,22,289,262,551,755
3405-000,2014,3,12,23,186,169,355,551
3405-000,2014,3,12,24,124,136,260,355
3405-000,2014,3,13,1,66,99,165,260
3405-000,2014,3,13,2,53,69,122,165
3405-000,2014,3,13,3,33,50,83,122
3405-000,2014,3,13,4,46,45,91,83
3405-000,2014,3,13,5,70,76,146,91
3405-000,2014,3,13,6,145,135,280,146
3405-000,2014,3,13,7,342,326,668,280
3405-000,2014,3,13,8,798,920,1718,668
3405-000,2014,3,13,9,1029,1052,2081,1718
3405-000,2014,3,13,10,855,733,1588,2081
3405-000,2014,3,13,11,899,826,1725,1588
3405-000,2014,3,13,12,850,770,1620,1725
3405-000,2014,3,13,13,730,667,1397,1620
3405-000,2014,3,13,14,808,742,1550,1397
3405-000,2014,3,13,15,941,816,1757,1550
3405-000,2014,3,13,16,869,763,1632,1757
3405-000,2014,3,13,17,882,761,1643,1632
3405-000,2014,3,13,18,894,745,1639,1643
3405-000,2014,3,13,19,823,782,1605,1639
3405-000,2014,3,13,20,574,525,1099,1605
3405-000,2014,3,13,21,445,436,881,1099
3405-000,2014,3,13,22,336,350,686,881
3405-000,2014,3,13,23,226,177,403,686
3405-000,2014,3,13,24,130,155,285,403
3405-000,2014,3,14,1,71,88,159,285
3405-000,2014,3,14,2,64,62,126,159
3405-000,2014,3,14,3,47,47,94,126
3405-000,2014,3,14,4,38,60,98,94
3405-000,2014,3,14,5,61,96,157,98
3405-000,2014,3,14,6,158,147,305,157
3405-000,2014,3,14,7,343,300,643,305
3405-000,2014,3,14,8,825,948,1773,643
3405-000,2014,3,14,9,1055,1000,2055,1773
3405-000,2014,3,14,10,968,813,1781,2055
3405-000,2014,3,14,11,941,842,1783,1781
3405-000,2014,3,14,12,870,736,1606,1783
3405-000,2014,3,14,13,761,679,1440,1606
3405-000,2014,3,14,14,887,792,1679,1440
3405-000,2014,3,14,15,920,885,1805,1679
3405-000,2014,3,14,16,1019,870,1889,1805
3405-000,2014,3,14,17,1014,788,1802,1889
3405-000,2014,3,14,18,1064,869,1933,1802
3405-000,2014,3,14,19,1229,910,2139,1933
3405-000,2014,3,14,20,807,585,1392,2139
3405-000,2014,3,14,21,574,497,1071,1392
3405-000,2014,3,14,22,439,350,789,1071
3405-000,2014,3,14,23,250,203,453,789
3405-000,2014,3,14,24,166,154,320,453
3405-000,2014,3,15,1,71,90,161,320
3405-000,2014,3,15,2,61,74,135,161
3405-000,2014,3,15,3,41,40,81,135
3405-000,2014,3,15,4,39,58,97,81
3405-000,2014,3,15,5,62,72,134,97
3405-000,2014,3,15,6,145,108,253,134
3405-000,2014,3,15,7,310,237,547,253
3405-000,2014,3,15,8,599,470,1069,547
3405-000,2014,3,15,9,767,617,1384,1069
3405-000,2014,3,15,10,768,565,1333,1384
3405-000,2014,3,15,11,818,663,1481,1333
3405-000,2014,3,15,12,702,577,1279,1481
3405-000,2014,3,15,13,657,567,1224,1279
3405-000,2014,3,15,14,616,584,1200,1224
3405-000,2014,3,15,15,666,538,1204,1200
3405-000,2014,3,15,16,655,600,1255,1204
3405-000,2014,3,15,17,639,752,1391,1255
3405-000,2014,3,15,18,784,670,1454,1391
3405-000,2014,3,15,19,625,505,1130,1454
3405-000,2014,3,15,20,420,346,766,1130
3405-000,2014,3,15,21,332,307,639,766
3405-000,2014,3,15,22,263,229,492,639
3405-000,2014,3,15,23,174,183,357,492
3405-000,2014,3,15,24,138,106,244,357
3405-000,2014,3,16,1,81,75,156,244
3405-000,2014,3,16,2,81,45,126,156
3405-000,2014,3,16,3,32,29,61,126
3405-000,2014,3,16,4,25,25,50,61
3405-000,2014,3,16,5,36,32,68,50
3405-000,2014,3,16,6,79,51,130,68
3405-000,2014,3,16,7,153,105,258,130
3405-000,2014,3,16,8,282,257,539,258
3405-000,2014,3,16,9,307,254,561,539
3405-000,2014,3,16,10,403,264,667,561
3405-000,2014,3,16,11,485,362,847,667
3405-000,2014,3,16,12,428,401,829,847
3405-000,2014,3,16,13,398,411,809,829
3405-000,2014,3,16,14,429,437,866,809
3405-000,2014,3,16,15,477,486,963,866
3405-000,2014,3,16,16,524,469,993,963
3405-000,2014,3,16,17,519,552,1071,993
3405-000,2014,3,16,18,524,559,1083,1071
3405-000,2014,3,16,19,461,435,896,1083
3405-000,2014,3,16,20,350,401,751,896
3405-000,2014,3,16,21,246,350,596,751
3405-000,2014,3,16,22,209,298,507,596
3405-000,2014,3,16,23,155,214,369,507
3405-000,2014,3,16,24,105,132,237,369
3405-000,2014,3,17,1,61,75,136,237
3405-000,2014,3,17,2,28,47,75,136
3405-000,2014,3,17,3,29,43,72,75
3405-000,2014,3,17,4,41,44,85,72
3405-000,2014,3,17,5,57,63,120,85
3405-000,2014,3,17,6,171,158,329,120
3405-000,2014,3,17,7,418,445,863,329
3405-000,2014,3,17,8,914,1193,2107,863
3405-000,2014,3,17,9,1048,1134,2182,2107
3405-000,2014,3,17,10,841,811,1652,2182
3405-000,2014,3,17,11,938,762,1700,1652
3405-000,2014,3,17,12,810,807,1617,1700
3405-000,2014,3,17,13,709,702,1411,1617
3405-000,2014,3,17,14,746,789,1535,1411
3405-000,2014,3,17,15,889,822,1711,1535
3405-000,2014,3,17,16,946,895,1841,1711
3405-000,2014,3,17,17,902,800,1702,1841
3405-000,2014,3,17,18,908,769,1677,1702
3405-000,2014,3,17,19,850,725,1575,1677
3405-000,2014,3,17,20,585,540,1125,1575
3405-000,2014,3,17,21,407,472,879,1125
3405-000,2014,3,17,22,309,337,646,879
3405-000,2014,3,17,23,203,182,385,646
3405-000,2014,3,17,24,126,146,272,385
3405-000,2014,3,18,1,78,103,181,272
3405-000,2014,3,18,2,47,53,100,181
3405-000,2014,3,18,3,49,61,110,100
3405-000,2014,3,18,4,51,56,107,110
3405-000,2014,3,18,5,79,76,155,107
3405-000,2014,3,18,6,142,118,260,155
3405-000,2014,3,18,7,386,324,710,260
3405-000,2014,3,18,8,831,970,1801,710
3405-000,2014,3,18,9,979,1052,2031,1801
3405-000,2014,3,18,10,979,770,1749,2031
3405-000,2014,3,18,11,944,834,1778,1749
3405-000,2014,3,18,12,882,805,1687,1778
3405-000,2014,3,18,13,776,710,1486,1687
3405-000,2014,3,18,14,808,806,1614,1486
3405-000,2014,3,18,15,967,864,1831,1614
3405-000,2014,3,18,16,994,844,1838,1831
3405-000,2014,3,18,17,933,799,1732,1838
3405-000,2014,3,18,18,888,853,1741,1732
3405-000,2014,3,18,19,846,803,1649,1741
3405-000,2014,3,18,20,588,530,1118,1649
3405-000,2014,3,18,21,440,443,883,1118
3405-000,2014,3,18,22,398,352,750,883
3405-000,2014,3,18,23,213,198,411,750
3405-000,2014,3,18,24,135,157,292,411
3405-000,2014,3,19,1,85,79,164,292
3405-000,2014,3,19,2,58,71,129,164
3405-000,2014,3,19,3,43,63,106,129
3405-000,2014,3,19,4,32,52,84,106
3405-000,2014,3,19,5,62,83,145,84
3405-000,2014,3,19,6,165,156,321,145
3405-000,2014,3,19,7,345,409,754,321
3405-000,2014,3,19,8,911,1011,1922,754
3405-000,2014,3,19,9,1094,1020,2114,1922
3405-000,2014,3,19,10,966,802,1768,2114
3405-000,2014,3,19,11,948,864,1812,1768
3405-000,2014,3,19,12,917,845,1762,1812
3405-000,2014,3,19,13,767,737,1504,1762
3405-000,2014,3,19,14,827,825,1652,1504
3405-000,2014,3,19,15,915,883,1798,1652
3405-000,2014,3,19,16,981,831,1812,1798
3405-000,2014,3,19,17,936,766,1702,1812
3405-000,2014,3,19,18,1003,861,1864,1702
3405-000,2014,3,19,19,930,811,1741,1864
3405-000,2014,3,19,20,547,530,1077,1741
3405-000,2014,3,19,21,428,402,830,1077
3405-000,2014,3,19,22,339,302,641,830
3405-000,2014,3,19,23,181,201,382,641
3405-000,2014,3,19,24,134,143,277,382
3405-000,2014,3,20,1,81,95,176,277
3405-000,2014,3,20,2,58,59,117,176
3405-000,2014,3,20,3,37,44,81,117
3405-000,2014,3,20,4,44,52,96,81
3405-000,2014,3,20,5,67,79,146,96
3405-000,2014,3,20,6,150,142,292,146
3405-000,2014,3,20,7,355,347,702,292
3405-000,2014,3,20,8,810,956,1766,702
3405-000,2014,3,20,9,1071,1047,2118,1766
3405-000,2014,3,20,10,887,779,1666,2118
3405-000,2014,3,20,11,937,803,1740,1666
3405-000,2014,3,20,12,878,764,1642,1740
3405-000,2014,3,20,13,715,624,1339,1642
3405-000,2014,3,20,14,805,726,1531,1339
3405-000,2014,3,20,15,981,902,1883,1531
3405-000,2014,3,20,16,910,788,1698,1883
3405-000,2014,3,20,17,909,792,1701,1698
3405-000,2014,3,20,18,926,795,1721,1701
3405-000,2014,3,20,19,891,819,1710,1721
3405-000,2014,3,20,20,634,575,1209,1710
3405-000,2014,3,20,21,447,478,925,1209
3405-000,2014,3,20,22,354,324,678,925
3405-000,2014,3,20,23,221,187,408,678
3405-000,2014,3,20,24,134,129,263,408
3405-000,2014,3,21,1,87,110,197,263
3405-000,2014,3,21,2,52,57,109,197
3405-000,2014,3,21,3,42,52,94,109
3405-000,2014,3,21,4,38,47,85,94
3405-000,2014,3,21,5,54,90,144,85
3405-000,2014,3,21,6,150,125,275,144
3405-000,2014,3,21,7,359,320,679,275
3405-000,2014,3,21,8,828,963,1791,679
3405-000,2014,3,21,9,1066,1021,2087,1791
3405-000,2014,3,21,10,911,737,1648,2087
3405-000,2014,3,21,11,977,840,1817,1648
3405-000,2014,3,21,12,917,776,1693,1817
3405-000,2014,3,21,13,705,661,1366,1693
3405-000,2014,3,21,14,837,772,1609,1366
3405-000,2014,3,21,15,948,832,1780,1609
3405-000,2014,3,21,16,983,875,1858,1780
3405-000,2014,3,21,17,948,777,1725,1858
3405-000,2014,3,21,18,1017,900,1917,1725
3405-000,2014,3,21,19,1216,865,2081,1917
3405-000,2014,3,21,20,765,617,1382,2081
3405-000,2014,3,21,21,550,490,1040,1382
3405-000,2014,3,21,22,404,314,718,1040
3405-000,2014,3,21,23,257,207,464,718
3405-000,2014,3,21,24,155,167,322,464
3405-000,2014,3,22,1,98,87,185,322
3405-000,2014,3,22,2,61,76,137,185
3405-000,2014,3,22,3,45,48,93,137
3405-000,2014,3,22,4,46,57,103,93
3405-000,2014,3,22,5,66,76,142,103
3405-000,2014,3,22,6,161,122,283,142
3405-000,2014,3,22,7,307,244,551,283
3405-000,2014,3,22,8,591,504,1095,551
3405-000,2014,3,22,9,783,620,1403,1095
3405-000,2014,3,22,10,773,583,1356,1403
3405-000,2014,3,22,11,769,579,1348,1356
3405-000,2014,3,22,12,733,643,1376,1348
3405-000,2014,3,22,13,647,545,1192,1376
3405-000,2014,3,22,14,628,606,1234,1192
3405-000,2014,3,22,15,747,633,1380,1234
3405-000,2014,3,22,16,726,596,1322,1380
3405-000,2014,3,22,17,749,649,1398,1322
3405-000,2014,3,22,18,800,698,1498,1398
3405-000,2014,3,22,19,678,573,1251,1498
3405-000,2014,3,22,20,413,448,861,1251
3405-000,2014,3,22,21,321,273,594,861
3405-000,2014,3,22,22,246,247,493,594
3405-000,2014,3,22,23,188,173,361,493
3405-000,2014,3,22,24,133,122,255,361
3405-000,2014,3,23,1,92,74,166,255
3405-000,2014,3,23,2,56,54,110,166
3405-000,2014,3,23,3,37,34,71,110
3405-000,2014,3,23,4,31,33,64,71
3405-000,2014,3,23,5,39,32,71,64
3405-000,2014,3,23,6,70,47,117,71
3405-000,2014,3,23,7,149,101,250,117
3405-000,2014,3,23,8,249,234,483,250
3405-000,2014,3,23,9,365,297,662,483
3405-000,2014,3,23,10,375,282,657,662
3405-000,2014,3,23,11,464,386,850,657
3405-000,2014,3,23,12,397,417,814,850
3405-000,2014,3,23,13,399,393,792,814
3405-000,2014,3,23,14,487,412,899,792
3405-000,2014,3,23,15,477,459,936,899
3405-000,2014,3,23,16,459,528,987,936
3405-000,2014,3,23,17,449,522,971,987
3405-000,2014,3,23,18,520,565,1085,971
3405-000,2014,3,23,19,458,446,904,1085
3405-000,2014,3,23,20,359,455,814,904
3405-000,2014,3,23,21,247,328,575,814
3405-000,2014,3,23,22,247,313,560,575
3405-000,2014,3,23,23,146,217,363,560
3405-000,2014,3,23,24,103,161,264,363
3405-000,2014,3,24,1,73,83,156,264
3405-000,2014,3,24,2,50,50,100,156
3405-000,2014,3,24,3,32,50,82,100
3405-000,2014,3,24,4,34,50,84,82
3405-000,2014,3,24,5,63,68,131,84
3405-000,2014,3,24,6,160,175,335,131
3405-000,2014,3,24,7,427,480,907,335
3405-000,2014,3,24,8,931,1273,2204,907
3405-000,2014,3,24,9,1068,1151,2219,2204
3405-000,2014,3,24,10,877,782,1659,2219
3405-000,2014,3,24,11,912,800,1712,1659
3405-000,2014,3,24,12,892,763,1655,1712
3405-000,2014,3,24,13,700,660,1360,1655
3405-000,2014,3,24,14,786,789,1575,1360
3405-000,2014,3,24,15,973,872,1845,1575
3405-000,2014,3,24,16,882,843,1725,1845
3405-000,2014,3,24,17,898,742,1640,1725
3405-000,2014,3,24,18,841,795,1636,1640
3405-000,2014,3,24,19,889,825,1714,1636
3405-000,2014,3,24,20,624,565,1189,1714
3405-000,2014,3,24,21,473,457,930,1189
3405-000,2014,3,24,22,340,344,684,930
3405-000,2014,3,24,23,208,196,404,684
3405-000,2014,3,24,24,116,143,259,404
3405-000,2014,3,25,1,70,98,168,259
3405-000,2014,3,25,2,66,52,118,168
3405-000,2014,3,25,3,33,60,93,118
3405-000,2014,3,25,4,42,57,99,93
3405-000,2014,3,25,5,65,87,152,99
3405-000,2014,3,25,6,158,144,302,152
3405-000,2014,3,25,7,375,359,734,302
3405-000,2014,3,25,8,869,1020,1889,734
3405-000,2014,3,25,9,1039,1058,2097,1889
3405-000,2014,3,25,10,963,753,1716,2097
3405-000,2014,3,25,11,936,803,1739,1716
3405-000,2014,3,25,12,866,778,1644,1739
3405-000,2014,3,25,13,674,692,1366,1644
3405-000,2014,3,25,14,808,762,1570,1366
3405-000,2014,3,25,15,874,881,1755,1570
3405-000,2014,3,25,16,945,827,1772,1755
3405-000,2014,3,25,17,876,811,1687,1772
3405-000,2014,3,25,18,947,814,1761,1687
3405-000,2014,3,25,19,853,831,1684,1761
3405-000,2014,3,25,20,590,559,1149,1684
3405-000,2014,3,25,21,465,433,898,1149
3405-000,2014,3,25,22,323,357,680,898
3405-000,2014,3,25,23,215,188,403,680
3405-000,2014,3,25,24,134,156,290,403
3405-000,2014,3,26,1,79,93,172,290
3405-000,2014,3,26,2,73,68,141,172
3405-000,2014,3,26,3,38,63,101,141
3405-000,2014,3,26,4,35,52,87,101
3405-000,2014,3,26,5,60,82,142,87
3405-000,2014,3,26,6,153,125,278,142
3405-000,2014,3,26,7,379,324,703,278
3405-000,2014,3,26,8,818,930,1748,703
3405-000,2014,3,26,9,1049,1019,2068,1748
3405-000,2014,3,26,10,889,787,1676,2068
3405-000,2014,3,26,11,902,868,1770,1676
3405-000,2014,3,26,12,874,796,1670,1770
3405-000,2014,3,26,13,709,698,1407,1670
3405-000,2014,3,26,14,848,803,1651,1407
3405-000,2014,3,26,15,897,796,1693,1651
3405-000,2014,3,26,16,939,788,1727,1693
3405-000,2014,3,26,17,901,797,1698,1727
3405-000,2014,3,26,18,936,814,1750,1698
3405-000,2014,3,26,19,917,841,1758,1750
3405-000,2014,3,26,20,588,581,1169,1758
3405-000,2014,3,26,21,482,408,890,1169
3405-000,2014,3,26,22,354,317,671,890
3405-000,2014,3,26,23,223,219,442,671
3405-000,2014,3,26,24,160,149,309,442
3405-000,2014,3,27,1,95,91,186,309
3405-000,2014,3,27,2,44,72,116,186
3405-000,2014,3,27,3,34,69,103,116
3405-000,2014,3,27,4,37,53,90,103
3405-000,2014,3,27,5,70,95,165,90
3405-000,2014,3,27,6,152,145,297,165
3405-000,2014,3,27,7,427,359,786,297
3405-000,2014,3,27,8,888,995,1883,786
3405-000,2014,3,27,9,1108,1103,2211,1883
3405-000,2014,3,27,10,970,783,1753,2211
3405-000,2014,3,27,11,951,857,1808,1753
3405-000,2014,3,27,12,856,839,1695,1808
3405-000,2014,3,27,13,791,686,1477,1695
3405-000,2014,3,27,14,839,828,1667,1477
3405-000,2014,3,27,15,911,804,1715,1667
3405-000,2014,3,27,16,882,853,1735,1715
3405-000,2014,3,27,17,934,780,1714,1735
3405-000,2014,3,27,18,998,841,1839,1714
3405-000,2014,3,27,19,830,808,1638,1839
3405-000,2014,3,27,20,590,593,1183,1638
3405-000,2014,3,27,21,464,473,937,1183
3405-000,2014,3,27,22,342,344,686,937
3405-000,2014,3,27,23,227,226,453,686
3405-000,2014,3,27,24,145,160,305,453
3405-000,2014,3,28,1,91,77,168,305
3405-000,2014,3,28,2,73,74,147,168
3405-000,2014,3,28,3,49,69,118,147
3405-000,2014,3,28,4,52,62,114,118
3405-000,2014,3,28,5,86,85,171,114
3405-000,2014,3,28,6,164,152,316,171
3405-000,2014,3,28,7,387,347,734,316
3405-000,2014,3,28,8,838,959,1797,734
3405-000,2014,3,28,9,1063,1064,2127,1797
3405-000,2014,3,28,10,948,788,1736,2127
3405-000,2014,3,28,11,999,844,1843,1736
3405-000,2014,3,28,12,927,819,1746,1843
3405-000,2014,3,28,13,740,741,1481,1746
3405-000,2014,3,28,14,882,756,1638,1481
3405-000,2014,3,28,15,992,864,1856,1638
3405-000,2014,3,28,16,913,846,1759,1856
3405-000,2014,3,28,17,1011,786,1797,1759
3405-000,2014,3,28,18,1027,934,1961,1797
3405-000,2014,3,28,19,1184,851,2035,1961
3405-000,2014,3,28,20,763,689,1452,2035
3405-000,2014,3,28,21,549,509,1058,1452
3405-000,2014,3,28,22,384,353,737,1058
3405-000,2014,3,28,23,261,211,472,737
3405-000,2014,3,28,24,162,158,320,472
3405-000,2014,3,29,1,97,119,216,320
3405-000,2014,3,29,2,76,75,151,216
3405-000,2014,3,29,3,57,64,121,151
3405-000,2014,3,29,4,47,70,117,121
3405-000,2014,3,29,5,77,82,159,117
3405-000,2014,3,29,6,142,127,269,159
3405-000,2014,3,29,7,350,268,618,269
3405-000,2014,3,29,8,584,434,1018,618
3405-000,2014,3,29,9,733,616,1349,1018
3405-000,2014,3,29,10,762,568,1330,1349
3405-000,2014,3,29,11,804,577,1381,1330
3405-000,2014,3,29,12,713,629,1342,1381
3405-000,2014,3,29,13,642,538,1180,1342
3405-000,2014,3,29,14,590,544,1134,1180
3405-000,2014,3,29,15,732,564,1296,1134
3405-000,2014,3,29,16,643,588,1231,1296
3405-000,2014,3,29,17,715,551,1266,1231
3405-000,2014,3,29,18,739,680,1419,1266
3405-000,2014,3,29,19,563,525,1088,1419
3405-000,2014,3,29,20,354,378,732,1088
3405-000,2014,3,29,21,313,275,588,732
3405-000,2014,3,29,22,199,227,426,588
3405-000,2014,3,29,23,174,172,346,426
3405-000,2014,3,29,24,109,113,222,346
3405-000,2014,3,30,1,75,84,159,222
3405-000,2014,3,30,2,42,45,87,159
3405-000,2014,3,30,3,26,25,51,87
3405-000,2014,3,30,4,27,33,60,51
3405-000,2014,3,30,5,36,35,71,60
3405-000,2014,3,30,6,84,61,145,71
3405-000,2014,3,30,7,177,119,296,145
3405-000,2014,3,30,8,266,245,511,296
3405-000,2014,3,30,9,336,286,622,511
3405-000,2014,3,30,10,456,298,754,622
3405-000,2014,3,30,11,485,389,874,754
3405-000,2014,3,30,12,466,415,881,874
3405-000,2014,3,30,13,433,407,840,881
3405-000,2014,3,30,14,441,427,868,840
3405-000,2014,3,30,15,459,466,925,868
3405-000,2014,3,30,16,501,489,990,925
3405-000,2014,3,30,17,508,548,1056,990
3405-000,2014,3,30,18,464,616,1080,1056
3405-000,2014,3,30,19,435,525,960,1080
3405-000,2014,3,30,20,370,444,814,960
3405-000,2014,3,30,21,306,409,715,814
3405-000,2014,3,30,22,272,299,571,715
3405-000,2014,3,30,23,172,240,412,571
3405-000,2014,3,30,24,112,151,263,412
3405-000,2014,3,31,1,56,109,165,263
3405-000,2014,3,31,2,48,67,115,165
3405-000,2014,3,31,3,26,49,75,115
3405-000,2014,3,31,4,37,66,103,75
3405-000,2014,3,31,5,53,80,133,103
3405-000,2014,3,31,6,161,182,343,133
3405-000,2014,3,31,7,474,534,1008,343
3405-000,2014,3,31,8,881,1205,2086,1008
3405-000,2014,3,31,9,1043,1166,2209,2086
3405-000,2014,3,31,10,828,741,1569,2209
3405-000,2014,3,31,11,962,800,1762,1569
3405-000,2014,3,31,12,799,758,1557,1762
3405-000,2014,3,31,13,673,616,1289,1557
3405-000,2014,3,31,14,738,743,1481,1289
3405-000,2014,3,31,15,862,859,1721,1481
3405-000,2014,3,31,16,869,789,1658,1721
3405-000,2014,3,31,17,815,803,1618,1658
3405-000,2014,3,31,18,920,768,1688,1618
3405-000,2014,3,31,19,873,804,1677,1688
3405-000,2014,3,31,20,611,604,1215,1677
3405-000,2014,3,31,21,495,498,993,1215
3405-000,2014,3,31,22,377,392,769,993
3405-000,2014,3,31,23,260,214,474,769
3405-000,2014,3,31,24,160,150,310,474
3405-000,2014,4,1,1,76,92,168,310
3405-000,2014,4,1,2,53,70,123,168
3405-000,2014,4,1,3,41,62,103,123
3405-000,2014,4,1,4,51,70,121,103
3405-000,2014,4,1,5,78,88,166,121
3405-000,2014,4,1,6,152,145,297,166
3405-000,2014,4,1,7,425,404,829,297
3405-000,2014,4,1,8,876,994,1870,829
3405-000,2014,4,1,9,1086,1072,2158,1870
3405-000,2014,4,1,10,941,782,1723,2158
3405-000,2014,4,1,11,958,774,1732,1723
3405-000,2014,4,1,12,870,759,1629,1732
3405-000,2014,4,1,13,692,670,1362,1629
3405-000,2014,4,1,14,818,803,1621,1362
3405-000,2014,4,1,15,930,894,1824,1621
3405-000,2014,4,1,16,895,837,1732,1824
3405-000,2014,4,1,17,952,791,1743,1732
3405-000,2014,4,1,18,889,863,1752,1743
3405-000,2014,4,1,19,936,801,1737,1752
3405-000,2014,4,1,20,607,531,1138,1737
3405-000,2014,4,1,21,451,502,953,1138
3405-000,2014,4,1,22,388,316,704,953
3405-000,2014,4,1,23,202,208,410,704
3405-000,2014,4,1,24,148,179,327,410
3405-000,2014,4,2,1,77,85,162,327
3405-000,2014,4,2,2,57,64,121,162
3405-000,2014,4,2,3,49,58,107,121
3405-000,2014,4,2,4,52,69,121,107
3405-000,2014,4,2,5,70,91,161,121
3405-000,2014,4,2,6,161,137,298,161
3405-000,2014,4,2,7,433,397,830,298
3405-000,2014,4,2,8,845,982,1827,830
3405-000,2014,4,2,9,1110,1028,2138,1827
3405-000,2014,4,2,10,948,727,1675,2138
3405-000,2014,4,2,11,951,827,1778,1675
3405-000,2014,4,2,12,905,775,1680,1778
3405-000,2014,4,2,13,667,649,1316,1680
3405-000,2014,4,2,14,785,823,1608,1316
3405-000,2014,4,2,15,874,884,1758,1608
3405-000,2014,4,2,16,903,846,1749,1758
3405-000,2014,4,2,17,950,775,1725,1749
3405-000,2014,4,2,18,970,870,1840,1725
3405-000,2014,4,2,19,930,859,1789,1840
3405-000,2014,4,2,20,609,547,1156,1789
3405-000,2014,4,2,21,421,437,858,1156
3405-000,2014,4,2,22,346,325,671,858
3405-000,2014,4,2,23,240,235,475,671
3405-000,2014,4,2,24,133,155,288,475
3405-000,2014,4,3,1,88,91,179,288
3405-000,2014,4,3,2,51,77,128,179
3405-000,2014,4,3,3,51,64,115,128
3405-000,2014,4,3,4,33,65,98,115
3405-000,2014,4,3,5,59,88,147,98
3405-000,2014,4,3,6,150,172,322,147
3405-000,2014,4,3,7,379,397,776,322
3405-000,2014,4,3,8,844,970,1814,776
3405-000,2014,4,3,9,1069,1035,2104,1814
3405-000,2014,4,3,10,951,772,1723,2104
3405-000,2014,4,3,11,1026,801,1827,1723
3405-000,2014,4,3,12,826,748,1574,1827
3405-000,2014,4,3,13,748,681,1429,1574
3405-000,2014,4,3,14,770,763,1533,1429
3405-000,2014,4,3,15,920,888,1808,1533
3405-000,2014,4,3,16,929,821,1750,1808
3405-000,2014,4,3,17,905,756,1661,1750
3405-000,2014,4,3,18,869,766,1635,1661
3405-000,2014,4,3,19,861,804,1665,1635
3405-000,2014,4,3,20,559,512,1071,1665
3405-000,2014,4,3,21,444,471,915,1071
3405-000,2014,4,3,22,323,354,677,915
3405-000,2014,4,3,23,225,227,452,677
3405-000,2014,4,3,24,148,154,302,452
3405-000,2014,4,4,1,69,90,159,302
3405-000,2014,4,4,2,65,65,130,159
3405-000,2014,4,4,3,40,60,100,130
3405-000,2014,4,4,4,60,64,124,100
3405-000,2014,4,4,5,75,80,155,124
3405-000,2014,4,4,6,153,165,318,155
3405-000,2014,4,4,7,394,393,787,318
3405-000,2014,4,4,8,839,958,1797,787
3405-000,2014,4,4,9,1103,1099,2202,1797
3405-000,2014,4,4,10,991,766,1757,2202
3405-000,2014,4,4,11,906,839,1745,1757
3405-000,2014,4,4,12,918,763,1681,1745
3405-000,2014,4,4,13,800,713,1513,1681
3405-000,2014,4,4,14,801,776,1577,1513
3405-000,2014,4,4,15,952,860,1812,1577
3405-000,2014,4,4,16,1026,918,1944,1812
3405-000,2014,4,4,17,966,814,1780,1944
3405-000,2014,4,4,18,1171,906,2077,1780
3405-000,2014,4,4,19,1295,943,2238,2077
3405-000,2014,4,4,20,810,691,1501,2238
3405-000,2014,4,4,21,564,588,1152,1501
3405-000,2014,4,4,22,411,379,790,1152
3405-000,2014,4,4,23,281,212,493,790
3405-000,2014,4,4,24,193,176,369,493
3405-000,2014,4,5,1,90,88,178,369
3405-000,2014,4,5,2,67,61,128,178
3405-000,2014,4,5,3,45,46,91,128
3405-000,2014,4,5,4,50,65,115,91
3405-000,2014,4,5,5,60,78,138,115
3405-000,2014,4,5,6,164,155,319,138
3405-000,2014,4,5,7,367,295,662,319
3405-000,2014,4,5,8,655,485,1140,662
3405-000,2014,4,5,9,781,625,1406,1140
3405-000,2014,4,5,10,801,671,1472,1406
3405-000,2014,4,5,11,959,755,1714,1472
3405-000,2014,4,5,12,1119,805,1924,1714
3405-000,2014,4,5,13,935,706,1641,1924
3405-000,2014,4,5,14,948,741,1689,1641
3405-000,2014,4,5,15,915,858,1773,1689
3405-000,2014,4,5,16,752,804,1556,1773
3405-000,2014,4,5,17,670,617,1287,1556
3405-000,2014,4,5,18,688,670,1358,1287
3405-000,2014,4,5,19,598,621,1219,1358
3405-000,2014,4,5,20,458,428,886,1219
3405-000,2014,4,5,21,303,326,629,886
3405-000,2014,4,5,22,276,243,519,629
3405-000,2014,4,5,23,168,167,335,519
3405-000,2014,4,5,24,105,129,234,335
3405-000,2014,4,6,1,69,83,152,234
3405-000,2014,4,6,2,33,39,72,152
3405-000,2014,4,6,3,23,28,51,72
3405-000,2014,4,6,4,26,23,49,51
3405-000,2014,4,6,5,27,34,61,49
3405-000,2014,4,6,6,79,66,145,61
3405-000,2014,4,6,7,186,135,321,145
3405-000,2014,4,6,8,324,213,537,321
3405-000,2014,4,6,9,389,324,713,537
3405-000,2014,4,6,10,495,324,819,713
3405-000,2014,4,6,11,501,410,911,819
3405-000,2014,4,6,12,465,398,863,911
3405-000,2014,4,6,13,421,440,861,863
3405-000,2014,4,6,14,460,488,948,861
3405-000,2014,4,6,15,464,485,949,948
3405-000,2014,4,6,16,516,600,1116,949
3405-000,2014,4,6,17,504,602,1106,1116
3405-000,2014,4,6,18,542,593,1135,1106
3405-000,2014,4,6,19,454,553,1007,1135
3405-000,2014,4,6,20,368,485,853,1007
3405-000,2014,4,6,21,335,398,733,853
3405-000,2014,4,6,22,284,384,668,733
3405-000,2014,4,6,23,217,260,477,668
3405-000,2014,4,6,24,132,179,311,477
3405-000,2014,4,7,1,61,95,156,311
3405-000,2014,4,7,2,36,68,104,156
3405-000,2014,4,7,3,35,53,88,104
3405-000,2014,4,7,4,37,57,94,88
3405-000,2014,4,7,5,68,93,161,94
3405-000,2014,4,7,6,162,188,350,161
3405-000,2014,4,7,7,441,503,944,350
3405-000,2014,4,7,8,931,1224,2155,944
3405-000,2014,4,7,9,1121,1209,2330,2155
3405-000,2014,4,7,10,873,865,1738,2330
3405-000,2014,4,7,11,851,795,1646,1738
3405-000,2014,4,7,12,917,767,1684,1646
3405-000,2014,4,7,13,680,653,1333,1684
3405-000,2014,4,7,14,852,769,1621,1333
3405-000,2014,4,7,15,942,853,1795,1621
3405-000,2014,4,7,16,880,839,1719,1795
3405-000,2014,4,7,17,868,781,1649,1719
3405-000,2014,4,7,18,933,754,1687,1649
3405-000,2014,4,7,19,847,806,1653,1687
3405-000,2014,4,7,20,583,598,1181,1653
3405-000,2014,4,7,21,498,488,986,1181
3405-000,2014,4,7,22,368,380,748,986
3405-000,2014,4,7,23,225,226,451,748
3405-000,2014,4,7,24,126,132,258,451
3405-000,2014,4,8,1,85,89,174,258
3405-000,2014,4,8,2,47,72,119,174
3405-000,2014,4,8,3,32,56,88,119
3405-000,2014,4,8,4,46,68,114,88
3405-000,2014,4,8,5,79,103,182,114
3405-000,2014,4,8,6,146,135,281,182
3405-000,2014,4,8,7,406,393,799,281
3405-000,2014,4,8,8,903,944,1847,799
3405-000,2014,4,8,9,1052,1058,2110,1847
3405-000,2014,4,8,10,995,784,1779,2110
3405-000,2014,4,8,11,915,868,1783,1779
3405-000,2014,4,8,12,904,822,1726,1783
3405-000,2014,4,8,13,782,694,1476,1726
3405-000,2014,4,8,14,805,795,1600,1476
3405-000,2014,4,8,15,908,900,1808,1600
3405-000,2014,4,8,16,970,853,1823,1808
3405-000,2014,4,8,17,901,768,1669,1823
3405-000,2014,4,8,18,976,834,1810,1669
3405-000,2014,4,8,19,847,799,1646,1810
3405-000,2014,4,8,20,628,568,1196,1646
3405-000,2014,4,8,21,504,545,1049,1196
3405-000,2014,4,8,22,348,350,698,1049
3405-000,2014,4,8,23,245,261,506,698
3405-000,2014,4,8,24,128,143,271,506
3405-000,2014,4,9,1,85,107,192,271
3405-000,2014,4,9,2,50,60,110,192
3405-000,2014,4,9,3,40,64,104,110
3405-000,2014,4,9,4,43,57,100,104
3405-000,2014,4,9,5,60,82,142,100
3405-000,2014,4,9,6,149,145,294,142
3405-000,2014,4,9,7,389,370,759,294
3405-000,2014,4,9,8,852,912,1764,759
3405-000,2014,4,9,9,1069,1038,2107,1764
3405-000,2014,4,9,10,963,816,1779,2107
3405-000,2014,4,9,11,971,823,1794,1779
3405-000,2014,4,9,12,905,771,1676,1794
3405-000,2014,4,9,13,741,657,1398,1676
3405-000,2014,4,9,14,830,815,1645,1398
3405-000,2014,4,9,15,960,849,1809,1645
3405-000,2014,4,9,16,920,879,1799,1809
3405-000,2014,4,9,17,882,812,1694,1799
3405-000,2014,4,9,18,985,882,1867,1694
3405-000,2014,4,9,19,951,845,1796,1867
3405-000,2014,4,9,20,606,601,1207,1796
3405-000,2014,4,9,21,501,474,975,1207
3405-000,2014,4,9,22,324,293,617,975
3405-000,2014,4,9,23,206,236,442,617
3405-000,2014,4,9,24,152,133,285,442
3405-000,2014,4,10,1,88,109,197,285
3405-000,2014,4,10,2,42,61,103,197
3405-000,2014,4,10,3,37,57,94,103
3405-000,2014,4,10,4,39,70,109,94
3405-000,2014,4,10,5,72,88,160,109
3405-000,2014,4,10,6,149,163,312,160
3405-000,2014,4,10,7,422,396,818,312
3405-000,2014,4,10,8,883,1022,1905,818
3405-000,2014,4,10,9,1091,1100,2191,1905
3405-000,2014,4,10,10,971,805,1776,2191
3405-000,2014,4,10,11,1012,859,1871,1776
3405-000,2014,4,10,12,878,816,1694,1871
3405-000,2014,4,10,13,734,677,1411,1694
3405-000,2014,4,10,14,813,758,1571,1411
3405-000,2014,4,10,15,937,914,1851,1571
3405-000,2014,4,10,16,995,772,1767,1851
3405-000,2014,4,10,17,913,827,1740,1767
3405-000,2014,4,10,18,978,828,1806,1740
3405-000,2014,4,10,19,859,818,1677,1806
3405-000,2014,4,10,20,634,622,1256,1677
3405-000,2014,4,10,21,468,473,941,1256
3405-000,2014,4,10,22,350,331,681,941
3405-000,2014,4,10,23,229,241,470,681
3405-000,2014,4,10,24,146,151,297,470
3405-000,2014,4,11,1,97,77,174,297
3405-000,2014,4,11,2,57,90,147,174
3405-000,2014,4,11,3,46,57,103,147
3405-000,2014,4,11,4,59,65,124,103
3405-000,2014,4,11,5,72,85,157,124
3405-000,2014,4,11,6,158,160,318,157
3405-000,2014,4,11,7,419,389,808,318
3405-000,2014,4,11,8,911,964,1875,808
3405-000,2014,4,11,9,1134,1043,2177,1875
3405-000,2014,4,11,10,979,777,1756,2177
3405-000,2014,4,11,11,925,853,1778,1756
3405-000,2014,4,11,12,888,781,1669,1778
3405-000,2014,4,11,13,772,664,1436,1669
3405-000,2014,4,11,14,804,743,1547,1436
3405-000,2014,4,11,15,932,883,1815,1547
3405-000,2014,4,11,16,934,882,1816,1815
3405-000,2014,4,11,17,944,751,1695,1816
3405-000,2014,4,11,18,1066,883,1949,1695
3405-000,2014,4,11,19,1185,923,2108,1949
3405-000,2014,4,11,20,798,627,1425,2108
3405-000,2014,4,11,21,548,476,1024,1425
3405-000,2014,4,11,22,407,357,764,1024
3405-000,2014,4,11,23,290,217,507,764
3405-000,2014,4,11,24,172,183,355,507
3405-000,2014,4,12,1,109,106,215,355
3405-000,2014,4,12,2,77,75,152,215
3405-000,2014,4,12,3,46,73,119,152
3405-000,2014,4,12,4,50,54,104,119
3405-000,2014,4,12,5,66,92,158,104
3405-000,2014,4,12,6,162,119,281,158
3405-000,2014,4,12,7,347,280,627,281
3405-000,2014,4,12,8,649,484,1133,627
3405-000,2014,4,12,9,784,575,1359,1133
3405-000,2014,4,12,10,737,543,1280,1359
3405-000,2014,4,12,11,817,727,1544,1280
3405-000,2014,4,12,12,947,711,1658,1544
3405-000,2014,4,12,13,724,619,1343,1658
3405-000,2014,4,12,14,659,588,1247,1343
3405-000,2014,4,12,15,661,603,1264,1247
3405-000,2014,4,12,16,665,582,1247,1264
3405-000,2014,4,12,17,683,596,1279,1247
3405-000,2014,4,12,18,767,679,1446,1279
3405-000,2014,4,12,19,678,566,1244,1446
3405-000,2014,4,12,20,395,431,826,1244
3405-000,2014,4,12,21,337,303,640,826
3405-000,2014,4,12,22,236,246,482,640
3405-000,2014,4,12,23,189,190,379,482
3405-000,2014,4,12,24,117,128,245,379
3405-000,2014,4,13,1,80,92,172,245
3405-000,2014,4,13,2,59,44,103,172
3405-000,2014,4,13,3,27,33,60,103
3405-000,2014,4,13,4,36,18,54,60
3405-000,2014,4,13,5,42,33,75,54
3405-000,2014,4,13,6,76,50,126,75
3405-000,2014,4,13,7,165,107,272,126
3405-000,2014,4,13,8,285,235,520,272
3405-000,2014,4,13,9,373,264,637,520
3405-000,2014,4,13,10,400,309,709,637
3405-000,2014,4,13,11,452,365,817,709
3405-000,2014,4,13,12,449,408,857,817
3405-000,2014,4,13,13,437,409,846,857
3405-000,2014,4,13,14,436,418,854,846
3405-000,2014,4,13,15,490,519,1009,854
3405-000,2014,4,13,16,471,528,999,1009
3405-000,2014,4,13,17,523,579,1102,999
3405-000,2014,4,13,18,547,617,1164,1102
3405-000,2014,4,13,19,473,660,1133,1164
3405-000,2014,4,13,20,392,603,995,1133
3405-000,2014,4,13,21,314,370,684,995
3405-000,2014,4,13,22,251,331,582,684
3405-000,2014,4,13,23,173,253,426,582
3405-000,2014,4,13,24,80,160,240,426
3405-000,2014,4,14,1,60,94,154,240
3405-000,2014,4,14,2,33,67,100,154
3405-000,2014,4,14,3,24,48,72,100
3405-000,2014,4,14,4,40,64,104,72
3405-000,2014,4,14,5,74,66,140,104
3405-000,2014,4,14,6,172,175,347,140
3405-000,2014,4,14,7,472,490,962,347
3405-000,2014,4,14,8,896,1246,2142,962
3405-000,2014,4,14,9,1100,1191,2291,2142
3405-000,2014,4,14,10,899,803,1702,2291
3405-000,2014,4,14,11,907,778,1685,1702
3405-000,2014,4,14,12,892,825,1717,1685
3405-000,2014,4,14,13,728,639,1367,1717
3405-000,2014,4,14,14,771,771,1542,1367
3405-000,2014,4,14,15,856,886,1742,1542
3405-000,2014,4,14,16,918,865,1783,1742
3405-000,2014,4,14,17,898,798,1696,1783
3405-000,2014,4,14,18,928,828,1756,1696
3405-000,2014,4,14,19,923,834,1757,1756
3405-000,2014,4,14,20,614,626,1240,1757
3405-000,2014,4,14,21,513,527,1040,1240
3405-000,2014,4,14,22,350,350,700,1040
3405-000,2014,4,14,23,252,233,485,700
3405-000,2014,4,14,24,136,154,290,485
3405-000,2014,4,15,1,104,91,195,290
3405-000,2014,4,15,2,65,73,138,195
3405-000,2014,4,15,3,43,71,114,138
3405-000,2014,4,15,4,48,55,103,114
3405-000,2014,4,15,5,69,104,173,103
3405-000,2014,4,15,6,154,145,299,173
3405-000,2014,4,15,7,403,400,803,299
3405-000,2014,4,15,8,896,1067,1963,803
3405-000,2014,4,15,9,1039,1046,2085,1963
3405-000,2014,4,15,10,1006,798,1804,2085
3405-000,2014,4,15,11,966,846,1812,1804
3405-000,2014,4,15,12,935,800,1735,1812
3405-000,2014,4,15,13,728,712,1440,1735
3405-000,2014,4,15,14,832,754,1586,1440
3405-000,2014,4,15,15,961,890,1851,1586
3405-000,2014,4,15,16,948,829,1777,1851
3405-000,2014,4,15,17,884,802,1686,1777
3405-000,2014,4,15,18,959,845,1804,1686
3405-000,2014,4,15,19,951,829,1780,1804
3405-000,2014,4,15,20,610,596,1206,1780
3405-000,2014,4,15,21,471,469,940,1206
3405-000,2014,4,15,22,340,343,683,940
3405-000,2014,4,15,23,215,223,438,683
3405-000,2014,4,15,24,141,149,290,438
3405-000,2014,4,16,1,81,107,188,290
3405-000,2014,4,16,2,57,63,120,188
3405-000,2014,4,16,3,64,53,117,120
3405-000,2014,4,16,4,40,54,94,117
3405-000,2014,4,16,5,75,83,158,94
3405-000,2014,4,16,6,155,136,291,158
3405-000,2014,4,16,7,403,383,786,291
3405-000,2014,4,16,8,840,966,1806,786
3405-000,2014,4,16,9,1057,1100,2157,1806
3405-000,2014,4,16,10,960,788,1748,2157
3405-000,2014,4,16,11,906,811,1717,1748
3405-000,2014,4,16,12,922,801,1723,1717
3405-000,2014,4,16,13,760,697,1457,1723
3405-000,2014,4,16,14,833,783,1616,1457
3405-000,2014,4,16,15,876,902,1778,1616
3405-000,2014,4,16,16,936,851,1787,1778
3405-000,2014,4,16,17,884,772,1656,1787
3405-000,2014,4,16,18,1041,862,1903,1656
3405-000,2014,4,16,19,970,887,1857,1903
3405-000,2014,4,16,20,605,596,1201,1857
3405-000,2014,4,16,21,454,414,868,1201
3405-000,2014,4,16,22,356,337,693,868
3405-000,2014,4,16,23,244,244,488,693
3405-000,2014,4,16,24,162,160,322,488
3405-000,2014,4,17,1,88,103,191,322
3405-000,2014,4,17,2,65,74,139,191
3405-000,2014,4,17,3,56,57,113,139
3405-000,2014,4,17,4,44,71,115,113
3405-000,2014,4,17,5,74,100,174,115
3405-000,2014,4,17,6,150,146,296,174
3405-000,2014,4,17,7,434,402,836,296
3405-000,2014,4,17,8,875,929,1804,836
3405-000,2014,4,17,9,1050,1067,2117,1804
3405-000,2014,4,17,10,906,773,1679,2117
3405-000,2014,4,17,11,947,801,1748,1679
3405-000,2014,4,17,12,879,797,1676,1748
3405-000,2014,4,17,13,713,673,1386,1676
3405-000,2014,4,17,14,800,827,1627,1386
3405-000,2014,4,17,15,946,895,1841,1627
3405-000,2014,4,17,16,920,820,1740,1841
3405-000,2014,4,17,17,876,740,1616,1740
3405-000,2014,4,17,18,927,773,1700,1616
3405-000,2014,4,17,19,851,774,1625,1700
3405-000,2014,4,17,20,584,552,1136,1625
3405-000,2014,4,17,21,428,458,886,1136
3405-000,2014,4,17,22,312,336,648,886
3405-000,2014,4,17,23,216,218,434,648
3405-000,2014,4,17,24,134,150,284,434
3405-000,2014,4,18,1,80,83,163,284
3405-000,2014,4,18,2,50,64,114,163
3405-000,2014,4,18,3,44,43,87,114
3405-000,2014,4,18,4,38,60,98,87
3405-000,2014,4,18,5,82,92,174,98
3405-000,2014,4,18,6,172,147,319,174
3405-000,2014,4,18,7,370,401,771,319
3405-000,2014,4,18,8,821,882,1703,771
3405-000,2014,4,18,9,1087,1060,2147,1703
3405-000,2014,4,18,10,934,742,1676,2147
3405-000,2014,4,18,11,934,860,1794,1676
3405-000,2014,4,18,12,875,814,1689,1794
3405-000,2014,4,18,13,734,613,1347,1689
3405-000,2014,4,18,14,800,747,1547,1347
3405-000,2014,4,18,15,917,855,1772,1547
3405-000,2014,4,18,16,962,779,1741,1772
3405-000,2014,4,18,17,1016,816,1832,1741
3405-000,2014,4,18,18,1097,807,1904,1832
3405-000,2014,4,18,19,1139,901,2040,1904
3405-000,2014,4,18,20,800,675,1475,2040
3405-000,2014,4,18,21,586,489,1075,1475
3405-000,2014,4,18,22,416,410,826,1075
3405-000,2014,4,18,23,269,229,498,826
3405-000,2014,4,18,24,152,159,311,498
3405-000,2014,4,19,1,99,101,200,311
3405-000,2014,4,19,2,53,78,131,200
3405-000,2014,4,19,3,48,44,92,131
3405-000,2014,4,19,4,47,60,107,92
3405-000,2014,4,19,5,82,76,158,107
3405-000,2014,4,19,6,148,150,298,158
3405-000,2014,4,19,7,344,309,653,298
3405-000,2014,4,19,8,627,502,1129,653
3405-000,2014,4,19,9,792,584,1376,1129
3405-000,2014,4,19,10,766,595,1361,1376
3405-000,2014,4,19,11,777,659,1436,1361
3405-000,2014,4,19,12,739,622,1361,1436
3405-000,2014,4,19,13,705,544,1249,1361
3405-000,2014,4,19,14,633,580,1213,1249
3405-000,2014,4,19,15,671,588,1259,1213
3405-000,2014,4,19,16,708,561,1269,1259
3405-000,2014,4,19,17,685,594,1279,1269
3405-000,2014,4,19,18,723,676,1399,1279
3405-000,2014,4,19,19,630,551,1181,1399
3405-000,2014,4,19,20,421,423,844,1181
3405-000,2014,4,19,21,343,291,634,844
3405-000,2014,4,19,22,227,225,452,634
3405-000,2014,4,19,23,155,158,313,452
3405-000,2014,4,19,24,132,94,226,313
3405-000,2014,4,20,1,73,62,135,226
3405-000,2014,4,20,2,49,60,109,135
3405-000,2014,4,20,3,35,33,68,109
3405-000,2014,4,20,4,34,32,66,68
3405-000,2014,4,20,5,39,39,78,66
3405-000,2014,4,20,6,90,74,164,78
3405-000,2014,4,20,7,186,144,330,164
3405-000,2014,4,20,8,308,247,555,330
3405-000,2014,4,20,9,333,314,647,555
3405-000,2014,4,20,10,408,326,734,647
3405-000,2014,4,20,11,486,376,862,734
3405-000,2014,4,20,12,434,427,861,862
3405-000,2014,4,20,13,390,351,741,861
3405-000,2014,4,20,14,406,394,800,741
3405-000,2014,4,20,15,442,454,896,800
3405-000,2014,4,20,16,466,512,978,896
3405-000,2014,4,20,17,521,608,1129,978
3405-000,2014,4,20,18,483,603,1086,1129
3405-000,2014,4,20,19,471,534,1005,1086
3405-000,2014,4,20,20,354,426,780,1005
3405-000,2014,4,20,21,303,336,639,780
3405-000,2014,4,20,22,237,294,531,639
3405-000,2014,4,20,23,147,228,375,531
3405-000,2014,4,20,24,106,136,242,375
3405-000,2014,4,21,1,73,96,169,242
3405-000,2014,4,21,2,31,65,96,169
3405-000,2014,4,21,3,22,40,62,96
3405-000,2014,4,21,4,26,60,86,62
3405-000,2014,4,21,5,68,72,140,86
3405-000,2014,4,21,6,187,180,367,140
3405-000,2014,4,21,7,444,527,971,367
3405-000,2014,4,21,8,920,1193,2113,971
3405-000,2014,4,21,9,1038,1156,2194,2113
3405-000,2014,4,21,10,874,803,1677,2194
3405-000,2014,4,21,11,876,847,1723,1677
3405-000,2014,4,21,12,869,753,1622,1723
3405-000,2014,4,21,13,697,772,1469,1622
3405-000,2014,4,21,14,796,806,1602,1469
3405-000,2014,4,21,15,908,865,1773,1602
3405-000,2014,4,21,16,898,865,1763,1773
3405-000,2014,4,21,17,870,748,1618,1763
3405-000,2014,4,21,18,905,828,1733,1618
3405-000,2014,4,21,19,845,863,1708,1733
3405-000,2014,4,21,20,668,578,1246,1708
3405-000,2014,4,21,21,514,486,1000,1246
3405-000,2014,4,21,22,342,348,690,1000
3405-000,2014,4,21,23,212,192,404,690
3405-000,2014,4,21,24,145,139,284,404
3405-000,2014,4,22,1,81,113,194,284
3405-000,2014,4,22,2,43,72,115,194
3405-000,2014,4,22,3,49,62,111,115
3405-000,2014,4,22,4,48,62,110,111
3405-000,2014,4,22,5,74,91,165,110
3405-000,2014,4,22,6,176,170,346,165
3405-000,2014,4,22,7,404,383,787,346
3405-000,2014,4,22,8,874,965,1839,787
3405-000,2014,4,22,9,1120,1101,2221,1839
3405-000,2014,4,22,10,958,833,1791,2221
3405-000,2014,4,22,11,963,822,1785,1791
3405-000,2014,4,22,12,929,757,1686,1785
3405-000,2014,4,22,13,712,700,1412,1686
3405-000,2014,4,22,14,870,811,1681,1412
3405-000,2014,4,22,15,990,872,1862,1681
3405-000,2014,4,22,16,925,839,1764,1862
3405-000,2014,4,22,17,893,745,1638,1764
3405-000,2014,4,22,18,887,850,1737,1638
3405-000,2014,4,22,19,897,814,1711,1737
3405-000,2014,4,22,20,608,613,1221,1711
3405-000,2014,4,22,21,488,500,988,1221
3405-000,2014,4,22,22,370,360,730,988
3405-000,2014,4,22,23,219,226,445,730
3405-000,2014,4,22,24,153,161,314,445
3405-000,2014,4,23,1,71,94,165,314
3405-000,2014,4,23,2,65,67,132,165
3405-000,2014,4,23,3,46,62,108,132
3405-000,2014,4,23,4,51,56,107,108
3405-000,2014,4,23,5,65,74,139,107
3405-000,2014,4,23,6,171,168,339,139
3405-000,2014,4,23,7,421,412,833,339
3405-000,2014,4,23,8,890,935,1825,833
3405-000,2014,4,23,9,1033,1029,2062,1825
3405-000,2014,4,23,10,950,803,1753,2062
3405-000,2014,4,23,11,915,871,1786,1753
3405-000,2014,4,23,12,904,770,1674,1786
3405-000,2014,4,23,13,804,710,1514,1674
3405-000,2014,4,23,14,797,805,1602,1514
3405-000,2014,4,23,15,895,863,1758,1602
3405-000,2014,4,23,16,965,813,1778,1758
3405-000,2014,4,23,17,922,789,1711,1778
3405-000,2014,4,23,18,962,824,1786,1711
3405-000,2014,4,23,19,950,928,1878,1786
3405-000,2014,4,23,20,588,603,1191,1878
3405-000,2014,4,23,21,488,461,949,1191
3405-000,2014,4,23,22,348,353,701,949
3405-000,2014,4,23,23,214,208,422,701
3405-000,2014,4,23,24,140,153,293,422
3405-000,2014,4,24,1,88,107,195,293
3405-000,2014,4,24,2,64,71,135,195
3405-000,2014,4,24,3,36,49,85,135
3405-000,2014,4,24,4,45,67,112,85
3405-000,2014,4,24,5,74,85,159,112
3405-000,2014,4,24,6,163,165,328,159
3405-000,2014,4,24,7,407,380,787,328
3405-000,2014,4,24,8,866,973,1839,787
3405-000,2014,4,24,9,1130,1093,2223,1839
3405-000,2014,4,24,10,1052,880,1932,2223
3405-000,2014,4,24,11,979,842,1821,1932
3405-000,2014,4,24,12,876,814,1690,1821
3405-000,2014,4,24,13,768,686,1454,1690
3405-000,2014,4,24,14,822,802,1624,1454
3405-000,2014,4,24,15,927,895,1822,1624
3405-000,2014,4,24,16,919,841,1760,1822
3405-000,2014,4,24,17,913,782,1695,1760
3405-000,2014,4,24,18,938,861,1799,1695
3405-000,2014,4,24,19,911,795,1706,1799
3405-000,2014,4,24,20,633,581,1214,1706
3405-000,2014,4,24,21,508,462,970,1214
3405-000,2014,4,24,22,359,388,747,970
3405-000,2014,4,24,23,244,236,480,747
3405-000,2014,4,24,24,148,160,308,480
3405-000,2014,4,25,1,84,112,196,308
3405-000,2014,4,25,2,61,74,135,196
3405-000,2014,4,25,3,43,59,102,135
3405-000,2014,4,25,4,44,62,106,102
3405-000,2014,4,25,5,79,82,161,106
3405-000,2014,4,25,6,177,178,355,161
3405-000,2014,4,25,7,451,441,892,355
3405-000,2014,4,25,8,894,1025,1919,892
3405-000,2014,4,25,9,1053,996,2049,1919
3405-000,2014,4,25,10,964,751,1715,2049
3405-000,2014,4,25,11,952,831,1783,1715
3405-000,2014,4,25,12,922,798,1720,1783
3405-000,2014,4,25,13,766,716,1482,1720
3405-000,2014,4,25,14,823,760,1583,1482
3405-000,2014,4,25,15,923,841,1764,1583
3405-000,2014,4,25,16,960,842,1802,1764
3405-000,2014,4,25,17,973,821,1794,1802
3405-000,2014,4,25,18,1166,807,1973,1794
3405-000,2014,4,25,19,1270,900,2170,1973
3405-000,2014,4,25,20,743,696,1439,2170
3405-000,2014,4,25,21,557,522,1079,1439
3405-000,2014,4,25,22,434,311,745,1079
3405-000,2014,4,25,23,233,221,454,745
3405-000,2014,4,25,24,160,170,330,454
3405-000,2014,4,26,1,98,103,201,330
3405-000,2014,4,26,2,66,82,148,201
3405-000,2014,4,26,3,51,65,116,148
3405-000,2014,4,26,4,55,68,123,116
3405-000,2014,4,26,5,97,110,207,123
3405-000,2014,4,26,6,182,167,349,207
3405-000,2014,4,26,7,409,306,715,349
3405-000,2014,4,26,8,658,485,1143,715
3405-000,2014,4,26,9,800,634,1434,1143
3405-000,2014,4,26,10,812,635,1447,1434
3405-000,2014,4,26,11,795,646,1441,1447
3405-000,2014,4,26,12,734,630,1364,1441
3405-000,2014,4,26,13,676,522,1198,1364
3405-000,2014,4,26,14,630,633,1263,1198
3405-000,2014,4,26,15,687,620,1307,1263
3405-000,2014,4,26,16,682,600,1282,1307
3405-000,2014,4,26,17,724,630,1354,1282
3405-000,2014,4,26,18,789,773,1562,1354
3405-000,2014,4,26,19,683,617,1300,1562
3405-000,2014,4,26,20,403,388,791,1300
3405-000,2014,4,26,21,343,357,700,791
3405-000,2014,4,26,22,230,284,514,700
3405-000,2014,4,26,23,182,166,348,514
3405-000,2014,4,26,24,113,125,238,348
3405-000,2014,4,27,1,73,69,142,238
3405-000,2014,4,27,2,60,54,114,142
3405-000,2014,4,27,3,25,31,56,114
3405-000,2014,4,27,4,35,27,62,56
3405-000,2014,4,27,5,39,45,84,62
3405-000,2014,4,27,6,91,58,149,84
3405-000,2014,4,27,7,173,104,277,149
3405-000,2014,4,27,8,232,204,436,277
3405-000,2014,4,27,9,289,244,533,436
3405-000,2014,4,27,10,363,267,630,533
3405-000,2014,4,27,11,392,362,754,630
3405-000,2014,4,27,12,396,386,782,754
3405-000,2014,4,27,13,371,340,711,782
3405-000,2014,4,27,14,421,406,827,711
3405-000,2014,4,27,15,463,434,897,827
3405-000,2014,4,27,16,463,506,969,897
3405-000,2014,4,27,17,424,473,897,969
3405-000,2014,4,27,18,482,467,949,897
3405-000,2014,4,27,19,388,444,832,949
3405-000,2014,4,27,20,295,336,631,832
3405-000,2014,4,27,21,262,301,563,631
3405-000,2014,4,27,22,217,265,482,563
3405-000,2014,4,27,23,141,186,327,482
3405-000,2014,4,27,24,93,130,223,327
3405-000,2014,4,28,1,54,108,162,223
3405-000,2014,4,28,2,34,63,97,162
3405-000,2014,4,28,3,40,45,85,97
3405-000,2014,4,28,4,31,60,91,85
3405-000,2014,4,28,5,70,81,151,91
3405-000,2014,4,28,6,180,174,354,151
3405-000,2014,4,28,7,430,463,893,354
3405-000,2014,4,28,8,835,1194,2029,893
3405-000,2014,4,28,9,908,1091,1999,2029
3405-000,2014,4,28,10,869,779,1648,1999
3405-000,2014,4,28,11,814,766,1580,1648
3405-000,2014,4,28,12,801,746,1547,1580
3405-000,2014,4,28,13,663,702,1365,1547
3405-000,2014,4,28,14,769,760,1529,1365
3405-000,2014,4,28,15,851,816,1667,1529
3405-000,2014,4,28,16,866,811,1677,1667
3405-000,2014,4,28,17,823,732,1555,1677
3405-000,2014,4,28,18,855,731,1586,1555
3405-000,2014,4,28,19,835,764,1599,1586
3405-000,2014,4,28,20,570,537,1107,1599
3405-000,2014,4,28,21,433,456,889,1107
3405-000,2014,4,28,22,328,310,638,889
3405-000,2014,4,28,23,176,236,412,638
3405-000,2014,4,28,24,126,131,257,412
3405-000,2014,4,29,1,80,79,159,257
3405-000,2014,4,29,2,59,74,133,159
3405-000,2014,4,29,3,42,58,100,133
3405-000,2014,4,29,4,41,58,99,100
3405-000,2014,4,29,5,68,89,157,99
3405-000,2014,4,29,6,181,166,347,157
3405-000,2014,4,29,7,409,364,773,347
3405-000,2014,4,29,8,801,972,1773,773
3405-000,2014,4,29,9,1046,1001,2047,1773
3405-000,2014,4,29,10,931,787,1718,2047
3405-000,2014,4,29,11,948,801,1749,1718
3405-000,2014,4,29,12,894,810,1704,1749
3405-000,2014,4,29,13,740,700,1440,1704
3405-000,2014,4,29,14,816,832,1648,1440
3405-000,2014,4,29,15,888,917,1805,1648
3405-000,2014,4,29,16,993,872,1865,1805
3405-000,2014,4,29,17,905,786,1691,1865
3405-000,2014,4,29,18,926,784,1710,1691
3405-000,2014,4,29,19,875,750,1625,1710
3405-000,2014,4,29,20,583,578,1161,1625
3405-000,2014,4,29,21,478,487,965,1161
3405-000,2014,4,29,22,354,374,728,965
3405-000,2014,4,29,23,223,215,438,728
3405-000,2014,4,29,24,154,140,294,438
3405-000,2014,4,30,1,70,102,172,294
3405-000,2014,4,30,2,50,68,118,172
3405-000,2014,4,30,3,54,61,115,118
3405-000,2014,4,30,4,53,61,114,115
3405-000,2014,4,30,5,91,76,167,114
3405-000,2014,4,30,6,188,172,360,167
3405-000,2014,4,30,7,505,404,909,360
3405-000,2014,4,30,8,889,1045,1934,909
3405-000,2014,4,30,9,1073,1045,2118,1934
3405-000,2014,4,30,10,953,842,1795,2118
3405-000,2014,4,30,11,961,867,1828,1795
3405-000,2014,4,30,12,951,858,1809,1828
3405-000,2014,4,30,13,794,679,1473,1809
3405-000,2014,4,30,14,897,862,1759,1473
3405-000,2014,4,30,15,911,886,1797,1759
3405-000,2014,4,30,16,960,836,1796,1797
3405-000,2014,4,30,17,965,777,1742,1796
3405-000,2014,4,30,18,1142,879,2021,1742
3405-000,2014,4,30,19,1161,928,2089,2021
3405-000,2014,4,30,20,716,675,1391,2089
3405-000,2014,4,30,21,565,461,1026,1391
3405-000,2014,4,30,22,366,297,663,1026
3405-000,2014,4,30,23,235,222,457,663
3405-000,2014,4,30,24,143,156,299,457
3405-000,2014,5,1,1,98,82,180,299
3405-000,2014,5,1,2,63,69,132,180
3405-000,2014,5,1,3,61,51,112,132
3405-000,2014,5,1,4,61,56,117,112
3405-000,2014,5,1,5,91,65,156,117
3405-000,2014,5,1,6,188,152,340,156
3405-000,2014,5,1,7,440,282,722,340
3405-000,2014,5,1,8,673,602,1275,722
3405-000,2014,5,1,9,903,737,1640,1275
3405-000,2014,5,1,10,784,649,1433,1640
3405-000,2014,5,1,11,782,600,1382,1433
3405-000,2014,5,1,12,722,590,1312,1382
3405-000,2014,5,1,13,631,547,1178,1312
3405-000,2014,5,1,14,624,612,1236,1178
3405-000,2014,5,1,15,696,643,1339,1236
3405-000,2014,5,1,16,629,663,1292,1339
3405-000,2014,5,1,17,643,592,1235,1292
3405-000,2014,5,1,18,690,653,1343,1235
3405-000,2014,5,1,19,633,589,1222,1343
3405-000,2014,5,1,20,411,438,849,1222
3405-000,2014,5,1,21,295,368,663,849
3405-000,2014,5,1,22,233,259,492,663
3405-000,2014,5,1,23,175,190,365,492
3405-000,2014,5,1,24,142,129,271,365
3405-000,2014,5,2,1,62,86,148,271
3405-000,2014,5,2,2,40,71,111,148
3405-000,2014,5,2,3,31,44,75,111
3405-000,2014,5,2,4,46,65,111,75
3405-000,2014,5,2,5,80,81,161,111
3405-000,2014,5,2,6,185,178,363,161
3405-000,2014,5,2,7,455,446,901,363
3405-000,2014,5,2,8,850,910,1760,901
3405-000,2014,5,2,9,963,933,1896,1760
3405-000,2014,5,2,10,909,706,1615,1896
3405-000,2014,5,2,11,885,745,1630,1615
3405-000,2014,5,2,12,845,750,1595,1630
3405-000,2014,5,2,13,765,630,1395,1595
3405-000,2014,5,2,14,833,752,1585,1395
3405-000,2014,5,2,15,902,787,1689,1585
3405-000,2014,5,2,16,912,801,1713,1689
3405-000,2014,5,2,17,940,761,1701,1713
3405-000,2014,5,2,18,1142,805,1947,1701
3405-000,2014,5,2,19,1162,759,1921,1947
3405-000,2014,5,2,20,712,646,1358,1921
3405-000,2014,5,2,21,475,624,1099,1358
3405-000,2014,5,2,22,359,623,982,1099
3405-000,2014,5,2,23,281,484,765,982
3405-000,2014,5,2,24,130,161,291,765
3405-000,2014,5,3,1,102,96,198,291
3405-000,2014,5,3,2,64,66,130,198
3405-000,2014,5,3,3,35,58,93,130
3405-000,2014,5,3,4,54,60,114,93
3405-000,2014,5,3,5,59,91,150,114
3405-000,2014,5,3,6,196,162,358,150
3405-000,2014,5,3,7,421,283,704,358
3405-000,2014,5,3,8,662,443,1105,704
3405-000,2014,5,3,9,883,568,1451,1105
3405-000,2014,5,3,10,992,592,1584,1451
3405-000,2014,5,3,11,1340,657,1997,1584
3405-000,2014,5,3,12,1075,668,1743,1997
3405-000,2014,5,3,13,937,719,1656,1743
3405-000,2014,5,3,14,858,956,1814,1656
3405-000,2014,5,3,15,866,704,1570,1814
3405-000,2014,5,3,16,926,764,1690,1570
3405-000,2014,5,3,17,978,728,1706,1690
3405-000,2014,5,3,18,1056,986,2042,1706
3405-000,2014,5,3,19,978,1216,2194,2042
3405-000,2014,5,3,20,828,650,1478,2194
3405-000,2014,5,3,21,832,496,1328,1478
3405-000,2014,5,3,22,751,487,1238,1328
3405-000,2014,5,3,23,232,413,645,1238
3405-000,2014,5,3,24,124,236,360,645
3405-000,2014,5,4,1,80,84,164,360
3405-000,2014,5,4,2,53,57,110,164
3405-000,2014,5,4,3,39,36,75,110
3405-000,2014,5,4,4,30,36,66,75
3405-000,2014,5,4,5,48,32,80,66
3405-000,2014,5,4,6,111,65,176,80
3405-000,2014,5,4,7,152,169,321,176
3405-000,2014,5,4,8,306,243,549,321
3405-000,2014,5,4,9,421,304,725,549
3405-000,2014,5,4,10,475,368,843,725
3405-000,2014,5,4,11,583,456,1039,843
3405-000,2014,5,4,12,583,500,1083,1039
3405-000,2014,5,4,13,475,442,917,1083
3405-000,2014,5,4,14,521,451,972,917
3405-000,2014,5,4,15,497,461,958,972
3405-000,2014,5,4,16,538,501,1039,958
3405-000,2014,5,4,17,567,611,1178,1039
3405-000,2014,5,4,18,555,634,1189,1178
3405-000,2014,5,4,19,490,596,1086,1189
3405-000,2014,5,4,20,356,544,900,1086
3405-000,2014,5,4,21,322,425,747,900
3405-000,2014,5,4,22,392,251,643,747
3405-000,2014,5,4,23,201,264,465,643
3405-000,2014,5,4,24,95,156,251,465
3405-000,2014,5,5,1,63,99,162,251
3405-000,2014,5,5,2,29,60,89,162
3405-000,2014,5,5,3,19,46,65,89
3405-000,2014,5,5,4,28,52,80,65
3405-000,2014,5,5,5,56,75,131,80
3405-000,2014,5,5,6,97,98,195,131
3405-000,2014,5,5,7,262,240,502,195
3405-000,2014,5,5,8,389,356,745,502
3405-000,2014,5,5,9,471,330,801,745
3405-000,2014,5,5,10,561,443,1004,801
3405-000,2014,5,5,11,667,533,1200,1004
3405-000,2014,5,5,12,635,536,1171,1200
3405-000,2014,5,5,13,496,531,1027,1171
3405-000,2014,5,5,14,555,520,1075,1027
3405-000,2014,5,5,15,612,528,1140,1075
3405-000,2014,5,5,16,612,583,1195,1140
3405-000,2014,5,5,17,621,611,1232,1195
3405-000,2014,5,5,18,556,647,1203,1232
3405-000,2014,5,5,19,582,558,1140,1203
3405-000,2014,5,5,20,451,466,917,1140
3405-000,2014,5,5,21,515,413,928,917
3405-000,2014,5,5,22,516,381,897,928
3405-000,2014,5,5,23,402,366,768,897
3405-000,2014,5,5,24,196,378,574,768
3405-000,2014,5,6,1,301,190,491,574
3405-000,2014,5,6,2,204,180,384,491
3405-000,2014,5,6,3,105,184,289,384
3405-000,2014,5,6,4,32,68,100,289
3405-000,2014,5,6,5,40,63,103,100
3405-000,2014,5,6,6,144,126,270,103
3405-000,2014,5,6,7,279,246,525,270
3405-000,2014,5,6,8,479,361,840,525
3405-000,2014,5,6,9,569,412,981,840
3405-000,2014,5,6,10,554,437,991,981
3405-000,2014,5,6,11,615,555,1170,991
3405-000,2014,5,6,12,614,494,1108,1170
3405-000,2014,5,6,13,499,536,1035,1108
3405-000,2014,5,6,14,587,573,1160,1035
3405-000,2014,5,6,15,528,658,1186,1160
3405-000,2014,5,6,16,586,651,1237,1186
3405-000,2014,5,6,17,544,615,1159,1237
3405-000,2014,5,6,18,558,641,1199,1159
3405-000,2014,5,6,19,476,614,1090,1199
3405-000,2014,5,6,20,362,479,841,1090
3405-000,2014,5,6,21,293,375,668,841
3405-000,2014,5,6,22,243,321,564,668
3405-000,2014,5,6,23,150,220,370,564
3405-000,2014,5,6,24,106,143,249,370
3405-000,2014,5,7,1,53,93,146,249
3405-000,2014,5,7,2,42,41,83,146
3405-000,2014,5,7,3,25,32,57,83
3405-000,2014,5,7,4,36,60,96,57
3405-000,2014,5,7,5,77,79,156,96
3405-000,2014,5,7,6,186,198,384,156
3405-000,2014,5,7,7,471,497,968,384
3405-000,2014,5,7,8,912,1323,2235,968
3405-000,2014,5,7,9,1042,1034,2076,2235
3405-000,2014,5,7,10,862,785,1647,2076
3405-000,2014,5,7,11,939,870,1809,1647
3405-000,2014,5,7,12,876,773,1649,1809
3405-000,2014,5,7,13,763,684,1447,1649
3405-000,2014,5,7,14,792,819,1611,1447
3405-000,2014,5,7,15,875,832,1707,1611
3405-000,2014,5,7,16,949,850,1799,1707
3405-000,2014,5,7,17,855,826,1681,1799
3405-000,2014,5,7,18,969,866,1835,1681
3405-000,2014,5,7,19,968,892,1860,1835
3405-000,2014,5,7,20,612,566,1178,1860
3405-000,2014,5,7,21,497,470,967,1178
3405-000,2014,5,7,22,371,368,739,967
3405-000,2014,5,7,23,237,252,489,739
3405-000,2014,5,7,24,129,143,272,489
3405-000,2014,5,8,1,75,100,175,272
3405-000,2014,5,8,2,56,48,104,175
3405-000,2014,5,8,3,52,53,105,104
3405-000,2014,5,8,4,57,62,119,105
3405-000,2014,5,8,5,79,98,177,119
3405-000,2014,5,8,6,186,182,368,177
3405-000,2014,5,8,7,425,390,815,368
3405-000,2014,5,8,8,892,1046,1938,815
3405-000,2014,5,8,9,1050,1089,2139,1938
3405-000,2014,5,8,10,954,820,1774,2139
3405-000,2014,5,8,11,982,887,1869,1774
3405-000,2014,5,8,12,954,879,1833,1869
3405-000,2014,5,8,13,844,768,1612,1833
3405-000,2014,5,8,14,913,847,1760,1612
3405-000,2014,5,8,15,967,933,1900,1760
3405-000,2014,5,8,16,972,877,1849,1900
3405-000,2014,5,8,17,936,900,1836,1849
3405-000,2014,5,8,18,1028,859,1887,1836
3405-000,2014,5,8,19,931,838,1769,1887
3405-000,2014,5,8,20,614,635,1249,1769
3405-000,2014,5,8,21,549,495,1044,1249
3405-000,2014,5,8,22,366,384,750,1044
3405-000,2014,5,8,23,226,296,522,750
3405-000,2014,5,8,24,132,135,267,522
3405-000,2014,5,9,1,86,95,181,267
3405-000,2014,5,9,2,46,60,106,181
3405-000,2014,5,9,3,43,61,104,106
3405-000,2014,5,9,4,37,58,95,104
3405-000,2014,5,9,5,74,95,169,95
3405-000,2014,5,9,6,190,196,386,169
3405-000,2014,5,9,7,440,435,875,386
3405-000,2014,5,9,8,943,1089,2032,875
3405-000,2014,5,9,9,1070,1084,2154,2032
3405-000,2014,5,9,10,949,805,1754,2154
3405-000,2014,5,9,11,947,847,1794,1754
3405-000,2014,5,9,12,935,850,1785,1794
3405-000,2014,5,9,13,753,711,1464,1785
3405-000,2014,5,9,14,829,821,1650,1464
3405-000,2014,5,9,15,940,877,1817,1650
3405-000,2014,5,9,16,1064,902,1966,1817
3405-000,2014,5,9,17,985,843,1828,1966
3405-000,2014,5,9,18,1180,881,2061,1828
3405-000,2014,5,9,19,1151,975,2126,2061
3405-000,2014,5,9,20,874,672,1546,2126
3405-000,2014,5,9,21,634,543,1177,1546
3405-000,2014,5,9,22,439,420,859,1177
3405-000,2014,5,9,23,279,248,527,859
3405-000,2014,5,9,24,168,187,355,527
3405-000,2014,5,10,1,108,106,214,355
3405-000,2014,5,10,2,76,71,147,214
3405-000,2014,5,10,3,41,54,95,147
3405-000,2014,5,10,4,52,73,125,95
3405-000,2014,5,10,5,76,96,172,125
3405-000,2014,5,10,6,165,177,342,172
3405-000,2014,5,10,7,405,317,722,342
3405-000,2014,5,10,8,673,518,1191,722
3405-000,2014,5,10,9,795,648,1443,1191
3405-000,2014,5,10,10,767,630,1397,1443
3405-000,2014,5,10,11,778,705,1483,1397
3405-000,2014,5,10,12,763,626,1389,1483
3405-000,2014,5,10,13,677,591,1268,1389
3405-000,2014,5,10,14,691,621,1312,1268
3405-000,2014,5,10,15,713,642,1355,1312
3405-000,2014,5,10,16,709,566,1275,1355
3405-000,2014,5,10,17,728,600,1328,1275
3405-000,2014,5,10,18,793,681,1474,1328
3405-000,2014,5,10,19,661,541,1202,1474
3405-000,2014,5,10,20,465,456,921,1202
3405-000,2014,5,10,21,369,321,690,921
3405-000,2014,5,10,22,273,286,559,690
3405-000,2014,5,10,23,171,196,367,559
3405-000,2014,5,10,24,131,153,284,367
3405-000,2014,5,11,1,87,84,171,284
3405-000,2014,5,11,2,54,42,96,171
3405-000,2014,5,11,3,45,34,79,96
3405-000,2014,5,11,4,19,32,51,79
3405-000,2014,5,11,5,47,29,76,51
3405-000,2014,5,11,6,95,72,167,76
3405-000,2014,5,11,7,244,148,392,167
3405-000,2014,5,11,8,298,239,537,392
3405-000,2014,5,11,9,330,291,621,537
3405-000,2014,5,11,10,410,302,712,621
3405-000,2014,5,11,11,429,346,775,712
3405-000,2014,5,11,12,442,381,823,775
3405-000,2014,5,11,13,370,379,749,823
3405-000,2014,5,11,14,437,420,857,749
3405-000,2014,5,11,15,434,423,857,857
3405-000,2014,5,11,16,430,607,1037,857
3405-000,2014,5,11,17,498,520,1018,1037
3405-000,2014,5,11,18,496,524,1020,1018
3405-000,2014,5,11,19,352,436,788,1020
3405-000,2014,5,11,20,312,349,661,788
3405-000,2014,5,11,21,266,318,584,661
3405-000,2014,5,11,22,228,278,506,584
3405-000,2014,5,11,23,125,197,322,506
3405-000,2014,5,11,24,92,151,243,322
3405-000,2014,5,12,1,60,85,145,243
3405-000,2014,5,12,2,25,49,74,145
3405-000,2014,5,12,3,27,32,59,74
3405-000,2014,5,12,4,26,43,69,59
3405-000,2014,5,12,5,57,75,132,69
3405-000,2014,5,12,6,191,177,368,132
3405-000,2014,5,12,7,424,489,913,368
3405-000,2014,5,12,8,915,1228,2143,913
3405-000,2014,5,12,9,1045,1160,2205,2143
3405-000,2014,5,12,10,888,774,1662,2205
3405-000,2014,5,12,11,929,802,1731,1662
3405-000,2014,5,12,12,873,812,1685,1731
3405-000,2014,5,12,13,781,682,1463,1685
3405-000,2014,5,12,14,805,861,1666,1463
3405-000,2014,5,12,15,897,907,1804,1666
3405-000,2014,5,12,16,906,840,1746,1804
3405-000,2014,5,12,17,863,803,1666,1746
3405-000,2014,5,12,18,952,805,1757,1666
3405-000,2014,5,12,19,854,787,1641,1757
3405-000,2014,5,12,20,685,612,1297,1641
3405-000,2014,5,12,21,507,501,1008,1297
3405-000,2014,5,12,22,384,392,776,1008
3405-000,2014,5,12,23,252,239,491,776
3405-000,2014,5,12,24,142,165,307,491
3405-000,2014,5,13,1,92,99,191,307
3405-000,2014,5,13,2,63,53,116,191
3405-000,2014,5,13,3,49,62,111,116
3405-000,2014,5,13,4,55,67,122,111
3405-000,2014,5,13,5,79,83,162,122
3405-000,2014,5,13,6,197,195,392,162
3405-000,2014,5,13,7,439,444,883,392
3405-000,2014,5,13,8,939,1033,1972,883
3405-000,2014,5,13,9,1094,1048,2142,1972
3405-000,2014,5,13,10,954,750,1704,2142
3405-000,2014,5,13,11,930,849,1779,1704
3405-000,2014,5,13,12,894,768,1662,1779
3405-000,2014,5,13,13,742,743,1485,1662
3405-000,2014,5,13,14,775,810,1585,1485
3405-000,2014,5,13,15,963,848,1811,1585
3405-000,2014,5,13,16,968,848,1816,1811
3405-000,2014,5,13,17,901,800,1701,1816
3405-000,2014,5,13,18,941,829,1770,1701
3405-000,2014,5,13,19,894,852,1746,1770
3405-000,2014,5,13,20,613,597,1210,1746
3405-000,2014,5,13,21,520,474,994,1210
3405-000,2014,5,13,22,335,387,722,994
3405-000,2014,5,13,23,272,250,522,722
3405-000,2014,5,13,24,153,147,300,522
3405-000,2014,5,14,1,97,92,189,300
3405-000,2014,5,14,2,62,70,132,189
3405-000,2014,5,14,3,38,56,94,132
3405-000,2014,5,14,4,40,64,104,94
3405-000,2014,5,14,5,58,87,145,104
3405-000,2014,5,14,6,210,157,367,145
3405-000,2014,5,14,7,433,453,886,367
3405-000,2014,5,14,8,940,1002,1942,886
3405-000,2014,5,14,9,1111,1094,2205,1942
3405-000,2014,5,14,10,884,837,1721,2205
3405-000,2014,5,14,11,974,874,1848,1721
3405-000,2014,5,14,12,971,845,1816,1848
3405-000,2014,5,14,13,773,688,1461,1816
3405-000,2014,5,14,14,822,830,1652,1461
3405-000,2014,5,14,15,967,871,1838,1652
3405-000,2014,5,14,16,863,843,1706,1838
3405-000,2014,5,14,17,925,785,1710,1706
3405-000,2014,5,14,18,1001,878,1879,1710
3405-000,2014,5,14,19,923,855,1778,1879
3405-000,2014,5,14,20,597,592,1189,1778
3405-000,2014,5,14,21,484,465,949,1189
3405-000,2014,5,14,22,305,340,645,949
3405-000,2014,5,14,23,243,220,463,645
3405-000,2014,5,14,24,157,152,309,463
3405-000,2014,5,15,1,92,110,202,309
3405-000,2014,5,15,2,64,65,129,202
3405-000,2014,5,15,3,51,38,89,129
3405-000,2014,5,15,4,46,71,117,89
3405-000,2014,5,15,5,69,100,169,117
3405-000,2014,5,15,6,200,183,383,169
3405-000,2014,5,15,7,439,449,888,383
3405-000,2014,5,15,8,858,1023,1881,888
3405-000,2014,5,15,9,1128,1064,2192,1881
3405-000,2014,5,15,10,967,774,1741,2192
3405-000,2014,5,15,11,968,877,1845,1741
3405-000,2014,5,15,12,904,805,1709,1845
3405-000,2014,5,15,13,757,708,1465,1709
3405-000,2014,5,15,14,853,809,1662,1465
3405-000,2014,5,15,15,938,859,1797,1662
3405-000,2014,5,15,16,972,817,1789,1797
3405-000,2014,5,15,17,911,784,1695,1789
3405-000,2014,5,15,18,917,848,1765,1695
3405-000,2014,5,15,19,863,857,1720,1765
3405-000,2014,5,15,20,618,560,1178,1720
3405-000,2014,5,15,21,470,503,973,1178
3405-000,2014,5,15,22,348,362,710,973
3405-000,2014,5,15,23,249,236,485,710
3405-000,2014,5,15,24,149,165,314,485
3405-000,2014,5,16,1,95,100,195,314
3405-000,2014,5,16,2,58,88,146,195
3405-000,2014,5,16,3,38,52,90,146
3405-000,2014,5,16,4,47,67,114,90
3405-000,2014,5,16,5,67,100,167,114
3405-000,2014,5,16,6,198,172,370,167
3405-000,2014,5,16,7,457,435,892,370
3405-000,2014,5,16,8,928,976,1904,892
3405-000,2014,5,16,9,1062,1090,2152,1904
3405-000,2014,5,16,10,995,799,1794,2152
3405-000,2014,5,16,11,1012,851,1863,1794
3405-000,2014,5,16,12,841,814,1655,1863
3405-000,2014,5,16,13,801,674,1475,1655
3405-000,2014,5,16,14,817,800,1617,1475
3405-000,2014,5,16,15,935,912,1847,1617
3405-000,2014,5,16,16,976,858,1834,1847
3405-000,2014,5,16,17,910,816,1726,1834
3405-000,2014,5,16,18,1132,851,1983,1726
3405-000,2014,5,16,19,1230,964,2194,1983
3405-000,2014,5,16,20,846,652,1498,2194
3405-000,2014,5,16,21,571,519,1090,1498
3405-000,2014,5,16,22,419,367,786,1090
3405-000,2014,5,16,23,299,250,549,786
3405-000,2014,5,16,24,170,193,363,549
3405-000,2014,5,17,1,88,97,185,363
3405-000,2014,5,17,2,81,86,167,185
3405-000,2014,5,17,3,54,53,107,167
3405-000,2014,5,17,4,46,84,130,107
3405-000,2014,5,17,5,66,94,160,130
3405-000,2014,5,17,6,175,153,328,160
3405-000,2014,5,17,7,372,333,705,328
3405-000,2014,5,17,8,686,527,1213,705
3405-000,2014,5,17,9,839,627,1466,1213
3405-000,2014,5,17,10,797,641,1438,1466
3405-000,2014,5,17,11,824,684,1508,1438
3405-000,2014,5,17,12,723,627,1350,1508
3405-000,2014,5,17,13,691,587,1278,1350
3405-000,2014,5,17,14,640,582,1222,1278
3405-000,2014,5,17,15,712,571,1283,1222
3405-000,2014,5,17,16,616,568,1184,1283
3405-000,2014,5,17,17,703,597,1300,1184
3405-000,2014,5,17,18,696,723,1419,1300
3405-000,2014,5,17,19,655,606,1261,1419
3405-000,2014,5,17,20,464,431,895,1261
3405-000,2014,5,17,21,354,321,675,895
3405-000,2014,5,17,22,275,273,548,675
3405-000,2014,5,17,23,180,191,371,548
3405-000,2014,5,17,24,113,124,237,371
3405-000,2014,5,18,1,86,93,179,237
3405-000,2014,5,18,2,47,58,105,179
3405-000,2014,5,18,3,43,34,77,105
3405-000,2014,5,18,4,27,24,51,77
3405-000,2014,5,18,5,48,40,88,51
3405-000,2014,5,18,6,110,80,190,88
3405-000,2014,5,18,7,228,133,361,190
3405-000,2014,5,18,8,312,232,544,361
3405-000,2014,5,18,9,410,277,687,544
3405-000,2014,5,18,10,436,297,733,687
3405-000,2014,5,18,11,506,385,891,733
3405-000,2014,5,18,12,475,427,902,891
3405-000,2014,5,18,13,390,395,785,902
3405-000,2014,5,18,14,398,410,808,785
3405-000,2014,5,18,15,454,455,909,808
3405-000,2014,5,18,16,491,445,936,909
3405-000,2014,5,18,17,508,488,996,936
3405-000,2014,5,18,18,552,598,1150,996
3405-000,2014,5,18,19,415,551,966,1150
3405-000,2014,5,18,20,368,466,834,966
3405-000,2014,5,18,21,288,415,703,834
3405-000,2014,5,18,22,262,316,578,703
3405-000,2014,5,18,23,177,240,417,578
3405-000,2014,5,18,24,127,165,292,417
3405-000,2014,5,19,1,61,93,154,292
3405-000,2014,5,19,2,41,64,105,154
3405-000,2014,5,19,3,20,45,65,105
3405-000,2014,5,19,4,33,56,89,65
3405-000,2014,5,19,5,69,71,140,89
3405-000,2014,5,19,6,191,219,410,140
3405-000,2014,5,19,7,500,572,1072,410
3405-000,2014,5,19,8,914,1262,2176,1072
3405-000,2014,5,19,9,1114,1083,2197,2176
3405-000,2014,5,19,10,956,809,1765,2197
3405-000,2014,5,19,11,898,834,1732,1765
3405-000,2014,5,19,12,911,725,1636,1732
3405-000,2014,5,19,13,690,733,1423,1636
3405-000,2014,5,19,14,798,805,1603,1423
3405-000,2014,5,19,15,910,890,1800,1603
3405-000,2014,5,19,16,956,936,1892,1800
3405-000,2014,5,19,17,882,825,1707,1892
3405-000,2014,5,19,18,932,838,1770,1707
3405-000,2014,5,19,19,876,843,1719,1770
3405-000,2014,5,19,20,588,609,1197,1719
3405-000,2014,5,19,21,476,461,937,1197
3405-000,2014,5,19,22,329,400,729,937
3405-000,2014,5,19,23,231,272,503,729
3405-000,2014,5,19,24,136,145,281,503
3405-000,2014,5,20,1,77,95,172,281
3405-000,2014,5,20,2,53,66,119,172
3405-000,2014,5,20,3,51,51,102,119
3405-000,2014,5,20,4,44,70,114,102
3405-000,2014,5,20,5,84,99,183,114
3405-000,2014,5,20,6,201,187,388,183
3405-000,2014,5,20,7,438,433,871,388
3405-000,2014,5,20,8,889,1015,1904,871
3405-000,2014,5,20,9,1069,1053,2122,1904
3405-000,2014,5,20,10,973,838,1811,2122
3405-000,2014,5,20,11,955,851,1806,1811
3405-000,2014,5,20,12,930,749,1679,1806
3405-000,2014,5,20,13,744,705,1449,1679
3405-000,2014,5,20,14,800,775,1575,1449
3405-000,2014,5,20,15,925,897,1822,1575
3405-000,2014,5,20,16,945,811,1756,1822
3405-000,2014,5,20,17,906,781,1687,1756
3405-000,2014,5,20,18,914,837,1751,1687
3405-000,2014,5,20,19,884,867,1751,1751
3405-000,2014,5,20,20,568,580,1148,1751
3405-000,2014,5,20,21,514,510,1024,1148
3405-000,2014,5,20,22,386,346,732,1024
3405-000,2014,5,20,23,217,234,451,732
3405-000,2014,5,20,24,129,150,279,451
3405-000,2014,5,21,1,98,105,203,279
3405-000,2014,5,21,2,62,77,139,203
3405-000,2014,5,21,3,52,53,105,139
3405-000,2014,5,21,4,33,53,86,105
3405-000,2014,5,21,5,61,85,146,86
3405-000,2014,5,21,6,189,198,387,146
3405-000,2014,5,21,7,438,410,848,387
3405-000,2014,5,21,8,921,992,1913,848
3405-000,2014,5,21,9,1091,1059,2150,1913
3405-000,2014,5,21,10,888,819,1707,2150
3405-000,2014,5,21,11,968,911,1879,1707
3405-000,2014,5,21,12,985,755,1740,1879
3405-000,2014,5,21,13,697,688,1385,1740
3405-000,2014,5,21,14,821,799,1620,1385
3405-000,2014,5,21,15,913,810,1723,1620
3405-000,2014,5,21,16,912,833,1745,1723
3405-000,2014,5,21,17,941,795,1736,1745
3405-000,2014,5,21,18,919,877,1796,1736
3405-000,2014,5,21,19,988,880,1868,1796
3405-000,2014,5,21,20,610,614,1224,1868
3405-000,2014,5,21,21,460,482,942,1224
3405-000,2014,5,21,22,349,339,688,942
3405-000,2014,5,21,23,271,234,505,688
3405-000,2014,5,21,24,124,146,270,505
3405-000,2014,5,22,1,79,125,204,270
3405-000,2014,5,22,2,52,72,124,204
3405-000,2014,5,22,3,32,59,91,124
3405-000,2014,5,22,4,44,71,115,91
3405-000,2014,5,22,5,72,88,160,115
3405-000,2014,5,22,6,194,201,395,160
3405-000,2014,5,22,7,464,441,905,395
3405-000,2014,5,22,8,921,1039,1960,905
3405-000,2014,5,22,9,1061,1064,2125,1960
3405-000,2014,5,22,10,873,821,1694,2125
3405-000,2014,5,22,11,967,838,1805,1694
3405-000,2014,5,22,12,877,761,1638,1805
3405-000,2014,5,22,13,744,662,1406,1638
3405-000,2014,5,22,14,764,807,1571,1406
3405-000,2014,5,22,15,973,873,1846,1571
3405-000,2014,5,22,16,939,791,1730,1846
3405-000,2014,5,22,17,890,782,1672,1730
3405-000,2014,5,22,18,917,848,1765,1672
3405-000,2014,5,22,19,917,813,1730,1765
3405-000,2014,5,22,20,590,606,1196,1730
3405-000,2014,5,22,21,518,502,1020,1196
3405-000,2014,5,22,22,341,387,728,1020
3405-000,2014,5,22,23,264,216,480,728
3405-000,2014,5,22,24,156,150,306,480
3405-000,2014,5,23,1,76,112,188,306
3405-000,2014,5,23,2,69,75,144,188
3405-000,2014,5,23,3,58,71,129,144
3405-000,2014,5,23,4,51,83,134,129
3405-000,2014,5,23,5,92,101,193,134
3405-000,2014,5,23,6,202,204,406,193
3405-000,2014,5,23,7,437,413,850,406
3405-000,2014,5,23,8,863,952,1815,850
3405-000,2014,5,23,9,1136,1073,2209,1815
3405-000,2014,5,23,10,990,766,1756,2209
3405-000,2014,5,23,11,949,913,1862,1756
3405-000,2014,5,23,12,959,770,1729,1862
3405-000,2014,5,23,13,794,692,1486,1729
3405-000,2014,5,23,14,853,787,1640,1486
3405-000,2014,5,23,15,991,928,1919,1640
3405-000,2014,5,23,16,968,883,1851,1919
3405-000,2014,5,23,17,972,858,1830,1851
3405-000,2014,5,23,18,1280,892,2172,1830
3405-000,2014,5,23,19,1249,956,2205,2172
3405-000,2014,5,23,20,784,684,1468,2205
3405-000,2014,5,23,21,579,494,1073,1468
3405-000,2014,5,23,22,443,347,790,1073
3405-000,2014,5,23,23,265,241,506,790
3405-000,2014,5,23,24,161,132,293,506
3405-000,2014,5,24,1,113,101,214,293
3405-000,2014,5,24,2,76,79,155,214
3405-000,2014,5,24,3,48,59,107,155
3405-000,2014,5,24,4,60,80,140,107
3405-000,2014,5,24,5,83,85,168,140
3405-000,2014,5,24,6,189,183,372,168
3405-000,2014,5,24,7,387,323,710,372
3405-000,2014,5,24,8,618,595,1213,710
3405-000,2014,5,24,9,790,647,1437,1213
3405-000,2014,5,24,10,817,593,1410,1437
3405-000,2014,5,24,11,841,658,1499,1410
3405-000,2014,5,24,12,768,643,1411,1499
3405-000,2014,5,24,13,675,558,1233,1411
3405-000,2014,5,24,14,656,584,1240,1233
3405-000,2014,5,24,15,707,616,1323,1240
3405-000,2014,5,24,16,693,596,1289,1323
3405-000,2014,5,24,17,728,560,1288,1289
3405-000,2014,5,24,18,775,695,1470,1288
3405-000,2014,5,24,19,622,574,1196,1470
3405-000,2014,5,24,20,405,411,816,1196
3405-000,2014,5,24,21,307,317,624,816
3405-000,2014,5,24,22,266,257,523,624
3405-000,2014,5,24,23,199,197,396,523
3405-000,2014,5,24,24,131,133,264,396
3405-000,2014,5,25,1,90,91,181,264
3405-000,2014,5,25,2,48,43,91,181
3405-000,2014,5,25,3,42,41,83,91
3405-000,2014,5,25,4,34,32,66,83
3405-000,2014,5,25,5,76,28,104,66
3405-000,2014,5,25,6,127,74,201,104
3405-000,2014,5,25,7,192,145,337,201
3405-000,2014,5,25,8,310,241,551,337
3405-000,2014,5,25,9,348,302,650,551
3405-000,2014,5,25,10,401,308,709,650
3405-000,2014,5,25,11,478,378,856,709
3405-000,2014,5,25,12,418,346,764,856
3405-000,2014,5,25,13,447,410,857,764
3405-000,2014,5,25,14,436,428,864,857
3405-000,2014,5,25,15,422,490,912,864
3405-000,2014,5,25,16,466,509,975,912
3405-000,2014,5,25,17,504,511,1015,975
3405-000,2014,5,25,18,466,590,1056,1015
3405-000,2014,5,25,19,375,523,898,1056
3405-000,2014,5,25,20,281,406,687,898
3405-000,2014,5,25,21,260,350,610,687
3405-000,2014,5,25,22,192,306,498,610
3405-000,2014,5,25,23,151,172,323,498
3405-000,2014,5,25,24,81,152,233,323
3405-000,2014,5,26,1,68,92,160,233
3405-000,2014,5,26,2,27,59,86,160
3405-000,2014,5,26,3,20,46,66,86
3405-000,2014,5,26,4,29,68,97,66
3405-000,2014,5,26,5,64,92,156,97
3405-000,2014,5,26,6,190,207,397,156
3405-000,2014,5,26,7,459,523,982,397
3405-000,2014,5,26,8,910,1270,2180,982
3405-000,2014,5,26,9,1117,1164,2281,2180
3405-000,2014,5,26,10,859,833,1692,2281
3405-000,2014,5,26,11,911,816,1727,1692
3405-000,2014,5,26,12,837,732,1569,1727
3405-000,2014,5,26,13,719,627,1346,1569
3405-000,2014,5,26,14,783,810,1593,1346
3405-000,2014,5,26,15,895,944,1839,1593
3405-000,2014,5,26,16,928,853,1781,1839
3405-000,2014,5,26,17,886,767,1653,1781
3405-000,2014,5,26,18,860,799,1659,1653
3405-000,2014,5,26,19,946,856,1802,1659
3405-000,2014,5,26,20,627,613,1240,1802
3405-000,2014,5,26,21,485,489,974,1240
3405-000,2014,5,26,22,393,343,736,974
3405-000,2014,5,26,23,235,257,492,736
3405-000,2014,5,26,24,145,151,296,492
3405-000,2014,5,27,1,78,101,179,296
3405-000,2014,5,27,2,53,68,121,179
3405-000,2014,5,27,3,35,67,102,121
3405-000,2014,5,27,4,47,71,118,102
3405-000,2014,5,27,5,71,112,183,118
3405-000,2014,5,27,6,202,188,390,183
3405-000,2014,5,27,7,413,446,859,390
3405-000,2014,5,27,8,888,1068,1956,859
3405-000,2014,5,27,9,1112,1102,2214,1956
3405-000,2014,5,27,10,1041,780,1821,2214
3405-000,2014,5,27,11,999,845,1844,1821
3405-000,2014,5,27,12,912,730,1642,1844
3405-000,2014,5,27,13,731,640,1371,1642
3405-000,2014,5,27,14,780,785,1565,1371
3405-000,2014,5,27,15,959,832,1791,1565
3405-000,2014,5,27,16,921,869,1790,1791
3405-000,2014,5,27,17,839,747,1586,1790
3405-000,2014,5,27,18,1002,804,1806,1586
3405-000,2014,5,27,19,945,902,1847,1806
3405-000,2014,5,27,20,686,622,1308,1847
3405-000,2014,5,27,21,510,506,1016,1308
3405-000,2014,5,27,22,372,395,767,1016
3405-000,2014,5,27,23,201,218,419,767
3405-000,2014,5,27,24,149,161,310,419
3405-000,2014,5,28,1,81,85,166,310
3405-000,2014,5,28,2,60,80,140,166
3405-000,2014,5,28,3,46,58,104,140
3405-000,2014,5,28,4,41,70,111,104
3405-000,2014,5,28,5,71,70,141,111
3405-000,2014,5,28,6,217,204,421,141
3405-000,2014,5,28,7,423,411,834,421
3405-000,2014,5,28,8,862,1061,1923,834
3405-000,2014,5,28,9,1122,1127,2249,1923
3405-000,2014,5,28,10,944,773,1717,2249
3405-000,2014,5,28,11,988,877,1865,1717
3405-000,2014,5,28,12,906,851,1757,1865
3405-000,2014,5,28,13,758,669,1427,1757
3405-000,2014,5,28,14,891,792,1683,1427
3405-000,2014,5,28,15,991,918,1909,1683
3405-000,2014,5,28,16,927,884,1811,1909
3405-000,2014,5,28,17,901,764,1665,1811
3405-000,2014,5,28,18,1005,855,1860,1665
3405-000,2014,5,28,19,922,902,1824,1860
3405-000,2014,5,28,20,623,617,1240,1824
3405-000,2014,5,28,21,448,476,924,1240
3405-000,2014,5,28,22,352,335,687,924
3405-000,2014,5,28,23,250,216,466,687
3405-000,2014,5,28,24,152,147,299,466
3405-000,2014,5,29,1,97,103,200,299
3405-000,2014,5,29,2,58,71,129,200
3405-000,2014,5,29,3,43,55,98,129
3405-000,2014,5,29,4,43,57,100,98
3405-000,2014,5,29,5,90,105,195,100
3405-000,2014,5,29,6,183,196,379,195
3405-000,2014,5,29,7,469,452,921,379
3405-000,2014,5,29,8,891,1092,1983,921
3405-000,2014,5,29,9,1083,1057,2140,1983
3405-000,2014,5,29,10,999,820,1819,2140
3405-000,2014,5,29,11,897,876,1773,1819
3405-000,2014,5,29,12,958,794,1752,1773
3405-000,2014,5,29,13,753,698,1451,1752
3405-000,2014,5,29,14,806,776,1582,1451
3405-000,2014,5,29,15,950,870,1820,1582
3405-000,2014,5,29,16,918,873,1791,1820
3405-000,2014,5,29,17,955,795,1750,1791
3405-000,2014,5,29,18,951,865,1816,1750
3405-000,2014,5,29,19,958,868,1826,1816
3405-000,2014,5,29,20,669,562,1231,1826
3405-000,2014,5,29,21,499,510,1009,1231
3405-000,2014,5,29,22,403,337,740,1009
3405-000,2014,5,29,23,243,261,504,740
3405-000,2014,5,29,24,144,181,325,504
3405-000,2014,5,30,1,73,88,161,325
3405-000,2014,5,30,2,71,68,139,161
3405-000,2014,5,30,3,46,67,113,139
3405-000,2014,5,30,4,50,68,118,113
3405-000,2014,5,30,5,72,92,164,118
3405-000,2014,5,30,6,221,205,426,164
3405-000,2014,5,30,7,479,419,898,426
3405-000,2014,5,30,8,873,1049,1922,898
3405-000,2014,5,30,9,1021,1034,2055,1922
3405-000,2014,5,30,10,1011,797,1808,2055
3405-000,2014,5,30,11,937,836,1773,1808
3405-000,2014,5,30,12,935,832,1767,1773
3405-000,2014,5,30,13,785,678,1463,1767
3405-000,2014,5,30,14,863,754,1617,1463
3405-000,2014,5,30,15,922,846,1768,1617
3405-000,2014,5,30,16,975,833,1808,1768
3405-000,2014,5,30,17,917,767,1684,1808
3405-000,2014,5,30,18,1115,850,1965,1684
3405-000,2014,5,30,19,1116,947,2063,1965
3405-000,2014,5,30,20,846,689,1535,2063
3405-000,2014,5,30,21,599,531,1130,1535
3405-000,2014,5,30,22,451,330,781,1130
3405-000,2014,5,30,23,264,246,510,781
3405-000,2014,5,30,24,178,174,352,510
3405-000,2014,5,31,1,124,126,250,352
3405-000,2014,5,31,2,73,68,141,250
3405-000,2014,5,31,3,53,61,114,141
3405-000,2014,5,31,4,45,77,122,114
3405-000,2014,5,31,5,85,93,178,122
3405-000,2014,5,31,6,211,160,371,178
3405-000,2014,5,31,7,376,328,704,371
3405-000,2014,5,31,8,672,565,1237,704
3405-000,2014,5,31,9,819,613,1432,1237
3405-000,2014,5,31,10,809,641,1450,1432
3405-000,2014,5,31,11,825,620,1445,1450
3405-000,2014,5,31,12,797,561,1358,1445
3405-000,2014,5,31,13,679,561,1240,1358
3405-000,2014,5,31,14,678,574,1252,1240
3405-000,2014,5,31,15,698,585,1283,1252
3405-000,2014,5,31,16,696,574,1270,1283
3405-000,2014,5,31,17,702,598,1300,1270
3405-000,2014,5,31,18,764,646,1410,1300
3405-000,2014,5,31,19,615,569,1184,1410
3405-000,2014,5,31,20,434,446,880,1184
3405-000,2014,5,31,21,372,344,716,880
3405-000,2014,5,31,22,258,252,510,716
3405-000,2014,5,31,23,217,222,439,510
3405-000,2014,5,31,24,106,135,241,439
3405-000,2014,6,1,1,80,70,150,241
3405-000,2014,6,1,2,60,51,111,150
3405-000,2014,6,1,3,39,36,75,111
3405-000,2014,6,1,4,38,31,69,75
3405-000,2014,6,1,5,62,45,107,69
3405-000,2014,6,1,6,134,108,242,107
3405-000,2014,6,1,7,198,155,353,242
3405-000,2014,6,1,8,311,260,571,353
3405-000,2014,6,1,9,381,297,678,571
3405-000,2014,6,1,10,456,330,786,678
3405-000,2014,6,1,11,459,392,851,786
3405-000,2014,6,1,12,412,391,803,851
3405-000,2014,6,1,13,417,429,846,803
3405-000,2014,6,1,14,394,413,807,846
3405-000,2014,6,1,15,474,502,976,807
3405-000,2014,6,1,16,479,557,1036,976
3405-000,2014,6,1,17,486,575,1061,1036
3405-000,2014,6,1,18,482,514,996,1061
3405-000,2014,6,1,19,455,505,960,996
3405-000,2014,6,1,20,341,413,754,960
3405-000,2014,6,1,21,326,353,679,754
3405-000,2014,6,1,22,243,290,533,679
3405-000,2014,6,1,23,189,224,413,533
3405-000,2014,6,1,24,109,174,283,413
3405-000,2014,6,2,1,49,95,144,283
3405-000,2014,6,2,2,39,41,80,144
3405-000,2014,6,2,3,30,46,76,80
3405-000,2014,6,2,4,39,62,101,76
3405-000,2014,6,2,5,81,102,183,101
3405-000,2014,6,2,6,219,230,449,183
3405-000,2014,6,2,7,510,575,1085,449
3405-000,2014,6,2,8,919,1287,2206,1085
3405-000,2014,6,2,9,1063,1136,2199,2206
3405-000,2014,6,2,10,892,770,1662,2199
3405-000,2014,6,2,11,934,812,1746,1662
3405-000,2014,6,2,12,854,792,1646,1746
3405-000,2014,6,2,13,746,670,1416,1646
3405-000,2014,6,2,14,814,822,1636,1416
3405-000,2014,6,2,15,920,879,1799,1636
3405-000,2014,6,2,16,935,800,1735,1799
3405-000,2014,6,2,17,922,788,1710,1735
3405-000,2014,6,2,18,891,798,1689,1710
3405-000,2014,6,2,19,899,780,1679,1689
3405-000,2014,6,2,20,630,559,1189,1679
3405-000,2014,6,2,21,488,528,1016,1189
3405-000,2014,6,2,22,328,348,676,1016
3405-000,2014,6,2,23,215,229,444,676
3405-000,2014,6,2,24,120,146,266,444
3405-000,2014,6,3,1,72,88,160,266
3405-000,2014,6,3,2,58,82,140,160
3405-000,2014,6,3,3,39,63,102,140
3405-000,2014,6,3,4,45,69,114,102
3405-000,2014,6,3,5,79,96,175,114
3405-000,2014,6,3,6,172,174,346,175
3405-000,2014,6,3,7,354,359,713,346
3405-000,2014,6,3,8,777,924,1701,713
3405-000,2014,6,3,9,996,998,1994,1701
3405-000,2014,6,3,10,845,733,1578,1994
3405-000,2014,6,3,11,838,746,1584,1578
3405-000,2014,6,3,12,841,722,1563,1584
3405-000,2014,6,3,13,726,656,1382,1563
3405-000,2014,6,3,14,764,727,1491,1382
3405-000,2014,6,3,15,915,842,1757,1491
3405-000,2014,6,3,16,930,806,1736,1757
3405-000,2014,6,3,17,927,800,1727,1736
3405-000,2014,6,3,18,1015,795,1810,1727
3405-000,2014,6,3,19,1056,817,1873,1810
3405-000,2014,6,3,20,700,622,1322,1873
3405-000,2014,6,3,21,547,468,1015,1322
3405-000,2014,6,3,22,404,346,750,1015
3405-000,2014,6,3,23,262,225,487,750
3405-000,2014,6,3,24,165,165,330,487
3405-000,2014,6,4,1,118,120,238,330
3405-000,2014,6,4,2,68,65,133,238
3405-000,2014,6,4,3,47,60,107,133
3405-000,2014,6,4,4,65,64,129,107
3405-000,2014,6,4,5,84,88,172,129
3405-000,2014,6,4,6,219,170,389,172
3405-000,2014,6,4,7,354,315,669,389
3405-000,2014,6,4,8,694,576,1270,669
3405-000,2014,6,4,9,794,693,1487,1270
3405-000,2014,6,4,10,833,667,1500,1487
3405-000,2014,6,4,11,805,622,1427,1500
3405-000,2014,6,4,12,793,701,1494,1427
3405-000,2014,6,4,13,689,610,1299,1494
3405-000,2014,6,4,14,709,700,1409,1299
3405-000,2014,6,4,15,694,656,1350,1409
3405-000,2014,6,4,16,728,690,1418,1350
3405-000,2014,6,4,17,680,652,1332,1418
3405-000,2014,6,4,18,720,663,1383,1332
3405-000,2014,6,4,19,595,596,1191,1383
3405-000,2014,6,4,20,438,454,892,1191
3405-000,2014,6,4,21,357,393,750,892
3405-000,2014,6,4,22,257,293,550,750
3405-000,2014,6,4,23,208,198,406,550
3405-000,2014,6,4,24,109,127,236,406
3405-000,2014,6,5,1,78,92,170,236
3405-000,2014,6,5,2,37,47,84,170
3405-000,2014,6,5,3,47,56,103,84
3405-000,2014,6,5,4,54,65,119,103
3405-000,2014,6,5,5,91,104,195,119
3405-000,2014,6,5,6,208,180,388,195
3405-000,2014,6,5,7,446,472,918,388
3405-000,2014,6,5,8,890,948,1838,918
3405-000,2014,6,5,9,1010,1000,2010,1838
3405-000,2014,6,5,10,923,783,1706,2010
3405-000,2014,6,5,11,989,795,1784,1706
3405-000,2014,6,5,12,875,818,1693,1784
3405-000,2014,6,5,13,743,725,1468,1693
3405-000,2014,6,5,14,832,804,1636,1468
3405-000,2014,6,5,15,934,920,1854,1636
3405-000,2014,6,5,16,917,884,1801,1854
3405-000,2014,6,5,17,1061,837,1898,1801
3405-000,2014,6,5,18,1009,830,1839,1898
3405-000,2014,6,5,19,1099,898,1997,1839
3405-000,2014,6,5,20,809,616,1425,1997
3405-000,2014,6,5,21,546,534,1080,1425
3405-000,2014,6,5,22,430,395,825,1080
3405-000,2014,6,5,23,291,241,532,825
3405-000,2014,6,5,24,161,158,319,532
3405-000,2014,6,6,1,101,104,205,319
3405-000,2014,6,6,2,78,79,157,205
3405-000,2014,6,6,3,45,53,98,157
3405-000,2014,6,6,4,56,67,123,98
3405-000,2014,6,6,5,91,104,195,123
3405-000,2014,6,6,6,224,156,380,195
3405-000,2014,6,6,7,377,332,709,380
3405-000,2014,6,6,8,679,469,1148,709
3405-000,2014,6,6,9,854,547,1401,1148
3405-000,2014,6,6,10,754,582,1336,1401
3405-000,2014,6,6,11,852,565,1417,1336
3405-000,2014,6,6,12,861,644,1505,1417
3405-000,2014,6,6,13,682,587,1269,1505
3405-000,2014,6,6,14,729,575,1304,1269
3405-000,2014,6,6,15,847,643,1490,1304
3405-000,2014,6,6,16,725,645,1370,1490
3405-000,2014,6,6,17,648,618,1266,1370
3405-000,2014,6,6,18,671,685,1356,1266
3405-000,2014,6,6,19,626,580,1206,1356
3405-000,2014,6,6,20,492,417,909,1206
3405-000,2014,6,6,21,329,413,742,909
3405-000,2014,6,6,22,273,279,552,742
3405-000,2014,6,6,23,236,179,415,552
3405-000,2014,6,6,24,122,160,282,415
3405-000,2014,6,7,1,74,85,159,282
3405-000,2014,6,7,2,39,65,104,159
3405-000,2014,6,7,3,31,51,82,104
3405-000,2014,6,7,4,48,65,113,82
3405-000,2014,6,7,5,76,83,159,113
3405-000,2014,6,7,6,165,171,336,159
3405-000,2014,6,7,7,354,272,626,336
3405-000,2014,6,7,8,513,435,948,626
3405-000,2014,6,7,9,660,548,1208,948
3405-000,2014,6,7,10,629,466,1095,1208
3405-000,2014,6,7,11,639,556,1195,1095
3405-000,2014,6,7,12,655,531,1186,1195
3405-000,2014,6,7,13,573,477,1050,1186
3405-000,2014,6,7,14,590,560,1150,1050
3405-000,2014,6,7,15,575,560,1135,1150
3405-000,2014,6,7,16,646,614,1260,1135
3405-000,2014,6,7,17,614,642,1256,1260
3405-000,2014,6,7,18,689,659,1348,1256
3405-000,2014,6,7,19,657,626,1283,1348
3405-000,2014,6,7,20,445,610,1055,1283
3405-000,2014,6,7,21,353,414,767,1055
3405-000,2014,6,7,22,315,326,641,767
3405-000,2014,6,7,23,216,260,476,641
3405-000,2014,6,7,24,114,160,274,476
3405-000,2014,6,8,1,81,82,163,274
3405-000,2014,6,8,2,51,56,107,163
3405-000,2014,6,8,3,29,36,65,107
3405-000,2014,6,8,4,29,29,58,65
3405-000,2014,6,8,5,40,52,92,58
3405-000,2014,6,8,6,113,80,193,92
3405-000,2014,6,8,7,198,151,349,193
3405-000,2014,6,8,8,266,232,498,349
3405-000,2014,6,8,9,368,278,646,498
3405-000,2014,6,8,10,389,287,676,646
3405-000,2014,6,8,11,461,374,835,676
3405-000,2014,6,8,12,471,397,868,835
3405-000,2014,6,8,13,423,490,913,868
3405-000,2014,6,8,14,410,471,881,913
3405-000,2014,6,8,15,437,534,971,881
3405-000,2014,6,8,16,432,589,1021,971
3405-000,2014,6,8,17,484,590,1074,1021
3405-000,2014,6,8,18,463,619,1082,1074
3405-000,2014,6,8,19,399,574,973,1082
3405-000,2014,6,8,20,331,517,848,973
3405-000,2014,6,8,21,301,403,704,848
3405-000,2014,6,8,22,247,321,568,704
3405-000,2014,6,8,23,157,266,423,568
3405-000,2014,6,8,24,120,182,302,423
3405-000,2014,6,9,1,73,93,166,302
3405-000,2014,6,9,2,43,55,98,166
3405-000,2014,6,9,3,32,60,92,98
3405-000,2014,6,9,4,37,58,95,92
3405-000,2014,6,9,5,76,106,182,95
3405-000,2014,6,9,6,209,242,451,182
3405-000,2014,6,9,7,504,551,1055,451
3405-000,2014,6,9,8,889,1345,2234,1055
3405-000,2014,6,9,9,1054,1098,2152,2234
3405-000,2014,6,9,10,925,740,1665,2152
3405-000,2014,6,9,11,902,830,1732,1665
3405-000,2014,6,9,12,836,924,1760,1732
3405-000,2014,6,9,13,727,878,1605,1760
3405-000,2014,6,9,14,784,780,1564,1605
3405-000,2014,6,9,15,962,880,1842,1564
3405-000,2014,6,9,16,901,810,1711,1842
3405-000,2014,6,9,17,880,797,1677,1711
3405-000,2014,6,9,18,966,825,1791,1677
3405-000,2014,6,9,19,976,886,1862,1791
3405-000,2014,6,9,20,688,600,1288,1862
3405-000,2014,6,9,21,529,543,1072,1288
3405-000,2014,6,9,22,382,388,770,1072
3405-000,2014,6,9,23,252,234,486,770
3405-000,2014,6,9,24,169,139,308,486
3405-000,2014,6,10,1,93,117,210,308
3405-000,2014,6,10,2,56,76,132,210
3405-000,2014,6,10,3,47,78,125,132
3405-000,2014,6,10,4,50,78,128,125
3405-000,2014,6,10,5,83,98,181,128
3405-000,2014,6,10,6,191,212,403,181
3405-000,2014,6,10,7,447,435,882,403
3405-000,2014,6,10,8,862,1081,1943,882
3405-000,2014,6,10,9,1038,1038,2076,1943
3405-000,2014,6,10,10,983,884,1867,2076
3405-000,2014,6,10,11,983,865,1848,1867
3405-000,2014,6,10,12,937,841,1778,1848
3405-000,2014,6,10,13,764,651,1415,1778
3405-000,2014,6,10,14,831,796,1627,1415
3405-000,2014,6,10,15,968,914,1882,1627
3405-000,2014,6,10,16,961,889,1850,1882
3405-000,2014,6,10,17,878,821,1699,1850
3405-000,2014,6,10,18,981,819,1800,1699
3405-000,2014,6,10,19,919,846,1765,1800
3405-000,2014,6,10,20,651,626,1277,1765
3405-000,2014,6,10,21,549,509,1058,1277
3405-000,2014,6,10,22,392,327,719,1058
3405-000,2014,6,10,23,242,232,474,719
3405-000,2014,6,10,24,161,147,308,474
3405-000,2014,6,11,1,96,95,191,308
3405-000,2014,6,11,2,54,71,125,191
3405-000,2014,6,11,3,44,59,103,125
3405-000,2014,6,11,4,49,59,108,103
3405-000,2014,6,11,5,69,91,160,108
3405-000,2014,6,11,6,194,168,362,160
3405-000,2014,6,11,7,419,391,810,362
3405-000,2014,6,11,8,834,978,1812,810
3405-000,2014,6,11,9,1114,1130,2244,1812
3405-000,2014,6,11,10,911,762,1673,2244
3405-000,2014,6,11,11,946,790,1736,1673
3405-000,2014,6,11,12,916,762,1678,1736
3405-000,2014,6,11,13,721,744,1465,1678
3405-000,2014,6,11,14,754,781,1535,1465
3405-000,2014,6,11,15,906,860,1766,1535
3405-000,2014,6,11,16,975,862,1837,1766
3405-000,2014,6,11,17,907,760,1667,1837
3405-000,2014,6,11,18,985,796,1781,1667
3405-000,2014,6,11,19,966,871,1837,1781
3405-000,2014,6,11,20,645,621,1266,1837
3405-000,2014,6,11,21,447,494,941,1266
3405-000,2014,6,11,22,370,356,726,941
3405-000,2014,6,11,23,280,219,499,726
3405-000,2014,6,11,24,155,157,312,499
3405-000,2014,6,12,1,79,97,176,312
3405-000,2014,6,12,2,49,69,118,176
3405-000,2014,6,12,3,50,58,108,118
3405-000,2014,6,12,4,53,58,111,108
3405-000,2014,6,12,5,84,90,174,111
3405-000,2014,6,12,6,243,218,461,174
3405-000,2014,6,12,7,443,499,942,461
3405-000,2014,6,12,8,890,1017,1907,942
3405-000,2014,6,12,9,1072,1059,2131,1907
3405-000,2014,6,12,10,957,807,1764,2131
3405-000,2014,6,12,11,929,836,1765,1764
3405-000,2014,6,12,12,884,812,1696,1765
3405-000,2014,6,12,13,774,674,1448,1696
3405-000,2014,6,12,14,800,804,1604,1448
3405-000,2014,6,12,15,888,842,1730,1604
3405-000,2014,6,12,16,911,740,1651,1730
3405-000,2014,6,12,17,936,767,1703,1651
3405-000,2014,6,12,18,1017,824,1841,1703
3405-000,2014,6,12,19,941,862,1803,1841
3405-000,2014,6,12,20,615,571,1186,1803
3405-000,2014,6,12,21,470,554,1024,1186
3405-000,2014,6,12,22,365,370,735,1024
3405-000,2014,6,12,23,265,244,509,735
3405-000,2014,6,12,24,171,168,339,509
3405-000,2014,6,13,1,81,100,181,339
3405-000,2014,6,13,2,62,63,125,181
3405-000,2014,6,13,3,53,76,129,125
3405-000,2014,6,13,4,53,74,127,129
3405-000,2014,6,13,5,92,89,181,127
3405-000,2014,6,13,6,204,206,410,181
3405-000,2014,6,13,7,407,445,852,410
3405-000,2014,6,13,8,834,1034,1868,852
3405-000,2014,6,13,9,1112,1124,2236,1868
3405-000,2014,6,13,10,958,803,1761,2236
3405-000,2014,6,13,11,929,907,1836,1761
3405-000,2014,6,13,12,967,822,1789,1836
3405-000,2014,6,13,13,861,762,1623,1789
3405-000,2014,6,13,14,853,851,1704,1623
3405-000,2014,6,13,15,955,877,1832,1704
3405-000,2014,6,13,16,949,914,1863,1832
3405-000,2014,6,13,17,990,834,1824,1863
3405-000,2014,6,13,18,1087,901,1988,1824
3405-000,2014,6,13,19,1178,960,2138,1988
3405-000,2014,6,13,20,866,615,1481,2138
3405-000,2014,6,13,21,652,536,1188,1481
3405-000,2014,6,13,22,445,392,837,1188
3405-000,2014,6,13,23,286,250,536,837
3405-000,2014,6,13,24,173,187,360,536
3405-000,2014,6,14,1,131,104,235,360
3405-000,2014,6,14,2,67,71,138,235
3405-000,2014,6,14,3,56,65,121,138
3405-000,2014,6,14,4,45,68,113,121
3405-000,2014,6,14,5,97,116,213,113
3405-000,2014,6,14,6,185,168,353,213
3405-000,2014,6,14,7,411,345,756,353
3405-000,2014,6,14,8,639,525,1164,756
3405-000,2014,6,14,9,808,658,1466,1164
3405-000,2014,6,14,10,807,634,1441,1466
3405-000,2014,6,14,11,843,642,1485,1441
3405-000,2014,6,14,12,815,595,1410,1485
3405-000,2014,6,14,13,663,571,1234,1410
3405-000,2014,6,14,14,636,587,1223,1234
3405-000,2014,6,14,15,738,629,1367,1223
3405-000,2014,6,14,16,725,639,1364,1367
3405-000,2014,6,14,17,708,545,1253,1364
3405-000,2014,6,14,18,838,649,1487,1253
3405-000,2014,6,14,19,669,611,1280,1487
3405-000,2014,6,14,20,479,451,930,1280
3405-000,2014,6,14,21,369,394,763,930
3405-000,2014,6,14,22,309,306,615,763
3405-000,2014,6,14,23,219,224,443,615
3405-000,2014,6,14,24,122,134,256,443
3405-000,2014,6,15,1,79,90,169,256
3405-000,2014,6,15,2,56,50,106,169
3405-000,2014,6,15,3,45,34,79,106
3405-000,2014,6,15,4,26,34,60,79
3405-000,2014,6,15,5,58,52,110,60
3405-000,2014,6,15,6,108,72,180,110
3405-000,2014,6,15,7,201,163,364,180
3405-000,2014,6,15,8,294,247,541,364
3405-000,2014,6,15,9,360,307,667,541
3405-000,2014,6,15,10,410,311,721,667
3405-000,2014,6,15,11,445,377,822,721
3405-000,2014,6,15,12,420,417,837,822
3405-000,2014,6,15,13,387,374,761,837
3405-000,2014,6,15,14,368,434,802,761
3405-000,2014,6,15,15,450,470,920,802
3405-000,2014,6,15,16,463,542,1005,920
3405-000,2014,6,15,17,496,521,1017,1005
3405-000,2014,6,15,18,494,574,1068,1017
3405-000,2014,6,15,19,440,512,952,1068
3405-000,2014,6,15,20,342,428,770,952
3405-000,2014,6,15,21,310,424,734,770
3405-000,2014,6,15,22,253,322,575,734
3405-000,2014,6,15,23,155,244,399,575
3405-000,2014,6,15,24,125,162,287,399
3405-000,2014,6,16,1,55,104,159,287
3405-000,2014,6,16,2,31,77,108,159
3405-000,2014,6,16,3,27,45,72,108
3405-000,2014,6,16,4,42,74,116,72
3405-000,2014,6,16,5,77,95,172,116
3405-000,2014,6,16,6,222,252,474,172
3405-000,2014,6,16,7,502,617,1119,474
3405-000,2014,6,16,8,887,1322,2209,1119
3405-000,2014,6,16,9,1071,1133,2204,2209
3405-000,2014,6,16,10,868,752,1620,2204
3405-000,2014,6,16,11,900,771,1671,1620
3405-000,2014,6,16,12,863,839,1702,1671
3405-000,2014,6,16,13,769,679,1448,1702
3405-000,2014,6,16,14,794,831,1625,1448
3405-000,2014,6,16,15,960,875,1835,1625
3405-000,2014,6,16,16,921,869,1790,1835
3405-000,2014,6,16,17,892,790,1682,1790
3405-000,2014,6,16,18,906,813,1719,1682
3405-000,2014,6,16,19,922,841,1763,1719
3405-000,2014,6,16,20,630,570,1200,1763
3405-000,2014,6,16,21,505,559,1064,1200
3405-000,2014,6,16,22,304,366,670,1064
3405-000,2014,6,16,23,227,210,437,670
3405-000,2014,6,16,24,140,138,278,437
3405-000,2014,6,17,1,107,95,202,278
3405-000,2014,6,17,2,69,77,146,202
3405-000,2014,6,17,3,39,59,98,146
3405-000,2014,6,17,4,36,63,99,98
3405-000,2014,6,17,5,97,97,194,99
3405-000,2014,6,17,6,182,201,383,194
3405-000,2014,6,17,7,438,421,859,383
3405-000,2014,6,17,8,863,990,1853,859
3405-000,2014,6,17,9,1065,1092,2157,1853
3405-000,2014,6,17,10,958,823,1781,2157
3405-000,2014,6,17,11,956,791,1747,1781
3405-000,2014,6,17,12,894,811,1705,1747
3405-000,2014,6,17,13,725,653,1378,1705
3405-000,2014,6,17,14,821,732,1553,1378
3405-000,2014,6,17,15,939,925,1864,1553
3405-000,2014,6,17,16,951,877,1828,1864
3405-000,2014,6,17,17,988,794,1782,1828
3405-000,2014,6,17,18,926,841,1767,1782
3405-000,2014,6,17,19,907,831,1738,1767
3405-000,2014,6,17,20,656,569,1225,1738
3405-000,2014,6,17,21,527,555,1082,1225
3405-000,2014,6,17,22,349,380,729,1082
3405-000,2014,6,17,23,287,219,506,729
3405-000,2014,6,17,24,196,144,340,506
3405-000,2014,6,18,1,107,106,213,340
3405-000,2014,6,18,2,69,78,147,213
3405-000,2014,6,18,3,46,59,105,147
3405-000,2014,6,18,4,48,62,110,105
3405-000,2014,6,18,5,84,119,203,110
3405-000,2014,6,18,6,204,189,393,203
3405-000,2014,6,18,7,455,498,953,393
3405-000,2014,6,18,8,840,938,1778,953
3405-000,2014,6,18,9,956,917,1873,1778
3405-000,2014,6,18,10,954,815,1769,1873
3405-000,2014,6,18,11,982,863,1845,1769
3405-000,2014,6,18,12,905,765,1670,1845
3405-000,2014,6,18,13,706,643,1349,1670
3405-000,2014,6,18,14,803,821,1624,1349
3405-000,2014,6,18,15,919,843,1762,1624
3405-000,2014,6,18,16,905,843,1748,1762
3405-000,2014,6,18,17,917,777,1694,1748
3405-000,2014,6,18,18,967,868,1835,1694
3405-000,2014,6,18,19,928,891,1819,1835
3405-000,2014,6,18,20,659,631,1290,1819
3405-000,2014,6,18,21,495,471,966,1290
3405-000,2014,6,18,22,351,318,669,966
3405-000,2014,6,18,23,258,224,482,669
3405-000,2014,6,18,24,174,152,326,482
3405-000,2014,6,19,1,104,101,205,326
3405-000,2014,6,19,2,51,83,134,205
3405-000,2014,6,19,3,38,55,93,134
3405-000,2014,6,19,4,44,60,104,93
3405-000,2014,6,19,5,89,97,186,104
3405-000,2014,6,19,6,212,180,392,186
3405-000,2014,6,19,7,464,440,904,392
3405-000,2014,6,19,8,867,1021,1888,904
3405-000,2014,6,19,9,1050,1081,2131,1888
3405-000,2014,6,19,10,921,821,1742,2131
3405-000,2014,6,19,11,926,865,1791,1742
3405-000,2014,6,19,12,876,772,1648,1791
3405-000,2014,6,19,13,752,739,1491,1648
3405-000,2014,6,19,14,812,793,1605,1491
3405-000,2014,6,19,15,1000,932,1932,1605
3405-000,2014,6,19,16,956,823,1779,1932
3405-000,2014,6,19,17,979,749,1728,1779
3405-000,2014,6,19,18,954,819,1773,1728
3405-000,2014,6,19,19,900,793,1693,1773
3405-000,2014,6,19,20,667,639,1306,1693
3405-000,2014,6,19,21,516,487,1003,1306
3405-000,2014,6,19,22,361,364,725,1003
3405-000,2014,6,19,23,261,235,496,725
3405-000,2014,6,19,24,137,162,299,496
3405-000,2014,6,20,1,105,95,200,299
3405-000,2014,6,20,2,56,80,136,200
3405-000,2014,6,20,3,46,64,110,136
3405-000,2014,6,20,4,49,79,128,110
3405-000,2014,6,20,5,79,110,189,128
3405-000,2014,6,20,6,198,185,383,189
3405-000,2014,6,20,7,439,444,883,383
3405-000,2014,6,20,8,886,993,1879,883
3405-000,2014,6,20,9,1084,1064,2148,1879
3405-000,2014,6,20,10,971,824,1795,2148
3405-000,2014,6,20,11,982,847,1829,1795
3405-000,2014,6,20,12,968,846,1814,1829
3405-000,2014,6,20,13,814,746,1560,1814
3405-000,2014,6,20,14,886,769,1655,1560
3405-000,2014,6,20,15,984,891,1875,1655
3405-000,2014,6,20,16,1019,926,1945,1875
3405-000,2014,6,20,17,995,781,1776,1945
3405-000,2014,6,20,18,1144,852,1996,1776
3405-000,2014,6,20,19,1190,905,2095,1996
3405-000,2014,6,20,20,892,673,1565,2095
3405-000,2014,6,20,21,604,528,1132,1565
3405-000,2014,6,20,22,445,388,833,1132
3405-000,2014,6,20,23,272,222,494,833
3405-000,2014,6,20,24,178,148,326,494
3405-000,2014,6,21,1,107,110,217,326
3405-000,2014,6,21,2,66,80,146,217
3405-000,2014,6,21,3,52,60,112,146
3405-000,2014,6,21,4,48,74,122,112
3405-000,2014,6,21,5,72,78,150,122
3405-000,2014,6,21,6,164,167,331,150
3405-000,2014,6,21,7,352,318,670,331
3405-000,2014,6,21,8,613,489,1102,670
3405-000,2014,6,21,9,766,625,1391,1102
3405-000,2014,6,21,10,781,611,1392,1391
3405-000,2014,6,21,11,760,691,1451,1392
3405-000,2014,6,21,12,732,602,1334,1451
3405-000,2014,6,21,13,715,578,1293,1334
3405-000,2014,6,21,14,636,651,1287,1293
3405-000,2014,6,21,15,663,575,1238,1287
3405-000,2014,6,21,16,739,581,1320,1238
3405-000,2014,6,21,17,685,562,1247,1320
3405-000,2014,6,21,18,821,702,1523,1247
3405-000,2014,6,21,19,691,580,1271,1523
3405-000,2014,6,21,20,453,460,913,1271
3405-000,2014,6,21,21,351,336,687,913
3405-000,2014,6,21,22,271,267,538,687
3405-000,2014,6,21,23,199,220,419,538
3405-000,2014,6,21,24,182,160,342,419
3405-000,2014,6,22,1,87,75,162,342
3405-000,2014,6,22,2,66,51,117,162
3405-000,2014,6,22,3,28,41,69,117
3405-000,2014,6,22,4,38,41,79,69
3405-000,2014,6,22,5,54,50,104,79
3405-000,2014,6,22,6,108,83,191,104
3405-000,2014,6,22,7,223,167,390,191
3405-000,2014,6,22,8,287,242,529,390
3405-000,2014,6,22,9,371,296,667,529
3405-000,2014,6,22,10,378,280,658,667
3405-000,2014,6,22,11,473,378,851,658
3405-000,2014,6,22,12,425,410,835,851
3405-000,2014,6,22,13,367,393,760,835
3405-000,2014,6,22,14,435,394,829,760
3405-000,2014,6,22,15,431,490,921,829
3405-000,2014,6,22,16,473,629,1102,921
3405-000,2014,6,22,17,488,556,1044,1102
3405-000,2014,6,22,18,500,624,1124,1044
3405-000,2014,6,22,19,458,532,990,1124
3405-000,2014,6,22,20,382,521,903,990
3405-000,2014,6,22,21,329,430,759,903
3405-000,2014,6,22,22,221,336,557,759
3405-000,2014,6,22,23,177,266,443,557
3405-000,2014,6,22,24,116,153,269,443
3405-000,2014,6,23,1,86,108,194,269
3405-000,2014,6,23,2,35,86,121,194
3405-000,2014,6,23,3,23,51,74,121
3405-000,2014,6,23,4,46,78,124,74
3405-000,2014,6,23,5,87,108,195,124
3405-000,2014,6,23,6,208,241,449,195
3405-000,2014,6,23,7,490,568,1058,449
3405-000,2014,6,23,8,905,1272,2177,1058
3405-000,2014,6,23,9,1067,1126,2193,2177
3405-000,2014,6,23,10,882,769,1651,2193
3405-000,2014,6,23,11,912,834,1746,1651
3405-000,2014,6,23,12,913,832,1745,1746
3405-000,2014,6,23,13,698,712,1410,1745
3405-000,2014,6,23,14,827,817,1644,1410
3405-000,2014,6,23,15,917,863,1780,1644
3405-000,2014,6,23,16,917,866,1783,1780
3405-000,2014,6,23,17,875,796,1671,1783
3405-000,2014,6,23,18,907,850,1757,1671
3405-000,2014,6,23,19,895,830,1725,1757
3405-000,2014,6,23,20,691,623,1314,1725
3405-000,2014,6,23,21,499,534,1033,1314
3405-000,2014,6,23,22,365,391,756,1033
3405-000,2014,6,23,23,238,225,463,756
3405-000,2014,6,23,24,156,140,296,463
3405-000,2014,6,24,1,90,97,187,296
3405-000,2014,6,24,2,66,67,133,187
3405-000,2014,6,24,3,41,65,106,133
3405-000,2014,6,24,4,46,69,115,106
3405-000,2014,6,24,5,86,115,201,115
3405-000,2014,6,24,6,179,208,387,201
3405-000,2014,6,24,7,443,398,841,387
3405-000,2014,6,24,8,898,1026,1924,841
3405-000,2014,6,24,9,1117,1115,2232,1924
3405-000,2014,6,24,10,936,802,1738,2232
3405-000,2014,6,24,11,975,866,1841,1738
3405-000,2014,6,24,12,918,863,1781,1841
3405-000,2014,6,24,13,754,664,1418,1781
3405-000,2014,6,24,14,852,811,1663,1418
3405-000,2014,6,24,15,984,876,1860,1663
3405-000,2014,6,24,16,911,836,1747,1860
3405-000,2014,6,24,17,885,762,1647,1747
3405-000,2014,6,24,18,936,872,1808,1647
3405-000,2014,6,24,19,898,824,1722,1808
3405-000,2014,6,24,20,681,630,1311,1722
3405-000,2014,6,24,21,518,509,1027,1311
3405-000,2014,6,24,22,352,391,743,1027
3405-000,2014,6,24,23,231,234,465,743
3405-000,2014,6,24,24,150,162,312,465
3405-000,2014,6,25,1,87,113,200,312
3405-000,2014,6,25,2,58,75,133,200
3405-000,2014,6,25,3,48,59,107,133
3405-000,2014,6,25,4,53,71,124,107
3405-000,2014,6,25,5,111,103,214,124
3405-000,2014,6,25,6,204,212,416,214
3405-000,2014,6,25,7,456,406,862,416
3405-000,2014,6,25,8,846,1017,1863,862
3405-000,2014,6,25,9,1105,1117,2222,1863
3405-000,2014,6,25,10,968,809,1777,2222
3405-000,2014,6,25,11,1010,892,1902,1777
3405-000,2014,6,25,12,903,816,1719,1902
3405-000,2014,6,25,13,801,685,1486,1719
3405-000,2014,6,25,14,747,774,1521,1486
3405-000,2014,6,25,15,920,865,1785,1521
3405-000,2014,6,25,16,959,858,1817,1785
3405-000,2014,6,25,17,930,815,1745,1817
3405-000,2014,6,25,18,1014,850,1864,1745
3405-000,2014,6,25,19,913,865,1778,1864
3405-000,2014,6,25,20,616,650,1266,1778
3405-000,2014,6,25,21,435,485,920,1266
3405-000,2014,6,25,22,347,385,732,920
3405-000,2014,6,25,23,242,218,460,732
3405-000,2014,6,25,24,164,167,331,460
3405-000,2014,6,26,1,98,92,190,331
3405-000,2014,6,26,2,59,75,134,190
3405-000,2014,6,26,3,34,59,93,134
3405-000,2014,6,26,4,64,82,146,93
3405-000,2014,6,26,5,85,81,166,146
3405-000,2014,6,26,6,197,193,390,166
3405-000,2014,6,26,7,425,443,868,390
3405-000,2014,6,26,8,915,1028,1943,868
3405-000,2014,6,26,9,1086,1075,2161,1943
3405-000,2014,6,26,10,941,804,1745,2161
3405-000,2014,6,26,11,982,863,1845,1745
3405-000,2014,6,26,12,936,812,1748,1845
3405-000,2014,6,26,13,710,699,1409,1748
3405-000,2014,6,26,14,823,803,1626,1409
3405-000,2014,6,26,15,1016,889,1905,1626
3405-000,2014,6,26,16,889,871,1760,1905
3405-000,2014,6,26,17,962,748,1710,1760
3405-000,2014,6,26,18,963,871,1834,1710
3405-000,2014,6,26,19,920,827,1747,1834
3405-000,2014,6,26,20,611,609,1220,1747
3405-000,2014,6,26,21,486,557,1043,1220
3405-000,2014,6,26,22,357,365,722,1043
3405-000,2014,6,26,23,276,267,543,722
3405-000,2014,6,26,24,163,191,354,543
3405-000,2014,6,27,1,118,99,217,354
3405-000,2014,6,27,2,71,74,145,217
3405-000,2014,6,27,3,47,66,113,145
3405-000,2014,6,27,4,62,98,160,113
3405-000,2014,6,27,5,103,98,201,160
3405-000,2014,6,27,6,200,181,381,201
3405-000,2014,6,27,7,394,446,840,381
3405-000,2014,6,27,8,946,1030,1976,840
3405-000,2014,6,27,9,1139,1078,2217,1976
3405-000,2014,6,27,10,926,795,1721,2217
3405-000,2014,6,27,11,960,809,1769,1721
3405-000,2014,6,27,12,896,826,1722,1769
3405-000,2014,6,27,13,765,723,1488,1722
3405-000,2014,6,27,14,823,733,1556,1488
3405-000,2014,6,27,15,1040,999,2039,1556
3405-000,2014,6,27,16,952,854,1806,2039
3405-000,2014,6,27,17,951,869,1820,1806
3405-000,2014,6,27,18,1099,852,1951,1820
3405-000,2014,6,27,19,1141,928,2069,1951
3405-000,2014,6,27,20,829,668,1497,2069
3405-000,2014,6,27,21,591,572,1163,1497
3405-000,2014,6,27,22,408,402,810,1163
3405-000,2014,6,27,23,306,223,529,810
3405-000,2014,6,27,24,141,145,286,529
3405-000,2014,6,28,1,93,111,204,286
3405-000,2014,6,28,2,65,82,147,204
3405-000,2014,6,28,3,52,45,97,147
3405-000,2014,6,28,4,67,81,148,97
3405-000,2014,6,28,5,89,101,190,148
3405-000,2014,6,28,6,206,183,389,190
3405-000,2014,6,28,7,418,338,756,389
3405-000,2014,6,28,8,674,492,1166,756
3405-000,2014,6,28,9,810,715,1525,1166
3405-000,2014,6,28,10,799,638,1437,1525
3405-000,2014,6,28,11,777,664,1441,1437
3405-000,2014,6,28,12,745,549,1294,1441
3405-000,2014,6,28,13,656,602,1258,1294
3405-000,2014,6,28,14,678,679,1357,1258
3405-000,2014,6,28,15,728,653,1381,1357
3405-000,2014,6,28,16,698,646,1344,1381
3405-000,2014,6,28,17,786,602,1388,1344
3405-000,2014,6,28,18,719,648,1367,1388
3405-000,2014,6,28,19,714,488,1202,1367
3405-000,2014,6,28,20,465,444,909,1202
3405-000,2014,6,28,21,376,374,750,909
3405-000,2014,6,28,22,292,288,580,750
3405-000,2014,6,28,23,200,202,402,580
3405-000,2014,6,28,24,137,132,269,402
3405-000,2014,6,29,1,88,71,159,269
3405-000,2014,6,29,2,42,62,104,159
3405-000,2014,6,29,3,45,25,70,104
3405-000,2014,6,29,4,27,31,58,70
3405-000,2014,6,29,5,61,40,101,58
3405-000,2014,6,29,6,142,101,243,101
3405-000,2014,6,29,7,227,144,371,243
3405-000,2014,6,29,8,284,257,541,371
3405-000,2014,6,29,9,419,307,726,541
3405-000,2014,6,29,10,421,325,746,726
3405-000,2014,6,29,11,479,356,835,746
3405-000,2014,6,29,12,454,420,874,835
3405-000,2014,6,29,13,427,417,844,874
3405-000,2014,6,29,14,438,453,891,844
3405-000,2014,6,29,15,447,488,935,891
3405-000,2014,6,29,16,470,553,1023,935
3405-000,2014,6,29,17,445,573,1018,1023
3405-000,2014,6,29,18,519,534,1053,1018
3405-000,2014,6,29,19,443,547,990,1053
3405-000,2014,6,29,20,329,480,809,990
3405-000,2014,6,29,21,297,407,704,809
3405-000,2014,6,29,22,262,322,584,704
3405-000,2014,6,29,23,192,234,426,584
3405-000,2014,6,29,24,104,166,270,426
3405-000,2014,6,30,1,63,108,171,270
3405-000,2014,6,30,2,29,63,92,171
3405-000,2014,6,30,3,22,67,89,92
3405-000,2014,6,30,4,49,72,121,89
3405-000,2014,6,30,5,87,113,200,121
3405-000,2014,6,30,6,233,250,483,200
3405-000,2014,6,30,7,486,624,1110,483
3405-000,2014,6,30,8,921,1350,2271,1110
3405-000,2014,6,30,9,1064,1111,2175,2271
3405-000,2014,6,30,10,883,753,1636,2175
3405-000,2014,6,30,11,914,767,1681,1636
3405-000,2014,6,30,12,862,787,1649,1681
3405-000,2014,6,30,13,689,709,1398,1649
3405-000,2014,6,30,14,766,801,1567,1398
3405-000,2014,6,30,15,958,851,1809,1567
3405-000,2014,6,30,16,939,872,1811,1809
3405-000,2014,6,30,17,904,823,1727,1811
3405-000,2014,6,30,18,933,842,1775,1727
3405-000,2014,6,30,19,891,852,1743,1775
3405-000,2014,6,30,20,648,615,1263,1743
3405-000,2014,6,30,21,525,512,1037,1263
3405-000,2014,6,30,22,357,354,711,1037
3405-000,2014,6,30,23,238,200,438,711
3405-000,2014,6,30,24,145,138,283,438
3405-000,2014,7,1,1,88,99,187,283
3405-000,2014,7,1,2,55,82,137,187
3405-000,2014,7,1,3,40,73,113,137
3405-000,2014,7,1,4,55,76,131,113
3405-000,2014,7,1,5,88,97,185,131
3405-000,2014,7,1,6,207,203,410,185
3405-000,2014,7,1,7,462,458,920,410
3405-000,2014,7,1,8,928,1086,2014,920
3405-000,2014,7,1,9,1095,1023,2118,2014
3405-000,2014,7,1,10,955,807,1762,2118
3405-000,2014,7,1,11,976,837,1813,1762
3405-000,2014,7,1,12,835,817,1652,1813
3405-000,2014,7,1,13,711,641,1352,1652
3405-000,2014,7,1,14,782,790,1572,1352
3405-000,2014,7,1,15,936,927,1863,1572
3405-000,2014,7,1,16,912,837,1749,1863
3405-000,2014,7,1,17,913,726,1639,1749
3405-000,2014,7,1,18,879,887,1766,1639
3405-000,2014,7,1,19,929,837,1766,1766
3405-000,2014,7,1,20,660,597,1257,1766
3405-000,2014,7,1,21,491,482,973,1257
3405-000,2014,7,1,22,345,363,708,973
3405-000,2014,7,1,23,245,251,496,708
3405-000,2014,7,1,24,150,159,309,496
3405-000,2014,7,2,1,81,90,171,309
3405-000,2014,7,2,2,65,57,122,171
3405-000,2014,7,2,3,44,66,110,122
3405-000,2014,7,2,4,45,75,120,110
3405-000,2014,7,2,5,82,98,180,120
3405-000,2014,7,2,6,208,193,401,180
3405-000,2014,7,2,7,457,444,901,401
3405-000,2014,7,2,8,933,1076,2009,901
3405-000,2014,7,2,9,1093,1006,2099,2009
3405-000,2014,7,2,10,979,820,1799,2099
3405-000,2014,7,2,11,955,860,1815,1799
3405-000,2014,7,2,12,924,831,1755,1815
3405-000,2014,7,2,13,734,670,1404,1755
3405-000,2014,7,2,14,769,850,1619,1404
3405-000,2014,7,2,15,988,912,1900,1619
3405-000,2014,7,2,16,933,858,1791,1900
3405-000,2014,7,2,17,887,781,1668,1791
3405-000,2014,7,2,18,1039,927,1966,1668
3405-000,2014,7,2,19,975,821,1796,1966
3405-000,2014,7,2,20,601,556,1157,1796
3405-000,2014,7,2,21,455,468,923,1157
3405-000,2014,7,2,22,304,315,619,923
3405-000,2014,7,2,23,221,201,422,619
3405-000,2014,7,2,24,110,121,231,422
3405-000,2014,7,3,1,93,98,191,231
3405-000,2014,7,3,2,67,72,139,191
3405-000,2014,7,3,3,40,64,104,139
3405-000,2014,7,3,4,42,70,112,104
3405-000,2014,7,3,5,71,71,142,112
3405-000,2014,7,3,6,157,159,316,142
3405-000,2014,7,3,7,423,373,796,316
3405-000,2014,7,3,8,893,1015,1908,796
3405-000,2014,7,3,9,1068,1044,2112,1908
3405-000,2014,7,3,10,924,739,1663,2112
3405-000,2014,7,3,11,906,795,1701,1663
3405-000,2014,7,3,12,855,763,1618,1701
3405-000,2014,7,3,13,736,641,1377,1618
3405-000,2014,7,3,14,832,796,1628,1377
3405-000,2014,7,3,15,840,869,1709,1628
3405-000,2014,7,3,16,956,821,1777,1709
3405-000,2014,7,3,17,814,794,1608,1777
3405-000,2014,7,3,18,920,835,1755,1608
3405-000,2014,7,3,19,826,803,1629,1755
3405-000,2014,7,3,20,618,556,1174,1629
3405-000,2014,7,3,21,464,463,927,1174
3405-000,2014,7,3,22,318,349,667,927
3405-000,2014,7,3,23,245,210,455,667
3405-000,2014,7,3,24,143,153,296,455
3405-000,2014,7,4,1,87,84,171,296
3405-000,2014,7,4,2,59,70,129,171
3405-000,2014,7,4,3,40,75,115,129
3405-000,2014,7,4,4,56,84,140,115
3405-000,2014,7,4,5,72,89,161,140
3405-000,2014,7,4,6,211,219,430,161
3405-000,2014,7,4,7,492,480,972,430
3405-000,2014,7,4,8,907,1090,1997,972
3405-000,2014,7,4,9,1084,1011,2095,1997
3405-000,2014,7,4,10,981,811,1792,2095
3405-000,2014,7,4,11,971,863,1834,1792
3405-000,2014,7,4,12,967,867,1834,1834
3405-000,2014,7,4,13,789,697,1486,1834
3405-000,2014,7,4,14,840,859,1699,1486
3405-000,2014,7,4,15,1038,918,1956,1699
3405-000,2014,7,4,16,1010,866,1876,1956
3405-000,2014,7,4,17,1013,909,1922,1876
3405-000,2014,7,4,18,1198,875,2073,1922
3405-000,2014,7,4,19,1263,907,2170,2073
3405-000,2014,7,4,20,820,702,1522,2170
3405-000,2014,7,4,21,597,553,1150,1522
3405-000,2014,7,4,22,458,336,794,1150
3405-000,2014,7,4,23,323,248,571,794
3405-000,2014,7,4,24,165,153,318,571
3405-000,2014,7,5,1,127,112,239,318
3405-000,2014,7,5,2,69,63,132,239
3405-000,2014,7,5,3,49,77,126,132
3405-000,2014,7,5,4,49,76,125,126
3405-000,2014,7,5,5,89,94,183,125
3405-000,2014,7,5,6,217,176,393,183
3405-000,2014,7,5,7,417,320,737,393
3405-000,2014,7,5,8,626,529,1155,737
3405-000,2014,7,5,9,812,625,1437,1155
3405-000,2014,7,5,10,824,685,1509,1437
3405-000,2014,7,5,11,825,711,1536,1509
3405-000,2014,7,5,12,803,651,1454,1536
3405-000,2014,7,5,13,753,572,1325,1454
3405-000,2014,7,5,14,631,596,1227,1325
3405-000,2014,7,5,15,732,642,1374,1227
3405-000,2014,7,5,16,742,598,1340,1374
3405-000,2014,7,5,17,722,632,1354,1340
3405-000,2014,7,5,18,772,681,1453,1354
3405-000,2014,7,5,19,738,565,1303,1453
3405-000,2014,7,5,20,418,398,816,1303
3405-000,2014,7,5,21,345,356,701,816
3405-000,2014,7,5,22,260,270,530,701
3405-000,2014,7,5,23,227,205,432,530
3405-000,2014,7,5,24,115,129,244,432
3405-000,2014,7,6,1,77,79,156,244
3405-000,2014,7,6,2,32,40,72,156
3405-000,2014,7,6,3,33,47,80,72
3405-000,2014,7,6,4,45,28,73,80
3405-000,2014,7,6,5,45,40,85,73
3405-000,2014,7,6,6,121,95,216,85
3405-000,2014,7,6,7,198,152,350,216
3405-000,2014,7,6,8,289,254,543,350
3405-000,2014,7,6,9,397,298,695,543
3405-000,2014,7,6,10,427,329,756,695
3405-000,2014,7,6,11,456,435,891,756
3405-000,2014,7,6,12,411,405,816,891
3405-000,2014,7,6,13,392,422,814,816
3405-000,2014,7,6,14,409,444,853,814
3405-000,2014,7,6,15,464,540,1004,853
3405-000,2014,7,6,16,524,551,1075,1004
3405-000,2014,7,6,17,519,534,1053,1075
3405-000,2014,7,6,18,483,589,1072,1053
3405-000,2014,7,6,19,414,499,913,1072
3405-000,2014,7,6,20,293,444,737,913
3405-000,2014,7,6,21,319,397,716,737
3405-000,2014,7,6,22,247,321,568,716
3405-000,2014,7,6,23,177,231,408,568
3405-000,2014,7,6,24,126,178,304,408
3405-000,2014,7,7,1,81,100,181,304
3405-000,2014,7,7,2,28,67,95,181
3405-000,2014,7,7,3,32,64,96,95
3405-000,2014,7,7,4,39,77,116,96
3405-000,2014,7,7,5,87,95,182,116
3405-000,2014,7,7,6,223,243,466,182
3405-000,2014,7,7,7,495,594,1089,466
3405-000,2014,7,7,8,968,1402,2370,1089
3405-000,2014,7,7,9,1031,1086,2117,2370
3405-000,2014,7,7,10,883,799,1682,2117
3405-000,2014,7,7,11,925,807,1732,1682
3405-000,2014,7,7,12,852,804,1656,1732
3405-000,2014,7,7,13,712,712,1424,1656
3405-000,2014,7,7,14,831,808,1639,1424
3405-000,2014,7,7,15,1005,876,1881,1639
3405-000,2014,7,7,16,952,914,1866,1881
3405-000,2014,7,7,17,858,803,1661,1866
3405-000,2014,7,7,18,964,820,1784,1661
3405-000,2014,7,7,19,907,876,1783,1784
3405-000,2014,7,7,20,653,610,1263,1783
3405-000,2014,7,7,21,475,502,977,1263
3405-000,2014,7,7,22,371,377,748,977
3405-000,2014,7,7,23,227,197,424,748
3405-000,2014,7,7,24,127,147,274,424
3405-000,2014,7,8,1,93,114,207,274
3405-000,2014,7,8,2,44,68,112,207
3405-000,2014,7,8,3,41,45,86,112
3405-000,2014,7,8,4,47,71,118,86
3405-000,2014,7,8,5,83,102,185,118
3405-000,2014,7,8,6,215,194,409,185
3405-000,2014,7,8,7,430,408,838,409
3405-000,2014,7,8,8,901,1076,1977,838
3405-000,2014,7,8,9,1094,1006,2100,1977
3405-000,2014,7,8,10,995,836,1831,2100
3405-000,2014,7,8,11,967,847,1814,1831
3405-000,2014,7,8,12,873,816,1689,1814
3405-000,2014,7,8,13,768,694,1462,1689
3405-000,2014,7,8,14,861,839,1700,1462
3405-000,2014,7,8,15,952,891,1843,1700
3405-000,2014,7,8,16,918,900,1818,1843
3405-000,2014,7,8,17,939,778,1717,1818
3405-000,2014,7,8,18,921,778,1699,1717
3405-000,2014,7,8,19,961,860,1821,1699
3405-000,2014,7,8,20,584,588,1172,1821
3405-000,2014,7,8,21,529,486,1015,1172
3405-000,2014,7,8,22,365,365,730,1015
3405-000,2014,7,8,23,238,223,461,730
3405-000,2014,7,8,24,138,139,277,461
3405-000,2014,7,9,1,78,81,159,277
3405-000,2014,7,9,2,55,79,134,159
3405-000,2014,7,9,3,37,62,99,134
3405-000,2014,7,9,4,47,71,118,99
3405-000,2014,7,9,5,78,94,172,118
3405-000,2014,7,9,6,208,171,379,172
3405-000,2014,7,9,7,443,457,900,379
3405-000,2014,7,9,8,870,1039,1909,900
3405-000,2014,7,9,9,1086,998,2084,1909
3405-000,2014,7,9,10,932,760,1692,2084
3405-000,2014,7,9,11,955,814,1769,1692
3405-000,2014,7,9,12,851,837,1688,1769
3405-000,2014,7,9,13,738,718,1456,1688
3405-000,2014,7,9,14,788,790,1578,1456
3405-000,2014,7,9,15,923,812,1735,1578
3405-000,2014,7,9,16,887,806,1693,1735
3405-000,2014,7,9,17,897,710,1607,1693
3405-000,2014,7,9,18,936,847,1783,1607
3405-000,2014,7,9,19,926,795,1721,1783
3405-000,2014,7,9,20,546,570,1116,1721
3405-000,2014,7,9,21,483,451,934,1116
3405-000,2014,7,9,22,335,325,660,934
3405-000,2014,7,9,23,221,191,412,660
3405-000,2014,7,9,24,143,138,281,412
3405-000,2014,7,10,1,79,86,165,281
3405-000,2014,7,10,2,61,83,144,165
3405-000,2014,7,10,3,38,61,99,144
3405-000,2014,7,10,4,45,73,118,99
3405-000,2014,7,10,5,63,72,135,118
3405-000,2014,7,10,6,174,180,354,135
3405-000,2014,7,10,7,437,441,878,354
3405-000,2014,7,10,8,867,1058,1925,878
3405-000,2014,7,10,9,1072,993,2065,1925
3405-000,2014,7,10,10,917,769,1686,2065
3405-000,2014,7,10,11,951,845,1796,1686
3405-000,2014,7,10,12,893,784,1677,1796
3405-000,2014,7,10,13,713,683,1396,1677
3405-000,2014,7,10,14,806,738,1544,1396
3405-000,2014,7,10,15,906,888,1794,1544
3405-000,2014,7,10,16,941,869,1810,1794
3405-000,2014,7,10,17,935,791,1726,1810
3405-000,2014,7,10,18,991,830,1821,1726
3405-000,2014,7,10,19,922,854,1776,1821
3405-000,2014,7,10,20,643,606,1249,1776
3405-000,2014,7,10,21,466,502,968,1249
3405-000,2014,7,10,22,372,345,717,968
3405-000,2014,7,10,23,237,220,457,717
3405-000,2014,7,10,24,123,153,276,457
3405-000,2014,7,11,1,92,84,176,276
3405-000,2014,7,11,2,57,67,124,176
3405-000,2014,7,11,3,49,63,112,124
3405-000,2014,7,11,4,37,70,107,112
3405-000,2014,7,11,5,81,106,187,107
3405-000,2014,7,11,6,221,177,398,187
3405-000,2014,7,11,7,488,448,936,398
3405-000,2014,7,11,8,890,1039,1929,936
3405-000,2014,7,11,9,1056,1012,2068,1929
3405-000,2014,7,11,10,963,835,1798,2068
3405-000,2014,7,11,11,993,822,1815,1798
3405-000,2014,7,11,12,944,820,1764,1815
3405-000,2014,7,11,13,667,636,1303,1764
3405-000,2014,7,11,14,843,832,1675,1303
3405-000,2014,7,11,15,1040,874,1914,1675
3405-000,2014,7,11,16,979,833,1812,1914
3405-000,2014,7,11,17,981,857,1838,1812
3405-000,2014,7,11,18,1170,887,2057,1838
3405-000,2014,7,11,19,1344,923,2267,2057
3405-000,2014,7,11,20,850,681,1531,2267
3405-000,2014,7,11,21,638,525,1163,1531
3405-000,2014,7,11,22,423,371,794,1163
3405-000,2014,7,11,23,269,219,488,794
3405-000,2014,7,11,24,165,170,335,488
3405-000,2014,7,12,1,104,116,220,335
3405-000,2014,7,12,2,88,93,181,220
3405-000,2014,7,12,3,54,55,109,181
3405-000,2014,7,12,4,44,69,113,109
3405-000,2014,7,12,5,117,104,221,113
3405-000,2014,7,12,6,218,182,400,221
3405-000,2014,7,12,7,373,324,697,400
3405-000,2014,7,12,8,671,491,1162,697
3405-000,2014,7,12,9,830,594,1424,1162
3405-000,2014,7,12,10,795,586,1381,1424
3405-000,2014,7,12,11,819,660,1479,1381
3405-000,2014,7,12,12,804,630,1434,1479
3405-000,2014,7,12,13,707,595,1302,1434
3405-000,2014,7,12,14,662,601,1263,1302
3405-000,2014,7,12,15,666,591,1257,1263
3405-000,2014,7,12,16,720,609,1329,1257
3405-000,2014,7,12,17,717,656,1373,1329
3405-000,2014,7,12,18,753,722,1475,1373
3405-000,2014,7,12,19,665,557,1222,1475
3405-000,2014,7,12,20,434,398,832,1222
3405-000,2014,7,12,21,334,340,674,832
3405-000,2014,7,12,22,266,255,521,674
3405-000,2014,7,12,23,183,220,403,521
3405-000,2014,7,12,24,111,136,247,403
3405-000,2014,7,13,1,92,85,177,247
3405-000,2014,7,13,2,47,62,109,177
3405-000,2014,7,13,3,53,56,109,109
3405-000,2014,7,13,4,30,34,64,109
3405-000,2014,7,13,5,42,33,75,64
3405-000,2014,7,13,6,102,59,161,75
3405-000,2014,7,13,7,184,144,328,161
3405-000,2014,7,13,8,303,229,532,328
3405-000,2014,7,13,9,343,279,622,532
3405-000,2014,7,13,10,440,313,753,622
3405-000,2014,7,13,11,525,364,889,753
3405-000,2014,7,13,12,456,416,872,889
3405-000,2014,7,13,13,409,382,791,872
3405-000,2014,7,13,14,449,436,885,791
3405-000,2014,7,13,15,481,477,958,885
3405-000,2014,7,13,16,481,532,1013,958
3405-000,2014,7,13,17,510,593,1103,1013
3405-000,2014,7,13,18,469,557,1026,1103
3405-000,2014,7,13,19,454,589,1043,1026
3405-000,2014,7,13,20,372,507,879,1043
3405-000,2014,7,13,21,343,448,791,879
3405-000,2014,7,13,22,262,373,635,791
3405-000,2014,7,13,23,165,244,409,635
3405-000,2014,7,13,24,109,200,309,409
3405-000,2014,7,14,1,72,108,180,309
3405-000,2014,7,14,2,32,56,88,180
3405-000,2014,7,14,3,33,52,85,88
3405-000,2014,7,14,4,40,68,108,85
3405-000,2014,7,14,5,74,88,162,108
3405-000,2014,7,14,6,204,237,441,162
3405-000,2014,7,14,7,548,579,1127,441
3405-000,2014,7,14,8,977,1374,2351,1127
3405-000,2014,7,14,9,1055,1109,2164,2351
3405-000,2014,7,14,10,867,796,1663,2164
3405-000,2014,7,14,11,891,770,1661,1663
3405-000,2014,7,14,12,875,851,1726,1661
3405-000,2014,7,14,13,763,708,1471,1726
3405-000,2014,7,14,14,775,789,1564,1471
3405-000,2014,7,14,15,879,860,1739,1564
3405-000,2014,7,14,16,926,828,1754,1739
3405-000,2014,7,14,17,856,804,1660,1754
3405-000,2014,7,14,18,936,777,1713,1660
3405-000,2014,7,14,19,926,808,1734,1713
3405-000,2014,7,14,20,624,576,1200,1734
3405-000,2014,7,14,21,454,502,956,1200
3405-000,2014,7,14,22,350,385,735,956
3405-000,2014,7,14,23,248,210,458,735
3405-000,2014,7,14,24,150,139,289,458
3405-000,2014,7,15,1,91,97,188,289
3405-000,2014,7,15,2,48,79,127,188
3405-000,2014,7,15,3,48,48,96,127
3405-000,2014,7,15,4,50,88,138,96
3405-000,2014,7,15,5,103,109,212,138
3405-000,2014,7,15,6,215,192,407,212
3405-000,2014,7,15,7,450,438,888,407
3405-000,2014,7,15,8,897,1083,1980,888
3405-000,2014,7,15,9,1099,1026,2125,1980
3405-000,2014,7,15,10,917,824,1741,2125
3405-000,2014,7,15,11,917,832,1749,1741
3405-000,2014,7,15,12,872,833,1705,1749
3405-000,2014,7,15,13,722,686,1408,1705
3405-000,2014,7,15,14,819,798,1617,1408
3405-000,2014,7,15,15,915,862,1777,1617
3405-000,2014,7,15,16,950,855,1805,1777
3405-000,2014,7,15,17,967,809,1776,1805
3405-000,2014,7,15,18,989,783,1772,1776
3405-000,2014,7,15,19,906,865,1771,1772
3405-000,2014,7,15,20,581,557,1138,1771
3405-000,2014,7,15,21,509,467,976,1138
3405-000,2014,7,15,22,345,371,716,976
3405-000,2014,7,15,23,240,231,471,716
3405-000,2014,7,15,24,144,168,312,471
3405-000,2014,7,16,1,82,93,175,312
3405-000,2014,7,16,2,67,71,138,175
3405-000,2014,7,16,3,40,47,87,138
3405-000,2014,7,16,4,35,78,113,87
3405-000,2014,7,16,5,69,93,162,113
3405-000,2014,7,16,6,206,195,401,162
3405-000,2014,7,16,7,433,426,859,401
3405-000,2014,7,16,8,842,1039,1881,859
3405-000,2014,7,16,9,1091,1019,2110,1881
3405-000,2014,7,16,10,901,812,1713,2110
3405-000,2014,7,16,11,908,825,1733,1713
3405-000,2014,7,16,12,880,801,1681,1733
3405-000,2014,7,16,13,750,670,1420,1681
3405-000,2014,7,16,14,802,786,1588,1420
3405-000,2014,7,16,15,999,848,1847,1588
3405-000,2014,7,16,16,948,787,1735,1847
3405-000,2014,7,16,17,975,829,1804,1735
3405-000,2014,7,16,18,1002,888,1890,1804
3405-000,2014,7,16,19,1015,914,1929,1890
3405-000,2014,7,16,20,621,559,1180,1929
3405-000,2014,7,16,21,449,478,927,1180
3405-000,2014,7,16,22,358,364,722,927
3405-000,2014,7,16,23,248,172,420,722
3405-000,2014,7,16,24,154,141,295,420
3405-000,2014,7,17,1,74,82,156,295
3405-000,2014,7,17,2,43,66,109,156
3405-000,2014,7,17,3,51,58,109,109
3405-000,2014,7,17,4,48,82,130,109
3405-000,2014,7,17,5,84,89,173,130
3405-000,2014,7,17,6,218,205,423,173
3405-000,2014,7,17,7,461,381,842,423
3405-000,2014,7,17,8,897,1037,1934,842
3405-000,2014,7,17,9,1047,1069,2116,1934
3405-000,2014,7,17,10,989,857,1846,2116
3405-000,2014,7,17,11,911,814,1725,1846
3405-000,2014,7,17,12,907,766,1673,1725
3405-000,2014,7,17,13,723,667,1390,1673
3405-000,2014,7,17,14,836,843,1679,1390
3405-000,2014,7,17,15,933,886,1819,1679
3405-000,2014,7,17,16,883,800,1683,1819
3405-000,2014,7,17,17,891,853,1744,1683
3405-000,2014,7,17,18,898,819,1717,1744
3405-000,2014,7,17,19,866,837,1703,1717
3405-000,2014,7,17,20,583,559,1142,1703
3405-000,2014,7,17,21,483,460,943,1142
3405-000,2014,7,17,22,386,370,756,943
3405-000,2014,7,17,23,240,220,460,756
3405-000,2014,7,17,24,153,157,310,460
3405-000,2014,7,18,1,104,86,190,310
3405-000,2014,7,18,2,57,75,132,190
3405-000,2014,7,18,3,38,65,103,132
3405-000,2014,7,18,4,41,77,118,103
3405-000,2014,7,18,5,80,96,176,118
3405-000,2014,7,18,6,160,134,294,176
3405-000,2014,7,18,7,318,362,680,294
3405-000,2014,7,18,8,773,919,1692,680
3405-000,2014,7,18,9,1019,1038,2057,1692
3405-000,2014,7,18,10,900,761,1661,2057
3405-000,2014,7,18,11,929,818,1747,1661
3405-000,2014,7,18,12,851,804,1655,1747
3405-000,2014,7,18,13,792,696,1488,1655
3405-000,2014,7,18,14,836,776,1612,1488
3405-000,2014,7,18,15,932,838,1770,1612
3405-000,2014,7,18,16,956,799,1755,1770
3405-000,2014,7,18,17,1029,801,1830,1755
3405-000,2014,7,18,18,1078,907,1985,1830
3405-000,2014,7,18,19,1208,892,2100,1985
3405-000,2014,7,18,20,814,657,1471,2100
3405-000,2014,7,18,21,632,547,1179,1471
3405-000,2014,7,18,22,432,379,811,1179
3405-000,2014,7,18,23,269,228,497,811
3405-000,2014,7,18,24,179,175,354,497
3405-000,2014,7,19,1,100,119,219,354
3405-000,2014,7,19,2,84,87,171,219
3405-000,2014,7,19,3,43,85,128,171
3405-000,2014,7,19,4,56,85,141,128
3405-000,2014,7,19,5,91,92,183,141
3405-000,2014,7,19,6,176,173,349,183
3405-000,2014,7,19,7,383,256,639,349
3405-000,2014,7,19,8,632,472,1104,639
3405-000,2014,7,19,9,732,567,1299,1104
3405-000,2014,7,19,10,747,561,1308,1299
3405-000,2014,7,19,11,818,574,1392,1308
3405-000,2014,7,19,12,786,620,1406,1392
3405-000,2014,7,19,13,721,588,1309,1406
3405-000,2014,7,19,14,813,566,1379,1309
3405-000,2014,7,19,15,760,509,1269,1379
3405-000,2014,7,19,16,766,596,1362,1269
3405-000,2014,7,19,17,804,539,1343,1362
3405-000,2014,7,19,18,848,629,1477,1343
3405-000,2014,7,19,19,778,494,1272,1477
3405-000,2014,7,19,20,422,379,801,1272
3405-000,2014,7,19,21,338,308,646,801
3405-000,2014,7,19,22,254,241,495,646
3405-000,2014,7,19,23,177,184,361,495
3405-000,2014,7,19,24,120,149,269,361
3405-000,2014,7,20,1,85,77,162,269
3405-000,2014,7,20,2,57,57,114,162
3405-000,2014,7,20,3,38,24,62,114
3405-000,2014,7,20,4,28,31,59,62
3405-000,2014,7,20,5,50,44,94,59
3405-000,2014,7,20,6,106,87,193,94
3405-000,2014,7,20,7,185,164,349,193
3405-000,2014,7,20,8,310,219,529,349
3405-000,2014,7,20,9,374,278,652,529
3405-000,2014,7,20,10,392,297,689,652
3405-000,2014,7,20,11,482,351,833,689
3405-000,2014,7,20,12,437,382,819,833
3405-000,2014,7,20,13,423,378,801,819
3405-000,2014,7,20,14,422,453,875,801
3405-000,2014,7,20,15,410,509,919,875
3405-000,2014,7,20,16,452,574,1026,919
3405-000,2014,7,20,17,475,575,1050,1026
3405-000,2014,7,20,18,508,587,1095,1050
3405-000,2014,7,20,19,450,523,973,1095
3405-000,2014,7,20,20,356,464,820,973
3405-000,2014,7,20,21,329,435,764,820
3405-000,2014,7,20,22,265,350,615,764
3405-000,2014,7,20,23,198,262,460,615
3405-000,2014,7,20,24,100,154,254,460
3405-000,2014,7,21,1,57,110,167,254
3405-000,2014,7,21,2,38,77,115,167
3405-000,2014,7,21,3,29,51,80,115
3405-000,2014,7,21,4,49,77,126,80
3405-000,2014,7,21,5,77,83,160,126
3405-000,2014,7,21,6,233,244,477,160
3405-000,2014,7,21,7,535,573,1108,477
3405-000,2014,7,21,8,953,1328,2281,1108
3405-000,2014,7,21,9,1004,1105,2109,2281
3405-000,2014,7,21,10,853,799,1652,2109
3405-000,2014,7,21,11,764,814,1578,1652
3405-000,2014,7,21,12,816,816,1632,1578
3405-000,2014,7,21,13,681,654,1335,1632
3405-000,2014,7,21,14,746,849,1595,1335
3405-000,2014,7,21,15,852,952,1804,1595
3405-000,2014,7,21,16,886,890,1776,1804
3405-000,2014,7,21,17,926,747,1673,1776
3405-000,2014,7,21,18,928,825,1753,1673
3405-000,2014,7,21,19,897,888,1785,1753
3405-000,2014,7,21,20,597,596,1193,1785
3405-000,2014,7,21,21,511,483,994,1193
3405-000,2014,7,21,22,367,398,765,994
3405-000,2014,7,21,23,219,221,440,765
3405-000,2014,7,21,24,134,148,282,440
3405-000,2014,7,22,1,81,76,157,282
3405-000,2014,7,22,2,55,71,126,157
3405-000,2014,7,22,3,37,74,111,126
3405-000,2014,7,22,4,36,86,122,111
3405-000,2014,7,22,5,84,98,182,122
3405-000,2014,7,22,6,217,194,411,182
3405-000,2014,7,22,7,439,408,847,411
3405-000,2014,7,22,8,898,1063,1961,847
3405-000,2014,7,22,9,1116,1063,2179,1961
3405-000,2014,7,22,10,968,815,1783,2179
3405-000,2014,7,22,11,952,818,1770,1783
3405-000,2014,7,22,12,905,830,1735,1770
3405-000,2014,7,22,13,722,728,1450,1735
3405-000,2014,7,22,14,816,757,1573,1450
3405-000,2014,7,22,15,917,926,1843,1573
3405-000,2014,7,22,16,940,854,1794,1843
3405-000,2014,7,22,17,892,798,1690,1794
3405-000,2014,7,22,18,961,847,1808,1690
3405-000,2014,7,22,19,946,878,1824,1808
3405-000,2014,7,22,20,675,626,1301,1824
3405-000,2014,7,22,21,501,438,939,1301
3405-000,2014,7,22,22,371,349,720,939
3405-000,2014,7,22,23,214,233,447,720
3405-000,2014,7,22,24,133,156,289,447
3405-000,2014,7,23,1,91,106,197,289
3405-000,2014,7,23,2,66,78,144,197
3405-000,2014,7,23,3,50,55,105,144
3405-000,2014,7,23,4,54,59,113,105
3405-000,2014,7,23,5,85,96,181,113
3405-000,2014,7,23,6,191,142,333,181
3405-000,2014,7,23,7,367,330,697,333
3405-000,2014,7,23,8,800,951,1751,697
3405-000,2014,7,23,9,1013,937,1950,1751
3405-000,2014,7,23,10,846,717,1563,1950
3405-000,2014,7,23,11,775,733,1508,1563
3405-000,2014,7,23,12,825,714,1539,1508
3405-000,2014,7,23,13,702,661,1363,1539
3405-000,2014,7,23,14,749,800,1549,1363
3405-000,2014,7,23,15,944,856,1800,1549
3405-000,2014,7,23,16,922,815,1737,1800
3405-000,2014,7,23,17,866,728,1594,1737
3405-000,2014,7,23,18,917,778,1695,1594
3405-000,2014,7,23,19,905,833,1738,1695
3405-000,2014,7,23,20,560,560,1120,1738
3405-000,2014,7,23,21,448,386,834,1120
3405-000,2014,7,23,22,308,312,620,834
3405-000,2014,7,23,23,230,212,442,620
3405-000,2014,7,23,24,143,145,288,442
3405-000,2014,7,24,1,113,85,198,288
3405-000,2014,7,24,2,59,69,128,198
3405-000,2014,7,24,3,57,42,99,128
3405-000,2014,7,24,4,45,78,123,99
3405-000,2014,7,24,5,65,91,156,123
3405-000,2014,7,24,6,174,185,359,156
3405-000,2014,7,24,7,412,342,754,359
3405-000,2014,7,24,8,783,961,1744,754
3405-000,2014,7,24,9,1041,995,2036,1744
3405-000,2014,7,24,10,937,743,1680,2036
3405-000,2014,7,24,11,912,917,1829,1680
3405-000,2014,7,24,12,891,784,1675,1829
3405-000,2014,7,24,13,779,727,1506,1675
3405-000,2014,7,24,14,838,876,1714,1506
3405-000,2014,7,24,15,903,862,1765,1714
3405-000,2014,7,24,16,950,852,1802,1765
3405-000,2014,7,24,17,888,840,1728,1802
3405-000,2014,7,24,18,968,782,1750,1728
3405-000,2014,7,24,19,905,821,1726,1750
3405-000,2014,7,24,20,614,565,1179,1726
3405-000,2014,7,24,21,530,497,1027,1179
3405-000,2014,7,24,22,356,428,784,1027
3405-000,2014,7,24,23,278,219,497,784
3405-000,2014,7,24,24,143,137,280,497
3405-000,2014,7,25,1,118,106,224,280
3405-000,2014,7,25,2,54,77,131,224
3405-000,2014,7,25,3,38,50,88,131
3405-000,2014,7,25,4,58,74,132,88
3405-000,2014,7,25,5,81,92,173,132
3405-000,2014,7,25,6,181,166,347,173
3405-000,2014,7,25,7,420,343,763,347
3405-000,2014,7,25,8,862,945,1807,763
3405-000,2014,7,25,9,1101,1028,2129,1807
3405-000,2014,7,25,10,909,784,1693,2129
3405-000,2014,7,25,11,976,770,1746,1693
3405-000,2014,7,25,12,810,745,1555,1746
3405-000,2014,7,25,13,820,716,1536,1555
3405-000,2014,7,25,14,813,745,1558,1536
3405-000,2014,7,25,15,957,872,1829,1558
3405-000,2014,7,25,16,952,849,1801,1829
3405-000,2014,7,25,17,922,773,1695,1801
3405-000,2014,7,25,18,1036,861,1897,1695
3405-000,2014,7,25,19,1236,948,2184,1897
3405-000,2014,7,25,20,762,1010,1772,2184
3405-000,2014,7,25,21,652,596,1248,1772
3405-000,2014,7,25,22,446,333,779,1248
3405-000,2014,7,25,23,264,226,490,779
3405-000,2014,7,25,24,170,143,313,490
3405-000,2014,7,26,1,104,97,201,313
3405-000,2014,7,26,2,68,74,142,201
3405-000,2014,7,26,3,56,62,118,142
3405-000,2014,7,26,4,65,75,140,118
3405-000,2014,7,26,5,74,78,152,140
3405-000,2014,7,26,6,157,140,297,152
3405-000,2014,7,26,7,329,290,619,297
3405-000,2014,7,26,8,590,487,1077,619
3405-000,2014,7,26,9,752,505,1257,1077
3405-000,2014,7,26,10,758,518,1276,1257
3405-000,2014,7,26,11,811,617,1428,1276
3405-000,2014,7,26,12,730,560,1290,1428
3405-000,2014,7,26,13,698,557,1255,1290
3405-000,2014,7,26,14,627,543,1170,1255
3405-000,2014,7,26,15,709,574,1283,1170
3405-000,2014,7,26,16,654,613,1267,1283
3405-000,2014,7,26,17,717,551,1268,1267
3405-000,2014,7,26,18,795,616,1411,1268
3405-000,2014,7,26,19,565,527,1092,1411
3405-000,2014,7,26,20,415,361,776,1092
3405-000,2014,7,26,21,344,327,671,776
3405-000,2014,7,26,22,267,244,511,671
3405-000,2014,7,26,23,196,201,397,511
3405-000,2014,7,26,24,105,143,248,397
3405-000,2014,7,27,1,83,76,159,248
3405-000,2014,7,27,2,48,49,97,159
3405-000,2014,7,27,3,37,40,77,97
3405-000,2014,7,27,4,31,37,68,77
3405-000,2014,7,27,5,38,35,73,68
3405-000,2014,7,27,6,103,66,169,73
3405-000,2014,7,27,7,227,136,363,169
3405-000,2014,7,27,8,304,243,547,363
3405-000,2014,7,27,9,365,293,658,547
3405-000,2014,7,27,10,423,309,732,658
3405-000,2014,7,27,11,434,357,791,732
3405-000,2014,7,27,12,461,398,859,791
3405-000,2014,7,27,13,399,354,753,859
3405-000,2014,7,27,14,394,403,797,753
3405-000,2014,7,27,15,460,512,972,797
3405-000,2014,7,27,16,424,550,974,972
3405-000,2014,7,27,17,448,517,965,974
3405-000,2014,7,27,18,471,572,1043,965
3405-000,2014,7,27,19,435,499,934,1043
3405-000,2014,7,27,20,377,468,845,934
3405-000,2014,7,27,21,324,407,731,845
3405-000,2014,7,27,22,258,363,621,731
3405-000,2014,7,27,23,167,269,436,621
3405-000,2014,7,27,24,122,196,318,436
3405-000,2014,7,28,1,65,104,169,318
3405-000,2014,7,28,2,26,61,87,169
3405-000,2014,7,28,3,32,60,92,87
3405-000,2014,7,28,4,41,66,107,92
3405-000,2014,7,28,5,83,83,166,107
3405-000,2014,7,28,6,213,253,466,166
3405-000,2014,7,28,7,514,558,1072,466
3405-000,2014,7,28,8,900,1303,2203,1072
3405-000,2014,7,28,9,1002,1040,2042,2203
3405-000,2014,7,28,10,910,764,1674,2042
3405-000,2014,7,28,11,942,834,1776,1674
3405-000,2014,7,28,12,890,767,1657,1776
3405-000,2014,7,28,13,677,699,1376,1657
3405-000,2014,7,28,14,823,793,1616,1376
3405-000,2014,7,28,15,941,867,1808,1616
3405-000,2014,7,28,16,885,792,1677,1808
3405-000,2014,7,28,17,837,833,1670,1677
3405-000,2014,7,28,18,936,811,1747,1670
3405-000,2014,7,28,19,857,872,1729,1747
3405-000,2014,7,28,20,616,586,1202,1729
3405-000,2014,7,28,21,516,475,991,1202
3405-000,2014,7,28,22,384,335,719,991
3405-000,2014,7,28,23,219,214,433,719
3405-000,2014,7,28,24,136,164,300,433
3405-000,2014,7,29,1,67,104,171,300
3405-000,2014,7,29,2,54,75,129,171
3405-000,2014,7,29,3,34,73,107,129
3405-000,2014,7,29,4,42,86,128,107
3405-000,2014,7,29,5,78,83,161,128
3405-000,2014,7,29,6,212,187,399,161
3405-000,2014,7,29,7,392,440,832,399
3405-000,2014,7,29,8,827,965,1792,832
3405-000,2014,7,29,9,1012,963,1975,1792
3405-000,2014,7,29,10,932,855,1787,1975
3405-000,2014,7,29,11,950,848,1798,1787
3405-000,2014,7,29,12,940,796,1736,1798
3405-000,2014,7,29,13,797,653,1450,1736
3405-000,2014,7,29,14,810,805,1615,1450
3405-000,2014,7,29,15,941,870,1811,1615
3405-000,2014,7,29,16,924,832,1756,1811
3405-000,2014,7,29,17,901,776,1677,1756
3405-000,2014,7,29,18,973,825,1798,1677
3405-000,2014,7,29,19,960,839,1799,1798
3405-000,2014,7,29,20,648,601,1249,1799
3405-000,2014,7,29,21,522,507,1029,1249
3405-000,2014,7,29,22,418,350,768,1029
3405-000,2014,7,29,23,238,218,456,768
3405-000,2014,7,29,24,141,155,296,456
3405-000,2014,7,30,1,81,114,195,296
3405-000,2014,7,30,2,74,67,141,195
3405-000,2014,7,30,3,41,51,92,141
3405-000,2014,7,30,4,65,82,147,92
3405-000,2014,7,30,5,100,90,190,147
3405-000,2014,7,30,6,219,186,405,190
3405-000,2014,7,30,7,454,426,880,405
3405-000,2014,7,30,8,816,856,1672,880
3405-000,2014,7,30,9,988,918,1906,1672
3405-000,2014,7,30,10,884,801,1685,1906
3405-000,2014,7,30,11,956,811,1767,1685
3405-000,2014,7,30,12,871,800,1671,1767
3405-000,2014,7,30,13,721,708,1429,1671
3405-000,2014,7,30,14,786,750,1536,1429
3405-000,2014,7,30,15,937,873,1810,1536
3405-000,2014,7,30,16,940,785,1725,1810
3405-000,2014,7,30,17,904,765,1669,1725
3405-000,2014,7,30,18,949,859,1808,1669
3405-000,2014,7,30,19,929,894,1823,1808
3405-000,2014,7,30,20,587,567,1154,1823
3405-000,2014,7,30,21,527,468,995,1154
3405-000,2014,7,30,22,361,339,700,995
3405-000,2014,7,30,23,259,204,463,700
3405-000,2014,7,30,24,184,167,351,463
3405-000,2014,7,31,1,96,112,208,351
3405-000,2014,7,31,2,57,67,124,208
3405-000,2014,7,31,3,58,63,121,124
3405-000,2014,7,31,4,47,83,130,121
3405-000,2014,7,31,5,97,89,186,130
3405-000,2014,7,31,6,211,164,375,186
3405-000,2014,7,31,7,469,415,884,375
3405-000,2014,7,31,8,868,892,1760,884
3405-000,2014,7,31,9,995,926,1921,1760
3405-000,2014,7,31,10,892,742,1634,1921
3405-000,2014,7,31,11,968,717,1685,1634
3405-000,2014,7,31,12,863,757,1620,1685
3405-000,2014,7,31,13,759,705,1464,1620
3405-000,2014,7,31,14,767,731,1498,1464
3405-000,2014,7,31,15,821,842,1663,1498
3405-000,2014,7,31,16,857,834,1691,1663
3405-000,2014,7,31,17,862,744,1606,1691
3405-000,2014,7,31,18,882,762,1644,1606
3405-000,2014,7,31,19,911,807,1718,1644
3405-000,2014,7,31,20,664,568,1232,1718
3405-000,2014,7,31,21,487,460,947,1232
3405-000,2014,7,31,22,354,362,716,947
3405-000,2014,7,31,23,251,235,486,716
3405-000,2014,7,31,24,165,141,306,486
3405-000,2014,8,1,1,98,111,209,306
3405-000,2014,8,1,2,60,86,146,209
3405-000,2014,8,1,3,47,65,112,146
3405-000,2014,8,1,4,65,61,126,112
3405-000,2014,8,1,5,93,94,187,126
3405-000,2014,8,1,6,226,179,405,187
3405-000,2014,8,1,7,452,394,846,405
3405-000,2014,8,1,8,809,886,1695,846
3405-000,2014,8,1,9,960,812,1772,1695
3405-000,2014,8,1,10,870,739,1609,1772
3405-000,2014,8,1,11,886,722,1608,1609
3405-000,2014,8,1,12,897,739,1636,1608
3405-000,2014,8,1,13,772,660,1432,1636
3405-000,2014,8,1,14,744,792,1536,1432
3405-000,2014,8,1,15,850,880,1730,1536
3405-000,2014,8,1,16,883,822,1705,1730
3405-000,2014,8,1,17,853,729,1582,1705
3405-000,2014,8,1,18,1051,815,1866,1582
3405-000,2014,8,1,19,1149,838,1987,1866
3405-000,2014,8,1,20,801,619,1420,1987
3405-000,2014,8,1,21,575,479,1054,1420
3405-000,2014,8,1,22,401,339,740,1054
3405-000,2014,8,1,23,284,234,518,740
3405-000,2014,8,1,24,174,177,351,518
3405-000,2014,8,2,1,106,104,210,351
3405-000,2014,8,2,2,63,78,141,210
3405-000,2014,8,2,3,55,60,115,141
3405-000,2014,8,2,4,60,74,134,115
3405-000,2014,8,2,5,107,67,174,134
3405-000,2014,8,2,6,211,114,325,174
3405-000,2014,8,2,7,371,275,646,325
3405-000,2014,8,2,8,584,444,1028,646
3405-000,2014,8,2,9,682,474,1156,1028
3405-000,2014,8,2,10,704,499,1203,1156
3405-000,2014,8,2,11,775,543,1318,1203
3405-000,2014,8,2,12,776,648,1424,1318
3405-000,2014,8,2,13,651,568,1219,1424
3405-000,2014,8,2,14,651,552,1203,1219
3405-000,2014,8,2,15,617,509,1126,1203
3405-000,2014,8,2,16,634,579,1213,1126
3405-000,2014,8,2,17,664,567,1231,1213
3405-000,2014,8,2,18,700,679,1379,1231
3405-000,2014,8,2,19,548,562,1110,1379
3405-000,2014,8,2,20,408,405,813,1110
3405-000,2014,8,2,21,360,319,679,813
3405-000,2014,8,2,22,282,292,574,679
3405-000,2014,8,2,23,167,197,364,574
3405-000,2014,8,2,24,107,145,252,364
3405-000,2014,8,3,1,68,83,151,252
3405-000,2014,8,3,2,47,54,101,151
3405-000,2014,8,3,3,32,22,54,101
3405-000,2014,8,3,4,28,29,57,54
3405-000,2014,8,3,5,31,34,65,57
3405-000,2014,8,3,6,66,57,123,65
3405-000,2014,8,3,7,143,120,263,123
3405-000,2014,8,3,8,259,176,435,263
3405-000,2014,8,3,9,341,208,549,435
3405-000,2014,8,3,10,369,239,608,549
3405-000,2014,8,3,11,427,334,761,608
3405-000,2014,8,3,12,409,365,774,761
3405-000,2014,8,3,13,430,445,875,774
3405-000,2014,8,3,14,411,428,839,875
3405-000,2014,8,3,15,449,470,919,839
3405-000,2014,8,3,16,514,494,1008,919
3405-000,2014,8,3,17,437,463,900,1008
3405-000,2014,8,3,18,433,533,966,900
3405-000,2014,8,3,19,346,763,1109,966
3405-000,2014,8,3,20,308,524,832,1109
3405-000,2014,8,3,21,290,391,681,832
3405-000,2014,8,3,22,220,350,570,681
3405-000,2014,8,3,23,152,224,376,570
3405-000,2014,8,3,24,91,196,287,376
3405-000,2014,8,4,1,62,99,161,287
3405-000,2014,8,4,2,39,47,86,161
3405-000,2014,8,4,3,25,40,65,86
3405-000,2014,8,4,4,31,50,81,65
3405-000,2014,8,4,5,57,67,124,81
3405-000,2014,8,4,6,144,185,329,124
3405-000,2014,8,4,7,352,365,717,329
3405-000,2014,8,4,8,688,903,1591,717
3405-000,2014,8,4,9,843,807,1650,1591
3405-000,2014,8,4,10,734,605,1339,1650
3405-000,2014,8,4,11,743,674,1417,1339
3405-000,2014,8,4,12,747,655,1402,1417
3405-000,2014,8,4,13,643,601,1244,1402
3405-000,2014,8,4,14,649,693,1342,1244
3405-000,2014,8,4,15,722,673,1395,1342
3405-000,2014,8,4,16,712,671,1383,1395
3405-000,2014,8,4,17,668,640,1308,1383
3405-000,2014,8,4,18,720,696,1416,1308
3405-000,2014,8,4,19,680,688,1368,1416
3405-000,2014,8,4,20,502,476,978,1368
3405-000,2014,8,4,21,392,366,758,978
3405-000,2014,8,4,22,252,278,530,758
3405-000,2014,8,4,23,172,172,344,530
3405-000,2014,8,4,24,127,135,262,344
3405-000,2014,8,5,1,75,92,167,262
3405-000,2014,8,5,2,53,58,111,167
3405-000,2014,8,5,3,31,54,85,111
3405-000,2014,8,5,4,40,59,99,85
3405-000,2014,8,5,5,62,74,136,99
3405-000,2014,8,5,6,145,176,321,136
3405-000,2014,8,5,7,338,307,645,321
3405-000,2014,8,5,8,743,745,1488,645
3405-000,2014,8,5,9,874,799,1673,1488
3405-000,2014,8,5,10,769,622,1391,1673
3405-000,2014,8,5,11,808,714,1522,1391
3405-000,2014,8,5,12,725,617,1342,1522
3405-000,2014,8,5,13,667,610,1277,1342
3405-000,2014,8,5,14,711,698,1409,1277
3405-000,2014,8,5,15,714,767,1481,1409
3405-000,2014,8,5,16,813,681,1494,1481
3405-000,2014,8,5,17,764,702,1466,1494
3405-000,2014,8,5,18,816,775,1591,1466
3405-000,2014,8,5,19,798,767,1565,1591
3405-000,2014,8,5,20,526,534,1060,1565
3405-000,2014,8,5,21,394,408,802,1060
3405-000,2014,8,5,22,334,345,679,802
3405-000,2014,8,5,23,184,246,430,679
3405-000,2014,8,5,24,115,166,281,430
3405-000,2014,8,6,1,87,93,180,281
3405-000,2014,8,6,2,50,67,117,180
3405-000,2014,8,6,3,33,53,86,117
3405-000,2014,8,6,4,49,70,119,86
3405-000,2014,8,6,5,67,88,155,119
3405-000,2014,8,6,6,162,175,337,155
3405-000,2014,8,6,7,366,332,698,337
3405-000,2014,8,6,8,741,756,1497,698
3405-000,2014,8,6,9,926,825,1751,1497
3405-000,2014,8,6,10,861,668,1529,1751
3405-000,2014,8,6,11,815,640,1455,1529
3405-000,2014,8,6,12,784,699,1483,1455
3405-000,2014,8,6,13,637,603,1240,1483
3405-000,2014,8,6,14,713,670,1383,1240
3405-000,2014,8,6,15,797,747,1544,1383
3405-000,2014,8,6,16,830,783,1613,1544
3405-000,2014,8,6,17,810,720,1530,1613
3405-000,2014,8,6,18,796,837,1633,1530
3405-000,2014,8,6,19,781,797,1578,1633
3405-000,2014,8,6,20,494,496,990,1578
3405-000,2014,8,6,21,349,381,730,990
3405-000,2014,8,6,22,264,257,521,730
3405-000,2014,8,6,23,187,196,383,521
3405-000,2014,8,6,24,116,120,236,383
3405-000,2014,8,7,1,56,82,138,236
3405-000,2014,8,7,2,44,52,96,138
3405-000,2014,8,7,3,30,49,79,96
3405-000,2014,8,7,4,37,76,113,79
3405-000,2014,8,7,5,67,78,145,113
3405-000,2014,8,7,6,178,139,317,145
3405-000,2014,8,7,7,307,299,606,317
3405-000,2014,8,7,8,749,783,1532,606
3405-000,2014,8,7,9,914,837,1751,1532
3405-000,2014,8,7,10,830,719,1549,1751
3405-000,2014,8,7,11,880,727,1607,1549
3405-000,2014,8,7,12,771,720,1491,1607
3405-000,2014,8,7,13,725,656,1381,1491
3405-000,2014,8,7,14,710,717,1427,1381
3405-000,2014,8,7,15,809,793,1602,1427
3405-000,2014,8,7,16,816,752,1568,1602
3405-000,2014,8,7,17,761,756,1517,1568
3405-000,2014,8,7,18,806,769,1575,1517
3405-000,2014,8,7,19,794,763,1557,1575
3405-000,2014,8,7,20,525,510,1035,1557
3405-000,2014,8,7,21,390,440,830,1035
3405-000,2014,8,7,22,285,338,623,830
3405-000,2014,8,7,23,208,182,390,623
3405-000,2014,8,7,24,108,129,237,390
3405-000,2014,8,8,1,90,100,190,237
3405-000,2014,8,8,2,49,73,122,190
3405-000,2014,8,8,3,38,41,79,122
3405-000,2014,8,8,4,41,82,123,79
3405-000,2014,8,8,5,64,71,135,123
3405-000,2014,8,8,6,177,141,318,135
3405-000,2014,8,8,7,367,350,717,318
3405-000,2014,8,8,8,808,818,1626,717
3405-000,2014,8,8,9,970,914,1884,1626
3405-000,2014,8,8,10,810,702,1512,1884
3405-000,2014,8,8,11,853,753,1606,1512
3405-000,2014,8,8,12,813,734,1547,1606
3405-000,2014,8,8,13,674,643,1317,1547
3405-000,2014,8,8,14,749,729,1478,1317
3405-000,2014,8,8,15,881,817,1698,1478
3405-000,2014,8,8,16,889,791,1680,1698
3405-000,2014,8,8,17,904,880,1784,1680
3405-000,2014,8,8,18,953,863,1816,1784
3405-000,2014,8,8,19,1035,907,1942,1816
3405-000,2014,8,8,20,673,667,1340,1942
3405-000,2014,8,8,21,521,460,981,1340
3405-000,2014,8,8,22,350,354,704,981
3405-000,2014,8,8,23,230,219,449,704
3405-000,2014,8,8,24,152,135,287,449
3405-000,2014,8,9,1,108,92,200,287
3405-000,2014,8,9,2,58,91,149,200
3405-000,2014,8,9,3,44,57,101,149
3405-000,2014,8,9,4,50,61,111,101
3405-000,2014,8,9,5,87,86,173,111
3405-000,2014,8,9,6,191,145,336,173
3405-000,2014,8,9,7,332,295,627,336
3405-000,2014,8,9,8,633,443,1076,627
3405-000,2014,8,9,9,712,525,1237,1076
3405-000,2014,8,9,10,735,534,1269,1237
3405-000,2014,8,9,11,742,597,1339,1269
3405-000,2014,8,9,12,688,692,1380,1339
3405-000,2014,8,9,13,627,685,1312,1380
3405-000,2014,8,9,14,650,648,1298,1312
3405-000,2014,8,9,15,678,608,1286,1298
3405-000,2014,8,9,16,633,601,1234,1286
3405-000,2014,8,9,17,579,584,1163,1234
3405-000,2014,8,9,18,717,714,1431,1163
3405-000,2014,8,9,19,629,652,1281,1431
3405-000,2014,8,9,20,394,478,872,1281
3405-000,2014,8,9,21,306,336,642,872
3405-000,2014,8,9,22,246,246,492,642
3405-000,2014,8,9,23,221,174,395,492
3405-000,2014,8,9,24,109,145,254,395
3405-000,2014,8,10,1,67,61,128,254
3405-000,2014,8,10,2,56,51,107,128
3405-000,2014,8,10,3,29,40,69,107
3405-000,2014,8,10,4,27,36,63,69
3405-000,2014,8,10,5,51,44,95,63
3405-000,2014,8,10,6,103,74,177,95
3405-000,2014,8,10,7,222,151,373,177
3405-000,2014,8,10,8,294,211,505,373
3405-000,2014,8,10,9,398,280,678,505
3405-000,2014,8,10,10,390,292,682,678
3405-000,2014,8,10,11,505,349,854,682
3405-000,2014,8,10,12,460,354,814,854
3405-000,2014,8,10,13,408,411,819,814
3405-000,2014,8,10,14,483,449,932,819
3405-000,2014,8,10,15,460,509,969,932
3405-000,2014,8,10,16,519,549,1068,969
3405-000,2014,8,10,17,486,626,1112,1068
3405-000,2014,8,10,18,459,598,1057,1112
3405-000,2014,8,10,19,441,543,984,1057
3405-000,2014,8,10,20,340,454,794,984
3405-000,2014,8,10,21,289,428,717,794
3405-000,2014,8,10,22,211,310,521,717
3405-000,2014,8,10,23,141,236,377,521
3405-000,2014,8,10,24,109,144,253,377
3405-000,2014,8,11,1,51,92,143,253
3405-000,2014,8,11,2,38,49,87,143
3405-000,2014,8,11,3,20,65,85,87
3405-000,2014,8,11,4,39,60,99,85
3405-000,2014,8,11,5,61,92,153,99
3405-000,2014,8,11,6,162,224,386,153
3405-000,2014,8,11,7,464,542,1006,386
3405-000,2014,8,11,8,876,1240,2116,1006
3405-000,2014,8,11,9,1027,1068,2095,2116
3405-000,2014,8,11,10,974,806,1780,2095
3405-000,2014,8,11,11,961,821,1782,1780
3405-000,2014,8,11,12,878,807,1685,1782
3405-000,2014,8,11,13,751,724,1475,1685
3405-000,2014,8,11,14,801,833,1634,1475
3405-000,2014,8,11,15,993,941,1934,1634
3405-000,2014,8,11,16,986,950,1936,1934
3405-000,2014,8,11,17,912,852,1764,1936
3405-000,2014,8,11,18,892,838,1730,1764
3405-000,2014,8,11,19,864,871,1735,1730
3405-000,2014,8,11,20,666,625,1291,1735
3405-000,2014,8,11,21,535,516,1051,1291
3405-000,2014,8,11,22,339,377,716,1051
3405-000,2014,8,11,23,223,205,428,716
3405-000,2014,8,11,24,137,141,278,428
3405-000,2014,8,12,1,90,97,187,278
3405-000,2014,8,12,2,58,85,143,187
3405-000,2014,8,12,3,37,50,87,143
3405-000,2014,8,12,4,65,94,159,87
3405-000,2014,8,12,5,70,92,162,159
3405-000,2014,8,12,6,182,209,391,162
3405-000,2014,8,12,7,415,400,815,391
3405-000,2014,8,12,8,867,1044,1911,815
3405-000,2014,8,12,9,1101,1046,2147,1911
3405-000,2014,8,12,10,992,856,1848,2147
3405-000,2014,8,12,11,923,855,1778,1848
3405-000,2014,8,12,12,908,887,1795,1778
3405-000,2014,8,12,13,721,781,1502,1795
3405-000,2014,8,12,14,801,856,1657,1502
3405-000,2014,8,12,15,936,896,1832,1657
3405-000,2014,8,12,16,937,871,1808,1832
3405-000,2014,8,12,17,964,778,1742,1808
3405-000,2014,8,12,18,919,797,1716,1742
3405-000,2014,8,12,19,938,896,1834,1716
3405-000,2014,8,12,20,638,664,1302,1834
3405-000,2014,8,12,21,508,499,1007,1302
3405-000,2014,8,12,22,416,374,790,1007
3405-000,2014,8,12,23,239,220,459,790
3405-000,2014,8,12,24,135,166,301,459
3405-000,2014,8,13,1,96,110,206,301
3405-000,2014,8,13,2,65,84,149,206
3405-000,2014,8,13,3,51,69,120,149
3405-000,2014,8,13,4,51,74,125,120
3405-000,2014,8,13,5,84,87,171,125
3405-000,2014,8,13,6,195,196,391,171
3405-000,2014,8,13,7,432,416,848,391
3405-000,2014,8,13,8,825,1024,1849,848
3405-000,2014,8,13,9,985,1079,2064,1849
3405-000,2014,8,13,10,967,796,1763,2064
3405-000,2014,8,13,11,990,884,1874,1763
3405-000,2014,8,13,12,879,938,1817,1874
3405-000,2014,8,13,13,700,874,1574,1817
3405-000,2014,8,13,14,793,828,1621,1574
3405-000,2014,8,13,15,970,915,1885,1621
3405-000,2014,8,13,16,912,897,1809,1885
3405-000,2014,8,13,17,939,889,1828,1809
3405-000,2014,8,13,18,931,948,1879,1828
3405-000,2014,8,13,19,943,898,1841,1879
3405-000,2014,8,13,20,637,585,1222,1841
3405-000,2014,8,13,21,466,472,938,1222
3405-000,2014,8,13,22,350,338,688,938
3405-000,2014,8,13,23,245,232,477,688
3405-000,2014,8,13,24,160,165,325,477
3405-000,2014,8,14,1,98,97,195,325
3405-000,2014,8,14,2,75,67,142,195
3405-000,2014,8,14,3,42,70,112,142
3405-000,2014,8,14,4,45,94,139,112
3405-000,2014,8,14,5,95,89,184,139
3405-000,2014,8,14,6,176,172,348,184
3405-000,2014,8,14,7,400,399,799,348
3405-000,2014,8,14,8,861,985,1846,799
3405-000,2014,8,14,9,1076,989,2065,1846
3405-000,2014,8,14,10,883,869,1752,2065
3405-000,2014,8,14,11,968,865,1833,1752
3405-000,2014,8,14,12,944,836,1780,1833
3405-000,2014,8,14,13,766,738,1504,1780
3405-000,2014,8,14,14,853,799,1652,1504
3405-000,2014,8,14,15,1025,895,1920,1652
3405-000,2014,8,14,16,916,863,1779,1920
3405-000,2014,8,14,17,928,844,1772,1779
3405-000,2014,8,14,18,1050,855,1905,1772
3405-000,2014,8,14,19,1210,971,2181,1905
3405-000,2014,8,14,20,770,705,1475,2181
3405-000,2014,8,14,21,577,598,1175,1475
3405-000,2014,8,14,22,401,407,808,1175
3405-000,2014,8,14,23,299,244,543,808
3405-000,2014,8,14,24,162,137,299,543
3405-000,2014,8,15,1,97,115,212,299
3405-000,2014,8,15,2,84,81,165,212
3405-000,2014,8,15,3,55,60,115,165
3405-000,2014,8,15,4,71,77,148,115
3405-000,2014,8,15,5,84,96,180,148
3405-000,2014,8,15,6,192,133,325,180
3405-000,2014,8,15,7,388,302,690,325
3405-000,2014,8,15,8,721,495,1216,690
3405-000,2014,8,15,9,775,603,1378,1216
3405-000,2014,8,15,10,778,609,1387,1378
3405-000,2014,8,15,11,855,644,1499,1387
3405-000,2014,8,15,12,967,698,1665,1499
3405-000,2014,8,15,13,849,643,1492,1665
3405-000,2014,8,15,14,744,726,1470,1492
3405-000,2014,8,15,15,894,807,1701,1470
3405-000,2014,8,15,16,775,791,1566,1701
3405-000,2014,8,15,17,685,723,1408,1566
3405-000,2014,8,15,18,729,683,1412,1408
3405-000,2014,8,15,19,644,622,1266,1412
3405-000,2014,8,15,20,474,466,940,1266
3405-000,2014,8,15,21,407,372,779,940
3405-000,2014,8,15,22,284,289,573,779
3405-000,2014,8,15,23,221,196,417,573
3405-000,2014,8,15,24,103,170,273,417
3405-000,2014,8,16,1,93,121,214,273
3405-000,2014,8,16,2,76,72,148,214
3405-000,2014,8,16,3,46,66,112,148
3405-000,2014,8,16,4,72,72,144,112
3405-000,2014,8,16,5,85,93,178,144
3405-000,2014,8,16,6,171,144,315,178
3405-000,2014,8,16,7,341,324,665,315
3405-000,2014,8,16,8,556,428,984,665
3405-000,2014,8,16,9,673,473,1146,984
3405-000,2014,8,16,10,643,490,1133,1146
3405-000,2014,8,16,11,677,603,1280,1133
3405-000,2014,8,16,12,699,567,1266,1280
3405-000,2014,8,16,13,613,594,1207,1266
3405-000,2014,8,16,14,630,572,1202,1207
3405-000,2014,8,16,15,657,707,1364,1202
3405-000,2014,8,16,16,702,597,1299,1364
3405-000,2014,8,16,17,793,672,1465,1299
3405-000,2014,8,16,18,868,725,1593,1465
3405-000,2014,8,16,19,684,722,1406,1593
3405-000,2014,8,16,20,434,580,1014,1406
3405-000,2014,8,16,21,386,487,873,1014
3405-000,2014,8,16,22,304,393,697,873
3405-000,2014,8,16,23,201,252,453,697
3405-000,2014,8,16,24,132,167,299,453
3405-000,2014,8,17,1,93,96,189,299
3405-000,2014,8,17,2,45,59,104,189
3405-000,2014,8,17,3,32,47,79,104
3405-000,2014,8,17,4,37,33,70,79
3405-000,2014,8,17,5,62,38,100,70
3405-000,2014,8,17,6,106,77,183,100
3405-000,2014,8,17,7,192,148,340,183
3405-000,2014,8,17,8,290,227,517,340
3405-000,2014,8,17,9,357,288,645,517
3405-000,2014,8,17,10,380,288,668,645
3405-000,2014,8,17,11,422,357,779,668
3405-000,2014,8,17,12,445,452,897,779
3405-000,2014,8,17,13,415,493,908,897
3405-000,2014,8,17,14,413,463,876,908
3405-000,2014,8,17,15,484,542,1026,876
3405-000,2014,8,17,16,520,584,1104,1026
3405-000,2014,8,17,17,517,533,1050,1104
3405-000,2014,8,17,18,432,583,1015,1050
3405-000,2014,8,17,19,413,534,947,1015
3405-000,2014,8,17,20,340,449,789,947
3405-000,2014,8,17,21,306,382,688,789
3405-000,2014,8,17,22,204,281,485,688
3405-000,2014,8,17,23,156,208,364,485
3405-000,2014,8,17,24,90,160,250,364
3405-000,2014,8,18,1,51,99,150,250
3405-000,2014,8,18,2,42,62,104,150
3405-000,2014,8,18,3,32,54,86,104
3405-000,2014,8,18,4,42,62,104,86
3405-000,2014,8,18,5,77,88,165,104
3405-000,2014,8,18,6,166,168,334,165
3405-000,2014,8,18,7,413,485,898,334
3405-000,2014,8,18,8,842,1184,2026,898
3405-000,2014,8,18,9,1014,1115,2129,2026
3405-000,2014,8,18,10,840,745,1585,2129
3405-000,2014,8,18,11,901,842,1743,1585
3405-000,2014,8,18,12,857,795,1652,1743
3405-000,2014,8,18,13,679,725,1404,1652
3405-000,2014,8,18,14,794,811,1605,1404
3405-000,2014,8,18,15,966,874,1840,1605
3405-000,2014,8,18,16,902,862,1764,1840
3405-000,2014,8,18,17,820,851,1671,1764
3405-000,2014,8,18,18,836,767,1603,1671
3405-000,2014,8,18,19,848,835,1683,1603
3405-000,2014,8,18,20,628,555,1183,1683
3405-000,2014,8,18,21,429,490,919,1183
3405-000,2014,8,18,22,341,352,693,919
3405-000,2014,8,18,23,243,211,454,693
3405-000,2014,8,18,24,120,125,245,454
3405-000,2014,8,19,1,81,86,167,245
3405-000,2014,8,19,2,53,49,102,167
3405-000,2014,8,19,3,45,64,109,102
3405-000,2014,8,19,4,53,92,145,109
3405-000,2014,8,19,5,71,95,166,145
3405-000,2014,8,19,6,150,177,327,166
3405-000,2014,8,19,7,357,355,712,327
3405-000,2014,8,19,8,819,922,1741,712
3405-000,2014,8,19,9,1058,1030,2088,1741
3405-000,2014,8,19,10,892,790,1682,2088
3405-000,2014,8,19,11,967,896,1863,1682
3405-000,2014,8,19,12,971,803,1774,1863
3405-000,2014,8,19,13,795,740,1535,1774
3405-000,2014,8,19,14,827,821,1648,1535
3405-000,2014,8,19,15,882,895,1777,1648
3405-000,2014,8,19,16,924,883,1807,1777
3405-000,2014,8,19,17,950,839,1789,1807
3405-000,2014,8,19,18,912,774,1686,1789
3405-000,2014,8,19,19,892,884,1776,1686
3405-000,2014,8,19,20,592,598,1190,1776
3405-000,2014,8,19,21,499,513,1012,1190
3405-000,2014,8,19,22,338,341,679,1012
3405-000,2014,8,19,23,223,232,455,679
3405-000,2014,8,19,24,159,150,309,455
3405-000,2014,8,20,1,77,116,193,309
3405-000,2014,8,20,2,61,75,136,193
3405-000,2014,8,20,3,50,65,115,136
3405-000,2014,8,20,4,51,76,127,115
3405-000,2014,8,20,5,80,95,175,127
3405-000,2014,8,20,6,181,175,356,175
3405-000,2014,8,20,7,421,363,784,356
3405-000,2014,8,20,8,828,1007,1835,784
3405-000,2014,8,20,9,1129,1130,2259,1835
3405-000,2014,8,20,10,935,863,1798,2259
3405-000,2014,8,20,11,951,830,1781,1798
3405-000,2014,8,20,12,992,819,1811,1781
3405-000,2014,8,20,13,781,712,1493,1811
3405-000,2014,8,20,14,825,840,1665,1493
3405-000,2014,8,20,15,885,920,1805,1665
3405-000,2014,8,20,16,1009,829,1838,1805
3405-000,2014,8,20,17,885,822,1707,1838
3405-000,2014,8,20,18,936,927,1863,1707
3405-000,2014,8,20,19,1070,953,2023,1863
3405-000,2014,8,20,20,611,604,1215,2023
3405-000,2014,8,20,21,467,457,924,1215
3405-000,2014,8,20,22,370,324,694,924
3405-000,2014,8,20,23,191,203,394,694
3405-000,2014,8,20,24,178,144,322,394
3405-000,2014,8,21,1,75,88,163,322
3405-000,2014,8,21,2,62,71,133,163
3405-000,2014,8,21,3,46,53,99,133
3405-000,2014,8,21,4,49,80,129,99
3405-000,2014,8,21,5,82,80,162,129
3405-000,2014,8,21,6,148,145,293,162
3405-000,2014,8,21,7,354,317,671,293
3405-000,2014,8,21,8,795,891,1686,671
3405-000,2014,8,21,9,1071,1025,2096,1686
3405-000,2014,8,21,10,844,824,1668,2096
3405-000,2014,8,21,11,847,698,1545,1668
3405-000,2014,8,21,12,847,757,1604,1545
3405-000,2014,8,21,13,695,628,1323,1604
3405-000,2014,8,21,14,759,697,1456,1323
3405-000,2014,8,21,15,926,860,1786,1456
3405-000,2014,8,21,16,940,884,1824,1786
3405-000,2014,8,21,17,869,739,1608,1824
3405-000,2014,8,21,18,929,779,1708,1608
3405-000,2014,8,21,19,887,834,1721,1708
3405-000,2014,8,21,20,592,536,1128,1721
3405-000,2014,8,21,21,485,459,944,1128
3405-000,2014,8,21,22,356,364,720,944
3405-000,2014,8,21,23,219,243,462,720
3405-000,2014,8,21,24,138,161,299,462
3405-000,2014,8,22,1,95,121,216,299
3405-000,2014,8,22,2,64,73,137,216
3405-000,2014,8,22,3,45,57,102,137
3405-000,2014,8,22,4,43,76,119,102
3405-000,2014,8,22,5,89,98,187,119
3405-000,2014,8,22,6,176,190,366,187
3405-000,2014,8,22,7,414,366,780,366
3405-000,2014,8,22,8,883,953,1836,780
3405-000,2014,8,22,9,1102,1072,2174,1836
3405-000,2014,8,22,10,977,800,1777,2174
3405-000,2014,8,22,11,1009,833,1842,1777
3405-000,2014,8,22,12,977,798,1775,1842
3405-000,2014,8,22,13,819,861,1680,1775
3405-000,2014,8,22,14,859,855,1714,1680
3405-000,2014,8,22,15,1004,1006,2010,1714
3405-000,2014,8,22,16,1042,1208,2250,2010
3405-000,2014,8,22,17,1064,1167,2231,2250
3405-000,2014,8,22,18,1265,995,2260,2231
3405-000,2014,8,22,19,1278,945,2223,2260
3405-000,2014,8,22,20,860,676,1536,2223
3405-000,2014,8,22,21,700,524,1224,1536
3405-000,2014,8,22,22,448,370,818,1224
3405-000,2014,8,22,23,289,256,545,818
3405-000,2014,8,22,24,178,200,378,545
3405-000,2014,8,23,1,108,159,267,378
3405-000,2014,8,23,2,78,88,166,267
3405-000,2014,8,23,3,57,83,140,166
3405-000,2014,8,23,4,68,83,151,140
3405-000,2014,8,23,5,102,93,195,151
3405-000,2014,8,23,6,222,164,386,195
3405-000,2014,8,23,7,408,320,728,386
3405-000,2014,8,23,8,757,515,1272,728
3405-000,2014,8,23,9,941,664,1605,1272
3405-000,2014,8,23,10,935,753,1688,1605
3405-000,2014,8,23,11,969,778,1747,1688
3405-000,2014,8,23,12,910,748,1658,1747
3405-000,2014,8,23,13,698,668,1366,1658
3405-000,2014,8,23,14,710,622,1332,1366
3405-000,2014,8,23,15,714,697,1411,1332
3405-000,2014,8,23,16,747,743,1490,1411
3405-000,2014,8,23,17,741,684,1425,1490
3405-000,2014,8,23,18,794,769,1563,1425
3405-000,2014,8,23,19,736,722,1458,1563
3405-000,2014,8,23,20,549,576,1125,1458
3405-000,2014,8,23,21,398,422,820,1125
3405-000,2014,8,23,22,316,310,626,820
3405-000,2014,8,23,23,250,239,489,626
3405-000,2014,8,23,24,145,143,288,489
3405-000,2014,8,24,1,97,90,187,288
3405-000,2014,8,24,2,49,60,109,187
3405-000,2014,8,24,3,32,48,80,109
3405-000,2014,8,24,4,35,34,69,80
3405-000,2014,8,24,5,61,38,99,69
3405-000,2014,8,24,6,125,85,210,99
3405-000,2014,8,24,7,277,177,454,210
3405-000,2014,8,24,8,461,290,751,454
3405-000,2014,8,24,9,446,328,774,751
3405-000,2014,8,24,10,470,334,804,774
3405-000,2014,8,24,11,481,359,840,804
3405-000,2014,8,24,12,475,427,902,840
3405-000,2014,8,24,13,434,502,936,902
3405-000,2014,8,24,14,512,560,1072,936
3405-000,2014,8,24,15,578,670,1248,1072
3405-000,2014,8,24,16,498,794,1292,1248
3405-000,2014,8,24,17,618,676,1294,1292
3405-000,2014,8,24,18,686,701,1387,1294
3405-000,2014,8,24,19,589,650,1239,1387
3405-000,2014,8,24,20,398,558,956,1239
3405-000,2014,8,24,21,360,546,906,956
3405-000,2014,8,24,22,245,596,841,906
3405-000,2014,8,24,23,203,339,542,841
3405-000,2014,8,24,24,112,229,341,542
3405-000,2014,8,25,1,69,111,180,341
3405-000,2014,8,25,2,34,73,107,180
3405-000,2014,8,25,3,23,46,69,107
3405-000,2014,8,25,4,33,68,101,69
3405-000,2014,8,25,5,67,90,157,101
3405-000,2014,8,25,6,175,190,365,157
3405-000,2014,8,25,7,436,478,914,365
3405-000,2014,8,25,8,868,1218,2086,914
3405-000,2014,8,25,9,1014,1187,2201,2086
3405-000,2014,8,25,10,809,777,1586,2201
3405-000,2014,8,25,11,887,744,1631,1586
3405-000,2014,8,25,12,814,764,1578,1631
3405-000,2014,8,25,13,670,785,1455,1578
3405-000,2014,8,25,14,751,856,1607,1455
3405-000,2014,8,25,15,895,886,1781,1607
3405-000,2014,8,25,16,926,837,1763,1781
3405-000,2014,8,25,17,865,823,1688,1763
3405-000,2014,8,25,18,855,783,1638,1688
3405-000,2014,8,25,19,888,889,1777,1638
3405-000,2014,8,25,20,639,633,1272,1777
3405-000,2014,8,25,21,514,502,1016,1272
3405-000,2014,8,25,22,352,341,693,1016
3405-000,2014,8,25,23,214,217,431,693
3405-000,2014,8,25,24,155,138,293,431
3405-000,2014,8,26,1,86,101,187,293
3405-000,2014,8,26,2,59,83,142,187
3405-000,2014,8,26,3,34,67,101,142
3405-000,2014,8,26,4,52,96,148,101
3405-000,2014,8,26,5,82,90,172,148
3405-000,2014,8,26,6,175,159,334,172
3405-000,2014,8,26,7,407,401,808,334
3405-000,2014,8,26,8,905,1032,1937,808
3405-000,2014,8,26,9,1047,1084,2131,1937
3405-000,2014,8,26,10,984,878,1862,2131
3405-000,2014,8,26,11,974,896,1870,1862
3405-000,2014,8,26,12,944,829,1773,1870
3405-000,2014,8,26,13,742,724,1466,1773
3405-000,2014,8,26,14,892,868,1760,1466
3405-000,2014,8,26,15,999,973,1972,1760
3405-000,2014,8,26,16,937,921,1858,1972
3405-000,2014,8,26,17,922,875,1797,1858
3405-000,2014,8,26,18,1014,929,1943,1797
3405-000,2014,8,26,19,958,910,1868,1943
3405-000,2014,8,26,20,655,627,1282,1868
3405-000,2014,8,26,21,549,500,1049,1282
3405-000,2014,8,26,22,392,419,811,1049
3405-000,2014,8,26,23,242,240,482,811
3405-000,2014,8,26,24,166,173,339,482
3405-000,2014,8,27,1,98,112,210,339
3405-000,2014,8,27,2,73,81,154,210
3405-000,2014,8,27,3,36,55,91,154
3405-000,2014,8,27,4,41,81,122,91
3405-000,2014,8,27,5,80,95,175,122
3405-000,2014,8,27,6,181,173,354,175
3405-000,2014,8,27,7,464,430,894,354
3405-000,2014,8,27,8,942,991,1933,894
3405-000,2014,8,27,9,1080,1116,2196,1933
3405-000,2014,8,27,10,944,916,1860,2196
3405-000,2014,8,27,11,994,894,1888,1860
3405-000,2014,8,27,12,968,857,1825,1888
3405-000,2014,8,27,13,794,751,1545,1825
3405-000,2014,8,27,14,843,868,1711,1545
3405-000,2014,8,27,15,1018,1057,2075,1711
3405-000,2014,8,27,16,1002,832,1834,2075
3405-000,2014,8,27,17,951,853,1804,1834
3405-000,2014,8,27,18,988,971,1959,1804
3405-000,2014,8,27,19,1016,941,1957,1959
3405-000,2014,8,27,20,638,638,1276,1957
3405-000,2014,8,27,21,520,494,1014,1276
3405-000,2014,8,27,22,379,342,721,1014
3405-000,2014,8,27,23,289,245,534,721
3405-000,2014,8,27,24,157,162,319,534
3405-000,2014,8,28,1,109,112,221,319
3405-000,2014,8,28,2,66,86,152,221
3405-000,2014,8,28,3,42,73,115,152
3405-000,2014,8,28,4,57,76,133,115
3405-000,2014,8,28,5,98,103,201,133
3405-000,2014,8,28,6,185,189,374,201
3405-000,2014,8,28,7,423,414,837,374
3405-000,2014,8,28,8,922,1091,2013,837
3405-000,2014,8,28,9,1120,1141,2261,2013
3405-000,2014,8,28,10,919,911,1830,2261
3405-000,2014,8,28,11,970,898,1868,1830
3405-000,2014,8,28,12,931,917,1848,1868
3405-000,2014,8,28,13,776,760,1536,1848
3405-000,2014,8,28,14,843,851,1694,1536
3405-000,2014,8,28,15,977,966,1943,1694
3405-000,2014,8,28,16,1050,942,1992,1943
3405-000,2014,8,28,17,994,950,1944,1992
3405-000,2014,8,28,18,1027,899,1926,1944
3405-000,2014,8,28,19,1012,990,2002,1926
3405-000,2014,8,28,20,660,665,1325,2002
3405-000,2014,8,28,21,583,492,1075,1325
3405-000,2014,8,28,22,386,365,751,1075
3405-000,2014,8,28,23,317,232,549,751
3405-000,2014,8,28,24,175,154,329,549
3405-000,2014,8,29,1,106,125,231,329
3405-000,2014,8,29,2,57,81,138,231
3405-000,2014,8,29,3,39,59,98,138
3405-000,2014,8,29,4,45,89,134,98
3405-000,2014,8,29,5,97,97,194,134
3405-000,2014,8,29,6,183,178,361,194
3405-000,2014,8,29,7,415,448,863,361
3405-000,2014,8,29,8,907,1098,2005,863
3405-000,2014,8,29,9,1129,1089,2218,2005
3405-000,2014,8,29,10,959,905,1864,2218
3405-000,2014,8,29,11,1002,860,1862,1864
3405-000,2014,8,29,12,946,844,1790,1862
3405-000,2014,8,29,13,842,795,1637,1790
3405-000,2014,8,29,14,864,858,1722,1637
3405-000,2014,8,29,15,976,954,1930,1722
3405-000,2014,8,29,16,1052,945,1997,1930
3405-000,2014,8,29,17,1046,911,1957,1997
3405-000,2014,8,29,18,1117,967,2084,1957
3405-000,2014,8,29,19,1287,972,2259,2084
3405-000,2014,8,29,20,834,737,1571,2259
3405-000,2014,8,29,21,684,567,1251,1571
3405-000,2014,8,29,22,482,367,849,1251
3405-000,2014,8,29,23,298,259,557,849
3405-000,2014,8,29,24,203,182,385,557
3405-000,2014,8,30,1,115,137,252,385
3405-000,2014,8,30,2,59,92,151,252
3405-000,2014,8,30,3,63,68,131,151
3405-000,2014,8,30,4,63,88,151,131
3405-000,2014,8,30,5,75,100,175,151
3405-000,2014,8,30,6,215,155,370,175
3405-000,2014,8,30,7,445,343,788,370
3405-000,2014,8,30,8,776,589,1365,788
3405-000,2014,8,30,9,881,753,1634,1365
3405-000,2014,8,30,10,888,706,1594,1634
3405-000,2014,8,30,11,935,792,1727,1594
3405-000,2014,8,30,12,847,712,1559,1727
3405-000,2014,8,30,13,737,717,1454,1559
3405-000,2014,8,30,14,759,860,1619,1454
3405-000,2014,8,30,15,791,793,1584,1619
3405-000,2014,8,30,16,893,825,1718,1584
3405-000,2014,8,30,17,782,821,1603,1718
3405-000,2014,8,30,18,834,874,1708,1603
3405-000,2014,8,30,19,741,797,1538,1708
3405-000,2014,8,30,20,540,660,1200,1538
3405-000,2014,8,30,21,438,452,890,1200
3405-000,2014,8,30,22,311,382,693,890
3405-000,2014,8,30,23,212,257,469,693
3405-000,2014,8,30,24,138,157,295,469
3405-000,2014,8,31,1,103,96,199,295
3405-000,2014,8,31,2,56,60,116,199
3405-000,2014,8,31,3,40,40,80,116
3405-000,2014,8,31,4,32,32,64,80
3405-000,2014,8,31,5,64,43,107,64
3405-000,2014,8,31,6,155,92,247,107
3405-000,2014,8,31,7,285,168,453,247
3405-000,2014,8,31,8,448,305,753,453
3405-000,2014,8,31,9,514,355,869,753
3405-000,2014,8,31,10,544,388,932,869
3405-000,2014,8,31,11,599,478,1077,932
3405-000,2014,8,31,12,554,466,1020,1077
3405-000,2014,8,31,13,496,517,1013,1020
3405-000,2014,8,31,14,602,596,1198,1013
3405-000,2014,8,31,15,622,718,1340,1198
3405-000,2014,8,31,16,622,731,1353,1340
3405-000,2014,8,31,17,618,718,1336,1353
3405-000,2014,8,31,18,679,778,1457,1336
3405-000,2014,8,31,19,524,693,1217,1457
3405-000,2014,8,31,20,474,591,1065,1217
3405-000,2014,8,31,21,395,477,872,1065
3405-000,2014,8,31,22,284,476,760,872
3405-000,2014,8,31,23,201,303,504,760
3405-000,2014,8,31,24,117,173,290,504
3405-000,2014,9,1,1,78,91,169,290
3405-000,2014,9,1,2,36,69,105,169
3405-000,2014,9,1,3,33,72,105,105
3405-000,2014,9,1,4,44,76,120,105
3405-000,2014,9,1,5,78,86,164,120
3405-000,2014,9,1,6,196,215,411,164
3405-000,2014,9,1,7,436,560,996,411
3405-000,2014,9,1,8,1004,1316,2320,996
3405-000,2014,9,1,9,1085,1237,2322,2320
3405-000,2014,9,1,10,892,871,1763,2322
3405-000,2014,9,1,11,984,850,1834,1763
3405-000,2014,9,1,12,959,868,1827,1834
3405-000,2014,9,1,13,742,759,1501,1827
3405-000,2014,9,1,14,855,866,1721,1501
3405-000,2014,9,1,15,913,963,1876,1721
3405-000,2014,9,1,16,946,950,1896,1876
3405-000,2014,9,1,17,935,884,1819,1896
3405-000,2014,9,1,18,958,830,1788,1819
3405-000,2014,9,1,19,933,892,1825,1788
3405-000,2014,9,1,20,729,606,1335,1825
3405-000,2014,9,1,21,559,540,1099,1335
3405-000,2014,9,1,22,376,396,772,1099
3405-000,2014,9,1,23,244,217,461,772
3405-000,2014,9,1,24,184,155,339,461
3405-000,2014,9,2,1,89,123,212,339
3405-000,2014,9,2,2,47,81,128,212
3405-000,2014,9,2,3,44,77,121,128
3405-000,2014,9,2,4,51,92,143,121
3405-000,2014,9,2,5,90,120,210,143
3405-000,2014,9,2,6,173,177,350,210
3405-000,2014,9,2,7,427,416,843,350
3405-000,2014,9,2,8,894,1068,1962,843
3405-000,2014,9,2,9,1146,1142,2288,1962
3405-000,2014,9,2,10,1010,887,1897,2288
3405-000,2014,9,2,11,1001,946,1947,1897
3405-000,2014,9,2,12,1011,898,1909,1947
3405-000,2014,9,2,13,842,746,1588,1909
3405-000,2014,9,2,14,940,871,1811,1588
3405-000,2014,9,2,15,990,994,1984,1811
3405-000,2014,9,2,16,992,987,1979,1984
3405-000,2014,9,2,17,992,898,1890,1979
3405-000,2014,9,2,18,1038,896,1934,1890
3405-000,2014,9,2,19,982,879,1861,1934
3405-000,2014,9,2,20,671,637,1308,1861
3405-000,2014,9,2,21,548,521,1069,1308
3405-000,2014,9,2,22,400,383,783,1069
3405-000,2014,9,2,23,276,232,508,783
3405-000,2014,9,2,24,164,163,327,508
3405-000,2014,9,3,1,98,93,191,327
3405-000,2014,9,3,2,62,83,145,191
3405-000,2014,9,3,3,47,68,115,145
3405-000,2014,9,3,4,50,67,117,115
3405-000,2014,9,3,5,83,81,164,117
3405-000,2014,9,3,6,161,159,320,164
3405-000,2014,9,3,7,360,337,697,320
3405-000,2014,9,3,8,763,953,1716,697
3405-000,2014,9,3,9,1030,1128,2158,1716
3405-000,2014,9,3,10,891,775,1666,2158
3405-000,2014,9,3,11,894,914,1808,1666
3405-000,2014,9,3,12,912,857,1769,1808
3405-000,2014,9,3,13,795,750,1545,1769
3405-000,2014,9,3,14,850,794,1644,1545
3405-000,2014,9,3,15,1009,954,1963,1644
3405-000,2014,9,3,16,1006,948,1954,1963
3405-000,2014,9,3,17,928,844,1772,1954
3405-000,2014,9,3,18,1013,850,1863,1772
3405-000,2014,9,3,19,963,860,1823,1863
3405-000,2014,9,3,20,591,594,1185,1823
3405-000,2014,9,3,21,508,466,974,1185
3405-000,2014,9,3,22,364,341,705,974
3405-000,2014,9,3,23,232,232,464,705
3405-000,2014,9,3,24,162,175,337,464
3405-000,2014,9,4,1,100,90,190,337
3405-000,2014,9,4,2,52,92,144,190
3405-000,2014,9,4,3,50,57,107,144
3405-000,2014,9,4,4,50,65,115,107
3405-000,2014,9,4,5,72,98,170,115
3405-000,2014,9,4,6,158,154,312,170
3405-000,2014,9,4,7,366,414,780,312
3405-000,2014,9,4,8,851,1044,1895,780
3405-000,2014,9,4,9,1070,1130,2200,1895
3405-000,2014,9,4,10,1007,895,1902,2200
3405-000,2014,9,4,11,1009,962,1971,1902
3405-000,2014,9,4,12,981,859,1840,1971
3405-000,2014,9,4,13,871,770,1641,1840
3405-000,2014,9,4,14,929,894,1823,1641
3405-000,2014,9,4,15,1004,1021,2025,1823
3405-000,2014,9,4,16,1027,1033,2060,2025
3405-000,2014,9,4,17,1021,1008,2029,2060
3405-000,2014,9,4,18,1012,940,1952,2029
3405-000,2014,9,4,19,1107,1026,2133,1952
3405-000,2014,9,4,20,726,713,1439,2133
3405-000,2014,9,4,21,571,544,1115,1439
3405-000,2014,9,4,22,411,447,858,1115
3405-000,2014,9,4,23,293,230,523,858
3405-000,2014,9,4,24,177,191,368,523
3405-000,2014,9,5,1,105,116,221,368
3405-000,2014,9,5,2,66,105,171,221
3405-000,2014,9,5,3,64,61,125,171
3405-000,2014,9,5,4,41,90,131,125
3405-000,2014,9,5,5,98,99,197,131
3405-000,2014,9,5,6,170,181,351,197
3405-000,2014,9,5,7,429,434,863,351
3405-000,2014,9,5,8,873,1046,1919,863
3405-000,2014,9,5,9,1086,1168,2254,1919
3405-000,2014,9,5,10,998,837,1835,2254
3405-000,2014,9,5,11,1012,857,1869,1835
3405-000,2014,9,5,12,1072,882,1954,1869
3405-000,2014,9,5,13,889,812,1701,1954
3405-000,2014,9,5,14,926,907,1833,1701
3405-000,2014,9,5,15,1062,943,2005,1833
3405-000,2014,9,5,16,1059,943,2002,2005
3405-000,2014,9,5,17,1196,863,2059,2002
3405-000,2014,9,5,18,1299,1089,2388,2059
3405-000,2014,9,5,19,1324,1027,2351,2388
3405-000,2014,9,5,20,887,601,1488,2351
3405-000,2014,9,5,21,542,471,1013,1488
3405-000,2014,9,5,22,392,340,732,1013
3405-000,2014,9,5,23,320,229,549,732
3405-000,2014,9,5,24,166,187,353,549
3405-000,2014,9,6,1,119,131,250,353
3405-000,2014,9,6,2,85,89,174,250
3405-000,2014,9,6,3,68,83,151,174
3405-000,2014,9,6,4,60,81,141,151
3405-000,2014,9,6,5,107,93,200,141
3405-000,2014,9,6,6,193,133,326,200
3405-000,2014,9,6,7,396,229,625,326
3405-000,2014,9,6,8,1018,367,1385,625
3405-000,2014,9,6,9,756,558,1314,1385
3405-000,2014,9,6,10,577,501,1078,1314
3405-000,2014,9,6,11,646,501,1147,1078
3405-000,2014,9,6,12,613,506,1119,1147
3405-000,2014,9,6,13,603,431,1034,1119
3405-000,2014,9,6,14,555,444,999,1034
3405-000,2014,9,6,15,585,483,1068,999
3405-000,2014,9,6,16,595,463,1058,1068
3405-000,2014,9,6,17,615,430,1045,1058
3405-000,2014,9,6,18,609,464,1073,1045
3405-000,2014,9,6,19,501,430,931,1073
3405-000,2014,9,6,20,368,299,667,931
3405-000,2014,9,6,21,317,249,566,667
3405-000,2014,9,6,22,239,162,401,566
3405-000,2014,9,6,23,186,131,317,401
3405-000,2014,9,6,24,115,112,227,317
3405-000,2014,9,7,1,79,65,144,227
3405-000,2014,9,7,2,59,36,95,144
3405-000,2014,9,7,3,34,34,68,95
3405-000,2014,9,7,4,34,20,54,68
3405-000,2014,9,7,5,41,35,76,54
3405-000,2014,9,7,6,112,60,172,76
3405-000,2014,9,7,7,193,98,291,172
3405-000,2014,9,7,8,262,184,446,291
3405-000,2014,9,7,9,397,227,624,446
3405-000,2014,9,7,10,522,285,807,624
3405-000,2014,9,7,11,551,346,897,807
3405-000,2014,9,7,12,576,475,1051,897
3405-000,2014,9,7,13,488,418,906,1051
3405-000,2014,9,7,14,474,340,814,906
3405-000,2014,9,7,15,425,317,742,814
3405-000,2014,9,7,16,453,366,819,742
3405-000,2014,9,7,17,388,334,722,819
3405-000,2014,9,7,18,316,306,622,722
3405-000,2014,9,7,19,261,246,507,622
3405-000,2014,9,7,20,224,212,436,507
3405-000,2014,9,7,21,192,165,357,436
3405-000,2014,9,7,22,146,145,291,357
3405-000,2014,9,7,23,122,116,238,291
3405-000,2014,9,7,24,70,77,147,238
3405-000,2014,9,8,1,54,30,84,147
3405-000,2014,9,8,2,33,28,61,84
3405-000,2014,9,8,3,25,23,48,61
3405-000,2014,9,8,4,18,14,32,48
3405-000,2014,9,8,5,29,17,46,32
3405-000,2014,9,8,6,104,42,146,46
3405-000,2014,9,8,7,271,146,417,146
3405-000,2014,9,8,8,336,269,605,417
3405-000,2014,9,8,9,378,213,591,605
3405-000,2014,9,8,10,600,286,886,591
3405-000,2014,9,8,11,825,404,1229,886
3405-000,2014,9,8,12,967,679,1646,1229
3405-000,2014,9,8,13,1027,659,1686,1646
3405-000,2014,9,8,14,881,670,1551,1686
3405-000,2014,9,8,15,1021,763,1784,1551
3405-000,2014,9,8,16,1130,842,1972,1784
3405-000,2014,9,8,17,1049,799,1848,1972
3405-000,2014,9,8,18,932,678,1610,1848
3405-000,2014,9,8,19,735,576,1311,1610
3405-000,2014,9,8,20,425,501,926,1311
3405-000,2014,9,8,21,441,406,847,926
3405-000,2014,9,8,22,695,410,1105,847
3405-000,2014,9,8,23,228,347,575,1105
3405-000,2014,9,8,24,176,216,392,575
3405-000,2014,9,9,1,169,155,324,392
3405-000,2014,9,9,2,65,118,183,324
3405-000,2014,9,9,3,56,81,137,183
3405-000,2014,9,9,4,44,36,80,137
3405-000,2014,9,9,5,49,33,82,80
3405-000,2014,9,9,6,68,53,121,82
3405-000,2014,9,9,7,136,77,213,121
3405-000,2014,9,9,8,173,170,343,213
3405-000,2014,9,9,9,263,177,440,343
3405-000,2014,9,9,10,351,281,632,440
3405-000,2014,9,9,11,475,351,826,632
3405-000,2014,9,9,12,468,475,943,826
3405-000,2014,9,9,13,472,508,980,943
3405-000,2014,9,9,14,427,516,943,980
3405-000,2014,9,9,15,482,556,1038,943
3405-000,2014,9,9,16,460,696,1156,1038
3405-000,2014,9,9,17,552,650,1202,1156
3405-000,2014,9,9,18,488,589,1077,1202
3405-000,2014,9,9,19,485,563,1048,1077
3405-000,2014,9,9,20,360,466,826,1048
3405-000,2014,9,9,21,353,439,792,826
3405-000,2014,9,9,22,248,510,758,792
3405-000,2014,9,9,23,211,392,603,758
3405-000,2014,9,9,24,124,239,363,603
3405-000,2014,9,10,1,112,339,451,363
3405-000,2014,9,10,2,77,130,207,451
3405-000,2014,9,10,3,53,80,133,207
3405-000,2014,9,10,4,31,46,77,133
3405-000,2014,9,10,5,54,60,114,77
3405-000,2014,9,10,6,103,89,192,114
3405-000,2014,9,10,7,242,237,479,192
3405-000,2014,9,10,8,501,435,936,479
3405-000,2014,9,10,9,476,413,889,936
3405-000,2014,9,10,10,509,397,906,889
3405-000,2014,9,10,11,588,501,1089,906
3405-000,2014,9,10,12,584,483,1067,1089
3405-000,2014,9,10,13,502,520,1022,1067
3405-000,2014,9,10,14,483,519,1002,1022
3405-000,2014,9,10,15,590,576,1166,1002
3405-000,2014,9,10,16,544,572,1116,1166
3405-000,2014,9,10,17,536,575,1111,1116
3405-000,2014,9,10,18,514,599,1113,1111
3405-000,2014,9,10,19,487,592,1079,1113
3405-000,2014,9,10,20,373,440,813,1079
3405-000,2014,9,10,21,290,385,675,813
3405-000,2014,9,10,22,225,297,522,675
3405-000,2014,9,10,23,176,227,403,522
3405-000,2014,9,10,24,97,142,239,403
3405-000,2014,9,11,1,54,99,153,239
3405-000,2014,9,11,2,38,64,102,153
3405-000,2014,9,11,3,44,54,98,102
3405-000,2014,9,11,4,38,65,103,98
3405-000,2014,9,11,5,74,101,175,103
3405-000,2014,9,11,6,175,212,387,175
3405-000,2014,9,11,7,383,494,877,387
3405-000,2014,9,11,8,895,1172,2067,877
3405-000,2014,9,11,9,1067,1049,2116,2067
3405-000,2014,9,11,10,812,755,1567,2116
3405-000,2014,9,11,11,892,738,1630,1567
3405-000,2014,9,11,12,840,742,1582,1630
3405-000,2014,9,11,13,706,691,1397,1582
3405-000,2014,9,11,14,744,791,1535,1397
3405-000,2014,9,11,15,883,876,1759,1535
3405-000,2014,9,11,16,867,798,1665,1759
3405-000,2014,9,11,17,811,772,1583,1665
3405-000,2014,9,11,18,872,786,1658,1583
3405-000,2014,9,11,19,837,828,1665,1658
3405-000,2014,9,11,20,567,574,1141,1665
3405-000,2014,9,11,21,404,476,880,1141
3405-000,2014,9,11,22,312,334,646,880
3405-000,2014,9,11,23,229,201,430,646
3405-000,2014,9,11,24,117,122,239,430
3405-000,2014,9,12,1,73,93,166,239
3405-000,2014,9,12,2,52,71,123,166
3405-000,2014,9,12,3,40,74,114,123
3405-000,2014,9,12,4,42,71,113,114
3405-000,2014,9,12,5,82,102,184,113
3405-000,2014,9,12,6,157,177,334,184
3405-000,2014,9,12,7,436,445,881,334
3405-000,2014,9,12,8,883,1046,1929,881
3405-000,2014,9,12,9,997,1037,2034,1929
3405-000,2014,9,12,10,933,842,1775,2034
3405-000,2014,9,12,11,972,874,1846,1775
3405-000,2014,9,12,12,931,808,1739,1846
3405-000,2014,9,12,13,749,737,1486,1739
3405-000,2014,9,12,14,880,848,1728,1486
3405-000,2014,9,12,15,1062,942,2004,1728
3405-000,2014,9,12,16,975,906,1881,2004
3405-000,2014,9,12,17,934,849,1783,1881
3405-000,2014,9,12,18,1093,920,2013,1783
3405-000,2014,9,12,19,1089,904,1993,2013
3405-000,2014,9,12,20,763,644,1407,1993
3405-000,2014,9,12,21,523,562,1085,1407
3405-000,2014,9,12,22,392,365,757,1085
3405-000,2014,9,12,23,262,187,449,757
3405-000,2014,9,12,24,155,179,334,449
3405-000,2014,9,13,1,91,100,191,334
3405-000,2014,9,13,2,56,60,116,191
3405-000,2014,9,13,3,51,64,115,116
3405-000,2014,9,13,4,52,76,128,115
3405-000,2014,9,13,5,64,110,174,128
3405-000,2014,9,13,6,162,176,338,174
3405-000,2014,9,13,7,344,354,698,338
3405-000,2014,9,13,8,722,603,1325,698
3405-000,2014,9,13,9,786,641,1427,1325
3405-000,2014,9,13,10,834,669,1503,1427
3405-000,2014,9,13,11,866,681,1547,1503
3405-000,2014,9,13,12,821,653,1474,1547
3405-000,2014,9,13,13,657,579,1236,1474
3405-000,2014,9,13,14,722,631,1353,1236
3405-000,2014,9,13,15,724,658,1382,1353
3405-000,2014,9,13,16,757,618,1375,1382
3405-000,2014,9,13,17,749,672,1421,1375
3405-000,2014,9,13,18,782,743,1525,1421
3405-000,2014,9,13,19,666,620,1286,1525
3405-000,2014,9,13,20,412,437,849,1286
3405-000,2014,9,13,21,309,325,634,849
3405-000,2014,9,13,22,238,213,451,634
3405-000,2014,9,13,23,195,163,358,451
3405-000,2014,9,13,24,109,130,239,358
3405-000,2014,9,14,1,67,92,159,239
3405-000,2014,9,14,2,49,57,106,159
3405-000,2014,9,14,3,34,43,77,106
3405-000,2014,9,14,4,42,36,78,77
3405-000,2014,9,14,5,47,40,87,78
3405-000,2014,9,14,6,104,74,178,87
3405-000,2014,9,14,7,205,171,376,178
3405-000,2014,9,14,8,337,270,607,376
3405-000,2014,9,14,9,440,295,735,607
3405-000,2014,9,14,10,461,337,798,735
3405-000,2014,9,14,11,532,407,939,798
3405-000,2014,9,14,12,483,404,887,939
3405-000,2014,9,14,13,422,425,847,887
3405-000,2014,9,14,14,458,486,944,847
3405-000,2014,9,14,15,498,499,997,944
3405-000,2014,9,14,16,562,517,1079,997
3405-000,2014,9,14,17,540,574,1114,1079
3405-000,2014,9,14,18,565,638,1203,1114
3405-000,2014,9,14,19,449,469,918,1203
3405-000,2014,9,14,20,349,421,770,918
3405-000,2014,9,14,21,301,322,623,770
3405-000,2014,9,14,22,217,272,489,623
3405-000,2014,9,14,23,135,207,342,489
3405-000,2014,9,14,24,91,131,222,342
3405-000,2014,9,15,1,55,83,138,222
3405-000,2014,9,15,2,29,60,89,138
3405-000,2014,9,15,3,33,54,87,89
3405-000,2014,9,15,4,36,67,103,87
3405-000,2014,9,15,5,70,95,165,103
3405-000,2014,9,15,6,173,218,391,165
3405-000,2014,9,15,7,502,581,1083,391
3405-000,2014,9,15,8,949,1382,2331,1083
3405-000,2014,9,15,9,1043,1176,2219,2331
3405-000,2014,9,15,10,922,886,1808,2219
3405-000,2014,9,15,11,974,861,1835,1808
3405-000,2014,9,15,12,970,834,1804,1835
3405-000,2014,9,15,13,824,799,1623,1804
3405-000,2014,9,15,14,862,858,1720,1623
3405-000,2014,9,15,15,970,953,1923,1720
3405-000,2014,9,15,16,999,874,1873,1923
3405-000,2014,9,15,17,960,874,1834,1873
3405-000,2014,9,15,18,952,940,1892,1834
3405-000,2014,9,15,19,1014,914,1928,1892
3405-000,2014,9,15,20,624,612,1236,1928
3405-000,2014,9,15,21,476,501,977,1236
3405-000,2014,9,15,22,342,355,697,977
3405-000,2014,9,15,23,211,208,419,697
3405-000,2014,9,15,24,127,161,288,419
3405-000,2014,9,16,1,106,93,199,288
3405-000,2014,9,16,2,59,87,146,199
3405-000,2014,9,16,3,27,65,92,146
3405-000,2014,9,16,4,52,89,141,92
3405-000,2014,9,16,5,84,127,211,141
3405-000,2014,9,16,6,183,176,359,211
3405-000,2014,9,16,7,430,494,924,359
3405-000,2014,9,16,8,902,1092,1994,924
3405-000,2014,9,16,9,1066,1121,2187,1994
3405-000,2014,9,16,10,977,906,1883,2187
3405-000,2014,9,16,11,1049,899,1948,1883
3405-000,2014,9,16,12,960,842,1802,1948
3405-000,2014,9,16,13,820,767,1587,1802
3405-000,2014,9,16,14,879,924,1803,1587
3405-000,2014,9,16,15,1009,945,1954,1803
3405-000,2014,9,16,16,1052,877,1929,1954
3405-000,2014,9,16,17,1020,827,1847,1929
3405-000,2014,9,16,18,988,862,1850,1847
3405-000,2014,9,16,19,957,871,1828,1850
3405-000,2014,9,16,20,647,575,1222,1828
3405-000,2014,9,16,21,507,490,997,1222
3405-000,2014,9,16,22,317,381,698,997
3405-000,2014,9,16,23,239,245,484,698
3405-000,2014,9,16,24,137,155,292,484
3405-000,2014,9,17,1,98,104,202,292
3405-000,2014,9,17,2,62,68,130,202
3405-000,2014,9,17,3,29,68,97,130
3405-000,2014,9,17,4,63,59,122,97
3405-000,2014,9,17,5,75,90,165,122
3405-000,2014,9,17,6,187,205,392,165
3405-000,2014,9,17,7,404,454,858,392
3405-000,2014,9,17,8,903,1110,2013,858
3405-000,2014,9,17,9,1076,1088,2164,2013
3405-000,2014,9,17,10,944,875,1819,2164
3405-000,2014,9,17,11,934,879,1813,1819
3405-000,2014,9,17,12,957,879,1836,1813
3405-000,2014,9,17,13,766,772,1538,1836
3405-000,2014,9,17,14,891,875,1766,1538
3405-000,2014,9,17,15,1057,892,1949,1766
3405-000,2014,9,17,16,1030,936,1966,1949
3405-000,2014,9,17,17,919,818,1737,1966
3405-000,2014,9,17,18,1049,926,1975,1737
3405-000,2014,9,17,19,970,936,1906,1975
3405-000,2014,9,17,20,650,595,1245,1906
3405-000,2014,9,17,21,435,460,895,1245
3405-000,2014,9,17,22,309,323,632,895
3405-000,2014,9,17,23,232,229,461,632
3405-000,2014,9,17,24,142,130,272,461
3405-000,2014,9,18,1,97,98,195,272
3405-000,2014,9,18,2,73,95,168,195
3405-000,2014,9,18,3,33,64,97,168
3405-000,2014,9,18,4,53,73,126,97
3405-000,2014,9,18,5,72,107,179,126
3405-000,2014,9,18,6,165,202,367,179
3405-000,2014,9,18,7,422,446,868,367
3405-000,2014,9,18,8,931,1105,2036,868
3405-000,2014,9,18,9,1102,1104,2206,2036
3405-000,2014,9,18,10,954,846,1800,2206
3405-000,2014,9,18,11,1002,862,1864,1800
3405-000,2014,9,18,12,990,758,1748,1864
3405-000,2014,9,18,13,789,770,1559,1748
3405-000,2014,9,18,14,870,841,1711,1559
3405-000,2014,9,18,15,1028,962,1990,1711
3405-000,2014,9,18,16,1051,927,1978,1990
3405-000,2014,9,18,17,1047,880,1927,1978
3405-000,2014,9,18,18,1031,917,1948,1927
3405-000,2014,9,18,19,947,838,1785,1948
3405-000,2014,9,18,20,669,640,1309,1785
3405-000,2014,9,18,21,478,444,922,1309
3405-000,2014,9,18,22,362,367,729,922
3405-000,2014,9,18,23,206,235,441,729
3405-000,2014,9,18,24,136,145,281,441
3405-000,2014,9,19,1,81,102,183,281
3405-000,2014,9,19,2,60,65,125,183
3405-000,2014,9,19,3,35,69,104,125
3405-000,2014,9,19,4,52,70,122,104
3405-000,2014,9,19,5,74,100,174,122
3405-000,2014,9,19,6,164,192,356,174
3405-000,2014,9,19,7,443,426,869,356
3405-000,2014,9,19,8,952,1130,2082,869
3405-000,2014,9,19,9,1060,1080,2140,2082
3405-000,2014,9,19,10,970,859,1829,2140
3405-000,2014,9,19,11,1061,903,1964,1829
3405-000,2014,9,19,12,947,871,1818,1964
3405-000,2014,9,19,13,845,784,1629,1818
3405-000,2014,9,19,14,858,868,1726,1629
3405-000,2014,9,19,15,1050,923,1973,1726
3405-000,2014,9,19,16,1044,905,1949,1973
3405-000,2014,9,19,17,1028,867,1895,1949
3405-000,2014,9,19,18,1237,997,2234,1895
3405-000,2014,9,19,19,1289,1012,2301,2234
3405-000,2014,9,19,20,837,700,1537,2301
3405-000,2014,9,19,21,615,508,1123,1537
3405-000,2014,9,19,22,406,355,761,1123
3405-000,2014,9,19,23,258,206,464,761
3405-000,2014,9,19,24,150,142,292,464
3405-000,2014,9,20,1,125,104,229,292
3405-000,2014,9,20,2,71,66,137,229
3405-000,2014,9,20,3,51,72,123,137
3405-000,2014,9,20,4,45,60,105,123
3405-000,2014,9,20,5,73,104,177,105
3405-000,2014,9,20,6,154,163,317,177
3405-000,2014,9,20,7,364,361,725,317
3405-000,2014,9,20,8,664,565,1229,725
3405-000,2014,9,20,9,847,661,1508,1229
3405-000,2014,9,20,10,854,705,1559,1508
3405-000,2014,9,20,11,902,872,1774,1559
3405-000,2014,9,20,12,855,682,1537,1774
3405-000,2014,9,20,13,739,667,1406,1537
3405-000,2014,9,20,14,687,617,1304,1406
3405-000,2014,9,20,15,758,698,1456,1304
3405-000,2014,9,20,16,760,632,1392,1456
3405-000,2014,9,20,17,742,669,1411,1392
3405-000,2014,9,20,18,845,794,1639,1411
3405-000,2014,9,20,19,726,702,1428,1639
3405-000,2014,9,20,20,502,433,935,1428
3405-000,2014,9,20,21,382,389,771,935
3405-000,2014,9,20,22,261,260,521,771
3405-000,2014,9,20,23,208,189,397,521
3405-000,2014,9,20,24,104,127,231,397
3405-000,2014,9,21,1,74,73,147,231
3405-000,2014,9,21,2,47,43,90,147
3405-000,2014,9,21,3,34,31,65,90
3405-000,2014,9,21,4,42,29,71,65
3405-000,2014,9,21,5,45,37,82,71
3405-000,2014,9,21,6,114,87,201,82
3405-000,2014,9,21,7,210,185,395,201
3405-000,2014,9,21,8,340,260,600,395
3405-000,2014,9,21,9,411,333,744,600
3405-000,2014,9,21,10,461,343,804,744
3405-000,2014,9,21,11,543,444,987,804
3405-000,2014,9,21,12,474,457,931,987
3405-000,2014,9,21,13,439,507,946,931
3405-000,2014,9,21,14,483,461,944,946
3405-000,2014,9,21,15,550,566,1116,944
3405-000,2014,9,21,16,530,585,1115,1116
3405-000,2014,9,21,17,601,613,1214,1115
3405-000,2014,9,21,18,627,636,1263,1214
3405-000,2014,9,21,19,605,552,1157,1263
3405-000,2014,9,21,20,432,431,863,1157
3405-000,2014,9,21,21,337,413,750,863
3405-000,2014,9,21,22,241,301,542,750
3405-000,2014,9,21,23,152,236,388,542
3405-000,2014,9,21,24,97,150,247,388
3405-000,2014,9,22,1,51,71,122,247
3405-000,2014,9,22,2,30,65,95,122
3405-000,2014,9,22,3,32,47,79,95
3405-000,2014,9,22,4,44,65,109,79
3405-000,2014,9,22,5,72,101,173,109
3405-000,2014,9,22,6,177,254,431,173
3405-000,2014,9,22,7,513,482,995,431
3405-000,2014,9,22,8,1054,1250,2304,995
3405-000,2014,9,22,9,1209,1306,2515,2304
3405-000,2014,9,22,10,949,885,1834,2515
3405-000,2014,9,22,11,965,837,1802,1834
3405-000,2014,9,22,12,983,874,1857,1802
3405-000,2014,9,22,13,757,786,1543,1857
3405-000,2014,9,22,14,919,884,1803,1543
3405-000,2014,9,22,15,980,982,1962,1803
3405-000,2014,9,22,16,1022,887,1909,1962
3405-000,2014,9,22,17,955,850,1805,1909
3405-000,2014,9,22,18,1000,872,1872,1805
3405-000,2014,9,22,19,964,960,1924,1872
3405-000,2014,9,22,20,619,587,1206,1924
3405-000,2014,9,22,21,515,497,1012,1206
3405-000,2014,9,22,22,344,373,717,1012
3405-000,2014,9,22,23,253,237,490,717
3405-000,2014,9,22,24,142,155,297,490
3405-000,2014,9,23,1,91,103,194,297
3405-000,2014,9,23,2,55,78,133,194
3405-000,2014,9,23,3,39,72,111,133
3405-000,2014,9,23,4,51,90,141,111
3405-000,2014,9,23,5,75,90,165,141
3405-000,2014,9,23,6,166,180,346,165
3405-000,2014,9,23,7,441,474,915,346
3405-000,2014,9,23,8,971,1098,2069,915
3405-000,2014,9,23,9,1177,1152,2329,2069
3405-000,2014,9,23,10,992,856,1848,2329
3405-000,2014,9,23,11,994,916,1910,1848
3405-000,2014,9,23,12,920,867,1787,1910
3405-000,2014,9,23,13,816,773,1589,1787
3405-000,2014,9,23,14,925,840,1765,1589
3405-000,2014,9,23,15,1036,911,1947,1765
3405-000,2014,9,23,16,1040,917,1957,1947
3405-000,2014,9,23,17,978,954,1932,1957
3405-000,2014,9,23,18,1050,918,1968,1932
3405-000,2014,9,23,19,981,978,1959,1968
3405-000,2014,9,23,20,650,623,1273,1959
3405-000,2014,9,23,21,507,484,991,1273
3405-000,2014,9,23,22,342,373,715,991
3405-000,2014,9,23,23,268,205,473,715
3405-000,2014,9,23,24,131,131,262,473
3405-000,2014,9,24,1,95,99,194,262
3405-000,2014,9,24,2,60,76,136,194
3405-000,2014,9,24,3,38,48,86,136
3405-000,2014,9,24,4,52,66,118,86
3405-000,2014,9,24,5,74,92,166,118
3405-000,2014,9,24,6,144,139,283,166
3405-000,2014,9,24,7,354,333,687,283
3405-000,2014,9,24,8,817,937,1754,687
3405-000,2014,9,24,9,1019,1059,2078,1754
3405-000,2014,9,24,10,830,800,1630,2078
3405-000,2014,9,24,11,822,771,1593,1630
3405-000,2014,9,24,12,756,751,1507,1593
3405-000,2014,9,24,13,656,659,1315,1507
3405-000,2014,9,24,14,773,775,1548,1315
3405-000,2014,9,24,15,905,809,1714,1548
3405-000,2014,9,24,16,886,830,1716,1714
3405-000,2014,9,24,17,851,774,1625,1716
3405-000,2014,9,24,18,846,852,1698,1625
3405-000,2014,9,24,19,867,854,1721,1698
3405-000,2014,9,24,20,569,508,1077,1721
3405-000,2014,9,24,21,404,461,865,1077
3405-000,2014,9,24,22,329,347,676,865
3405-000,2014,9,24,23,224,196,420,676
3405-000,2014,9,24,24,113,164,277,420
3405-000,2014,9,25,1,84,88,172,277
3405-000,2014,9,25,2,45,81,126,172
3405-000,2014,9,25,3,36,61,97,126
3405-000,2014,9,25,4,45,74,119,97
3405-000,2014,9,25,5,83,84,167,119
3405-000,2014,9,25,6,141,196,337,167
3405-000,2014,9,25,7,421,462,883,337
3405-000,2014,9,25,8,912,1070,1982,883
3405-000,2014,9,25,9,1108,1143,2251,1982
3405-000,2014,9,25,10,1009,791,1800,2251
3405-000,2014,9,25,11,947,890,1837,1800
3405-000,2014,9,25,12,970,865,1835,1837
3405-000,2014,9,25,13,745,722,1467,1835
3405-000,2014,9,25,14,899,903,1802,1467
3405-000,2014,9,25,15,1003,949,1952,1802
3405-000,2014,9,25,16,1007,939,1946,1952
3405-000,2014,9,25,17,970,901,1871,1946
3405-000,2014,9,25,18,979,911,1890,1871
3405-000,2014,9,25,19,1026,940,1966,1890
3405-000,2014,9,25,20,675,651,1326,1966
3405-000,2014,9,25,21,462,511,973,1326
3405-000,2014,9,25,22,362,401,763,973
3405-000,2014,9,25,23,230,253,483,763
3405-000,2014,9,25,24,132,149,281,483
3405-000,2014,9,26,1,80,95,175,281
3405-000,2014,9,26,2,54,97,151,175
3405-000,2014,9,26,3,34,72,106,151
3405-000,2014,9,26,4,63,78,141,106
3405-000,2014,9,26,5,87,107,194,141
3405-000,2014,9,26,6,164,180,344,194
3405-000,2014,9,26,7,425,438,863,344
3405-000,2014,9,26,8,910,1049,1959,863
3405-000,2014,9,26,9,1133,1027,2160,1959
3405-000,2014,9,26,10,958,824,1782,2160
3405-000,2014,9,26,11,1000,800,1800,1782
3405-000,2014,9,26,12,1062,834,1896,1800
3405-000,2014,9,26,13,852,831,1683,1896
3405-000,2014,9,26,14,873,905,1778,1683
3405-000,2014,9,26,15,1036,952,1988,1778
3405-000,2014,9,26,16,973,898,1871,1988
3405-000,2014,9,26,17,1010,939,1949,1871
3405-000,2014,9,26,18,1165,1000,2165,1949
3405-000,2014,9,26,19,1328,949,2277,2165
3405-000,2014,9,26,20,813,569,1382,2277
3405-000,2014,9,26,21,549,490,1039,1382
3405-000,2014,9,26,22,387,373,760,1039
3405-000,2014,9,26,23,272,226,498,760
3405-000,2014,9,26,24,150,181,331,498
3405-000,2014,9,27,1,81,119,200,331
3405-000,2014,9,27,2,67,79,146,200
3405-000,2014,9,27,3,46,72,118,146
3405-000,2014,9,27,4,56,81,137,118
3405-000,2014,9,27,5,68,92,160,137
3405-000,2014,9,27,6,147,153,300,160
3405-000,2014,9,27,7,356,313,669,300
3405-000,2014,9,27,8,645,577,1222,669
3405-000,2014,9,27,9,824,727,1551,1222
3405-000,2014,9,27,10,836,686,1522,1551
3405-000,2014,9,27,11,893,1178,2071,1522
3405-000,2014,9,27,12,879,761,1640,2071
3405-000,2014,9,27,13,715,779,1494,1640
3405-000,2014,9,27,14,704,621,1325,1494
3405-000,2014,9,27,15,766,681,1447,1325
3405-000,2014,9,27,16,775,696,1471,1447
3405-000,2014,9,27,17,659,711,1370,1471
3405-000,2014,9,27,18,821,808,1629,1370
3405-000,2014,9,27,19,716,682,1398,1629
3405-000,2014,9,27,20,482,463,945,1398
3405-000,2014,9,27,21,372,363,735,945
3405-000,2014,9,27,22,266,263,529,735
3405-000,2014,9,27,23,180,169,349,529
3405-000,2014,9,27,24,122,130,252,349
3405-000,2014,9,28,1,67,72,139,252
3405-000,2014,9,28,2,57,61,118,139
3405-000,2014,9,28,3,29,33,62,118
3405-000,2014,9,28,4,44,29,73,62
3405-000,2014,9,28,5,43,39,82,73
3405-000,2014,9,28,6,88,73,161,82
3405-000,2014,9,28,7,207,143,350,161
3405-000,2014,9,28,8,308,277,585,350
3405-000,2014,9,28,9,403,332,735,585
3405-000,2014,9,28,10,439,344,783,735
3405-000,2014,9,28,11,505,402,907,783
3405-000,2014,9,28,12,474,426,900,907
3405-000,2014,9,28,13,421,405,826,900
3405-000,2014,9,28,14,462,465,927,826
3405-000,2014,9,28,15,506,502,1008,927
3405-000,2014,9,28,16,513,590,1103,1008
3405-000,2014,9,28,17,528,572,1100,1103
3405-000,2014,9,28,18,624,678,1302,1100
3405-000,2014,9,28,19,539,593,1132,1302
3405-000,2014,9,28,20,392,483,875,1132
3405-000,2014,9,28,21,347,415,762,875
3405-000,2014,9,28,22,219,314,533,762
3405-000,2014,9,28,23,153,213,366,533
3405-000,2014,9,28,24,89,166,255,366
3405-000,2014,9,29,1,68,98,166,255
3405-000,2014,9,29,2,35,62,97,166
3405-000,2014,9,29,3,24,60,84,97
3405-000,2014,9,29,4,45,70,115,84
3405-000,2014,9,29,5,77,92,169,115
3405-000,2014,9,29,6,182,226,408,169
3405-000,2014,9,29,7,467,512,979,408
3405-000,2014,9,29,8,891,1264,2155,979
3405-000,2014,9,29,9,1017,1230,2247,2155
3405-000,2014,9,29,10,849,774,1623,2247
3405-000,2014,9,29,11,904,813,1717,1623
3405-000,2014,9,29,12,800,795,1595,1717
3405-000,2014,9,29,13,683,686,1369,1595
3405-000,2014,9,29,14,736,829,1565,1369
3405-000,2014,9,29,15,888,879,1767,1565
3405-000,2014,9,29,16,900,868,1768,1767
3405-000,2014,9,29,17,813,790,1603,1768
3405-000,2014,9,29,18,895,820,1715,1603
3405-000,2014,9,29,19,870,818,1688,1715
3405-000,2014,9,29,20,567,528,1095,1688
3405-000,2014,9,29,21,461,469,930,1095
3405-000,2014,9,29,22,328,334,662,930
3405-000,2014,9,29,23,203,212,415,662
3405-000,2014,9,29,24,127,146,273,415
3405-000,2014,9,30,1,65,126,191,273
3405-000,2014,9,30,2,43,69,112,191
3405-000,2014,9,30,3,36,53,89,112
3405-000,2014,9,30,4,47,76,123,89
3405-000,2014,9,30,5,69,108,177,123
3405-000,2014,9,30,6,123,193,316,177
3405-000,2014,9,30,7,421,402,823,316
3405-000,2014,9,30,8,856,1015,1871,823
3405-000,2014,9,30,9,1288,996,2284,1871
3405-000,2014,9,30,10,1096,921,2017,2284
3405-000,2014,9,30,11,979,907,1886,2017
3405-000,2014,9,30,12,969,827,1796,1886
3405-000,2014,9,30,13,758,751,1509,1796
3405-000,2014,9,30,14,863,881,1744,1509
3405-000,2014,9,30,15,953,927,1880,1744
3405-000,2014,9,30,16,935,949,1884,1880
3405-000,2014,9,30,17,982,843,1825,1884
3405-000,2014,9,30,18,1024,909,1933,1825
3405-000,2014,9,30,19,997,913,1910,1933
3405-000,2014,9,30,20,615,510,1125,1910
3405-000,2014,9,30,21,462,538,1000,1125
3405-000,2014,9,30,22,335,310,645,1000
3405-000,2014,9,30,23,243,258,501,645
3405-000,2014,9,30,24,145,168,313,501
3405-000,2014,10,1,1,93,100,193,313
3405-000,2014,10,1,2,48,72,120,193
3405-000,2014,10,1,3,39,65,104,120
3405-000,2014,10,1,4,45,77,122,104
3405-000,2014,10,1,5,70,102,172,122
3405-000,2014,10,1,6,143,162,305,172
3405-000,2014,10,1,7,392,460,852,305
3405-000,2014,10,1,8,882,1012,1894,852
3405-000,2014,10,1,9,1069,1121,2190,1894
3405-000,2014,10,1,10,908,788,1696,2190
3405-000,2014,10,1,11,902,848,1750,1696
3405-000,2014,10,1,12,916,813,1729,1750
3405-000,2014,10,1,13,710,758,1468,1729
3405-000,2014,10,1,14,833,833,1666,1468
3405-000,2014,10,1,15,982,959,1941,1666
3405-000,2014,10,1,16,941,906,1847,1941
3405-000,2014,10,1,17,969,836,1805,1847
3405-000,2014,10,1,18,1057,927,1984,1805
3405-000,2014,10,1,19,1026,951,1977,1984
3405-000,2014,10,1,20,583,568,1151,1977
3405-000,2014,10,1,21,418,486,904,1151
3405-000,2014,10,1,22,352,390,742,904
3405-000,2014,10,1,23,219,211,430,742
3405-000,2014,10,1,24,133,164,297,430
3405-000,2014,10,2,1,75,114,189,297
3405-000,2014,10,2,2,53,76,129,189
3405-000,2014,10,2,3,36,60,96,129
3405-000,2014,10,2,4,57,76,133,96
3405-000,2014,10,2,5,70,95,165,133
3405-000,2014,10,2,6,155,198,353,165
3405-000,2014,10,2,7,426,423,849,353
3405-000,2014,10,2,8,866,1143,2009,849
3405-000,2014,10,2,9,1103,1111,2214,2009
3405-000,2014,10,2,10,963,889,1852,2214
3405-000,2014,10,2,11,1022,919,1941,1852
3405-000,2014,10,2,12,940,801,1741,1941
3405-000,2014,10,2,13,767,826,1593,1741
3405-000,2014,10,2,14,838,881,1719,1593
3405-000,2014,10,2,15,963,963,1926,1719
3405-000,2014,10,2,16,1023,911,1934,1926
3405-000,2014,10,2,17,978,912,1890,1934
3405-000,2014,10,2,18,1141,992,2133,1890
3405-000,2014,10,2,19,1266,981,2247,2133
3405-000,2014,10,2,20,820,688,1508,2247
3405-000,2014,10,2,21,559,553,1112,1508
3405-000,2014,10,2,22,401,358,759,1112
3405-000,2014,10,2,23,261,269,530,759
3405-000,2014,10,2,24,165,188,353,530
3405-000,2014,10,3,1,79,133,212,353
3405-000,2014,10,3,2,63,76,139,212
3405-000,2014,10,3,3,43,48,91,139
3405-000,2014,10,3,4,40,61,101,91
3405-000,2014,10,3,5,57,92,149,101
3405-000,2014,10,3,6,157,152,309,149
3405-000,2014,10,3,7,328,284,612,309
3405-000,2014,10,3,8,609,547,1156,612
3405-000,2014,10,3,9,839,644,1483,1156
3405-000,2014,10,3,10,769,686,1455,1483
3405-000,2014,10,3,11,1085,894,1979,1455
3405-000,2014,10,3,12,1133,877,2010,1979
3405-000,2014,10,3,13,834,760,1594,2010
3405-000,2014,10,3,14,800,876,1676,1594
3405-000,2014,10,3,15,958,981,1939,1676
3405-000,2014,10,3,16,932,873,1805,1939
3405-000,2014,10,3,17,794,784,1578,1805
3405-000,2014,10,3,18,801,863,1664,1578
3405-000,2014,10,3,19,689,692,1381,1664
3405-000,2014,10,3,20,459,477,936,1381
3405-000,2014,10,3,21,348,362,710,936
3405-000,2014,10,3,22,249,272,521,710
3405-000,2014,10,3,23,180,198,378,521
3405-000,2014,10,3,24,129,113,242,378
3405-000,2014,10,4,1,70,75,145,242
3405-000,2014,10,4,2,45,56,101,145
3405-000,2014,10,4,3,49,47,96,101
3405-000,2014,10,4,4,40,62,102,96
3405-000,2014,10,4,5,56,95,151,102
3405-000,2014,10,4,6,108,129,237,151
3405-000,2014,10,4,7,283,276,559,237
3405-000,2014,10,4,8,501,480,981,559
3405-000,2014,10,4,9,630,526,1156,981
3405-000,2014,10,4,10,575,555,1130,1156
3405-000,2014,10,4,11,732,600,1332,1130
3405-000,2014,10,4,12,673,621,1294,1332
3405-000,2014,10,4,13,626,586,1212,1294
3405-000,2014,10,4,14,644,573,1217,1212
3405-000,2014,10,4,15,710,590,1300,1217
3405-000,2014,10,4,16,692,581,1273,1300
3405-000,2014,10,4,17,705,653,1358,1273
3405-000,2014,10,4,18,767,730,1497,1358
3405-000,2014,10,4,19,715,616,1331,1497
3405-000,2014,10,4,20,448,615,1063,1331
3405-000,2014,10,4,21,363,539,902,1063
3405-000,2014,10,4,22,310,326,636,902
3405-000,2014,10,4,23,192,239,431,636
3405-000,2014,10,4,24,129,158,287,431
3405-000,2014,10,5,1,67,100,167,287
3405-000,2014,10,5,2,52,49,101,167
3405-000,2014,10,5,3,27,48,75,101
3405-000,2014,10,5,4,39,38,77,75
3405-000,2014,10,5,5,43,39,82,77
3405-000,2014,10,5,6,87,81,168,82
3405-000,2014,10,5,7,162,133,295,168
3405-000,2014,10,5,8,277,272,549,295
3405-000,2014,10,5,9,360,309,669,549
3405-000,2014,10,5,10,409,316,725,669
3405-000,2014,10,5,11,504,379,883,725
3405-000,2014,10,5,12,435,410,845,883
3405-000,2014,10,5,13,430,574,1004,845
3405-000,2014,10,5,14,460,692,1152,1004
3405-000,2014,10,5,15,552,668,1220,1152
3405-000,2014,10,5,16,544,728,1272,1220
3405-000,2014,10,5,17,517,818,1335,1272
3405-000,2014,10,5,18,610,806,1416,1335
3405-000,2014,10,5,19,558,706,1264,1416
3405-000,2014,10,5,20,445,537,982,1264
3405-000,2014,10,5,21,309,432,741,982
3405-000,2014,10,5,22,182,340,522,741
3405-000,2014,10,5,23,174,224,398,522
3405-000,2014,10,5,24,95,179,274,398
3405-000,2014,10,6,1,60,90,150,274
3405-000,2014,10,6,2,31,64,95,150
3405-000,2014,10,6,3,34,61,95,95
3405-000,2014,10,6,4,28,65,93,95
3405-000,2014,10,6,5,63,85,148,93
3405-000,2014,10,6,6,148,225,373,148
3405-000,2014,10,6,7,440,564,1004,373
3405-000,2014,10,6,8,872,1357,2229,1004
3405-000,2014,10,6,9,1027,1230,2257,2229
3405-000,2014,10,6,10,857,793,1650,2257
3405-000,2014,10,6,11,933,867,1800,1650
3405-000,2014,10,6,12,933,841,1774,1800
3405-000,2014,10,6,13,784,769,1553,1774
3405-000,2014,10,6,14,809,882,1691,1553
3405-000,2014,10,6,15,991,949,1940,1691
3405-000,2014,10,6,16,1023,926,1949,1940
3405-000,2014,10,6,17,915,884,1799,1949
3405-000,2014,10,6,18,973,891,1864,1799
3405-000,2014,10,6,19,910,935,1845,1864
3405-000,2014,10,6,20,586,588,1174,1845
3405-000,2014,10,6,21,482,492,974,1174
3405-000,2014,10,6,22,337,395,732,974
3405-000,2014,10,6,23,201,220,421,732
3405-000,2014,10,6,24,134,167,301,421
3405-000,2014,10,7,1,71,126,197,301
3405-000,2014,10,7,2,47,85,132,197
3405-000,2014,10,7,3,40,60,100,132
3405-000,2014,10,7,4,37,90,127,100
3405-000,2014,10,7,5,68,92,160,127
3405-000,2014,10,7,6,138,205,343,160
3405-000,2014,10,7,7,405,417,822,343
3405-000,2014,10,7,8,855,1102,1957,822
3405-000,2014,10,7,9,1008,1083,2091,1957
3405-000,2014,10,7,10,964,857,1821,2091
3405-000,2014,10,7,11,954,852,1806,1821
3405-000,2014,10,7,12,932,856,1788,1806
3405-000,2014,10,7,13,790,687,1477,1788
3405-000,2014,10,7,14,829,900,1729,1477
3405-000,2014,10,7,15,986,914,1900,1729
3405-000,2014,10,7,16,952,907,1859,1900
3405-000,2014,10,7,17,997,887,1884,1859
3405-000,2014,10,7,18,1012,895,1907,1884
3405-000,2014,10,7,19,884,922,1806,1907
3405-000,2014,10,7,20,586,594,1180,1806
3405-000,2014,10,7,21,468,534,1002,1180
3405-000,2014,10,7,22,365,384,749,1002
3405-000,2014,10,7,23,213,215,428,749
3405-000,2014,10,7,24,148,148,296,428
3405-000,2014,10,8,1,71,95,166,296
3405-000,2014,10,8,2,36,74,110,166
3405-000,2014,10,8,3,25,59,84,110
3405-000,2014,10,8,4,38,72,110,84
3405-000,2014,10,8,5,64,94,158,110
3405-000,2014,10,8,6,132,193,325,158
3405-000,2014,10,8,7,387,401,788,325
3405-000,2014,10,8,8,787,1077,1864,788
3405-000,2014,10,8,9,1046,1070,2116,1864
3405-000,2014,10,8,10,975,864,1839,2116
3405-000,2014,10,8,11,1033,938,1971,1839
3405-000,2014,10,8,12,973,899,1872,1971
3405-000,2014,10,8,13,799,718,1517,1872
3405-000,2014,10,8,14,919,894,1813,1517
3405-000,2014,10,8,15,1036,1000,2036,1813
3405-000,2014,10,8,16,1070,970,2040,2036
3405-000,2014,10,8,17,1117,967,2084,2040
3405-000,2014,10,8,18,1182,1015,2197,2084
3405-000,2014,10,8,19,1151,1020,2171,2197
3405-000,2014,10,8,20,759,697,1456,2171
3405-000,2014,10,8,21,525,485,1010,1456
3405-000,2014,10,8,22,380,359,739,1010
3405-000,2014,10,8,23,245,246,491,739
3405-000,2014,10,8,24,141,182,323,491
3405-000,2014,10,9,1,102,95,197,323
3405-000,2014,10,9,2,63,68,131,197
3405-000,2014,10,9,3,45,69,114,131
3405-000,2014,10,9,4,43,62,105,114
3405-000,2014,10,9,5,59,90,149,105
3405-000,2014,10,9,6,133,160,293,149
3405-000,2014,10,9,7,349,343,692,293
3405-000,2014,10,9,8,648,571,1219,692
3405-000,2014,10,9,9,805,663,1468,1219
3405-000,2014,10,9,10,739,670,1409,1468
3405-000,2014,10,9,11,794,840,1634,1409
3405-000,2014,10,9,12,741,703,1444,1634
3405-000,2014,10,9,13,604,611,1215,1444
3405-000,2014,10,9,14,604,646,1250,1215
3405-000,2014,10,9,15,702,629,1331,1250
3405-000,2014,10,9,16,656,662,1318,1331
3405-000,2014,10,9,17,667,621,1288,1318
3405-000,2014,10,9,18,822,759,1581,1288
3405-000,2014,10,9,19,677,672,1349,1581
3405-000,2014,10,9,20,443,474,917,1349
3405-000,2014,10,9,21,343,344,687,917
3405-000,2014,10,9,22,228,280,508,687
3405-000,2014,10,9,23,169,180,349,508
3405-000,2014,10,9,24,89,133,222,349
3405-000,2014,10,10,1,61,105,166,222
3405-000,2014,10,10,2,50,72,122,166
3405-000,2014,10,10,3,33,61,94,122
3405-000,2014,10,10,4,33,69,102,94
3405-000,2014,10,10,5,62,89,151,102
3405-000,2014,10,10,6,144,187,331,151
3405-000,2014,10,10,7,375,459,834,331
3405-000,2014,10,10,8,847,1037,1884,834
3405-000,2014,10,10,9,1057,1058,2115,1884
3405-000,2014,10,10,10,961,841,1802,2115
3405-000,2014,10,10,11,1007,893,1900,1802
3405-000,2014,10,10,12,956,910,1866,1900
3405-000,2014,10,10,13,748,764,1512,1866
3405-000,2014,10,10,14,869,920,1789,1512
3405-000,2014,10,10,15,1070,967,2037,1789
3405-000,2014,10,10,16,1045,911,1956,2037
3405-000,2014,10,10,17,1028,929,1957,1956
3405-000,2014,10,10,18,1143,994,2137,1957
3405-000,2014,10,10,19,1218,1002,2220,2137
3405-000,2014,10,10,20,785,661,1446,2220
3405-000,2014,10,10,21,543,513,1056,1446
3405-000,2014,10,10,22,397,351,748,1056
3405-000,2014,10,10,23,328,245,573,748
3405-000,2014,10,10,24,175,169,344,573
3405-000,2014,10,11,1,108,103,211,344
3405-000,2014,10,11,2,57,68,125,211
3405-000,2014,10,11,3,50,75,125,125
3405-000,2014,10,11,4,50,70,120,125
3405-000,2014,10,11,5,62,89,151,120
3405-000,2014,10,11,6,155,160,315,151
3405-000,2014,10,11,7,343,284,627,315
3405-000,2014,10,11,8,616,541,1157,627
3405-000,2014,10,11,9,848,664,1512,1157
3405-000,2014,10,11,10,828,605,1433,1512
3405-000,2014,10,11,11,905,741,1646,1433
3405-000,2014,10,11,12,870,767,1637,1646
3405-000,2014,10,11,13,679,629,1308,1637
3405-000,2014,10,11,14,686,709,1395,1308
3405-000,2014,10,11,15,705,716,1421,1395
3405-000,2014,10,11,16,708,716,1424,1421
3405-000,2014,10,11,17,762,735,1497,1424
3405-000,2014,10,11,18,824,856,1680,1497
3405-000,2014,10,11,19,757,742,1499,1680
3405-000,2014,10,11,20,502,530,1032,1499
3405-000,2014,10,11,21,336,400,736,1032
3405-000,2014,10,11,22,257,287,544,736
3405-000,2014,10,11,23,208,243,451,544
3405-000,2014,10,11,24,139,136,275,451
3405-000,2014,10,12,1,66,55,121,275
3405-000,2014,10,12,2,32,48,80,121
3405-000,2014,10,12,3,50,26,76,80
3405-000,2014,10,12,4,25,40,65,76
3405-000,2014,10,12,5,33,43,76,65
3405-000,2014,10,12,6,93,80,173,76
3405-000,2014,10,12,7,191,121,312,173
3405-000,2014,10,12,8,296,268,564,312
3405-000,2014,10,12,9,412,328,740,564
3405-000,2014,10,12,10,493,372,865,740
3405-000,2014,10,12,11,539,388,927,865
3405-000,2014,10,12,12,465,431,896,927
3405-000,2014,10,12,13,456,458,914,896
3405-000,2014,10,12,14,493,484,977,914
3405-000,2014,10,12,15,517,543,1060,977
3405-000,2014,10,12,16,635,597,1232,1060
3405-000,2014,10,12,17,527,635,1162,1232
3405-000,2014,10,12,18,614,779,1393,1162
3405-000,2014,10,12,19,503,911,1414,1393
3405-000,2014,10,12,20,401,724,1125,1414
3405-000,2014,10,12,21,318,608,926,1125
3405-000,2014,10,12,22,229,398,627,926
3405-000,2014,10,12,23,189,294,483,627
3405-000,2014,10,12,24,109,173,282,483
3405-000,2014,10,13,1,63,118,181,282
3405-000,2014,10,13,2,38,82,120,181
3405-000,2014,10,13,3,34,51,85,120
3405-000,2014,10,13,4,46,57,103,85
3405-000,2014,10,13,5,80,90,170,103
3405-000,2014,10,13,6,179,236,415,170
3405-000,2014,10,13,7,440,514,954,415
3405-000,2014,10,13,8,943,1394,2337,954
3405-000,2014,10,13,9,1121,1219,2340,2337
3405-000,2014,10,13,10,932,859,1791,2340
3405-000,2014,10,13,11,928,904,1832,1791
3405-000,2014,10,13,12,959,888,1847,1832
3405-000,2014,10,13,13,832,714,1546,1847
3405-000,2014,10,13,14,796,924,1720,1546
3405-000,2014,10,13,15,1034,941,1975,1720
3405-000,2014,10,13,16,982,925,1907,1975
3405-000,2014,10,13,17,876,887,1763,1907
3405-000,2014,10,13,18,1004,911,1915,1763
3405-000,2014,10,13,19,946,908,1854,1915
3405-000,2014,10,13,20,600,594,1194,1854
3405-000,2014,10,13,21,440,532,972,1194
3405-000,2014,10,13,22,359,380,739,972
3405-000,2014,10,13,23,205,255,460,739
3405-000,2014,10,13,24,129,176,305,460
3405-000,2014,10,14,1,62,120,182,305
3405-000,2014,10,14,2,38,74,112,182
3405-000,2014,10,14,3,29,70,99,112
3405-000,2014,10,14,4,52,73,125,99
3405-000,2014,10,14,5,71,105,176,125
3405-000,2014,10,14,6,156,194,350,176
3405-000,2014,10,14,7,401,454,855,350
3405-000,2014,10,14,8,857,1119,1976,855
3405-000,2014,10,14,9,1037,1083,2120,1976
3405-000,2014,10,14,10,914,865,1779,2120
3405-000,2014,10,14,11,1011,888,1899,1779
3405-000,2014,10,14,12,929,871,1800,1899
3405-000,2014,10,14,13,804,721,1525,1800
3405-000,2014,10,14,14,899,849,1748,1525
3405-000,2014,10,14,15,1031,989,2020,1748
3405-000,2014,10,14,16,993,938,1931,2020
3405-000,2014,10,14,17,1016,895,1911,1931
3405-000,2014,10,14,18,1001,894,1895,1911
3405-000,2014,10,14,19,930,883,1813,1895
3405-000,2014,10,14,20,570,583,1153,1813
3405-000,2014,10,14,21,446,513,959,1153
3405-000,2014,10,14,22,304,406,710,959
3405-000,2014,10,14,23,233,210,443,710
3405-000,2014,10,14,24,130,148,278,443
3405-000,2014,10,15,1,48,117,165,278
3405-000,2014,10,15,2,49,75,124,165
3405-000,2014,10,15,3,34,66,100,124
3405-000,2014,10,15,4,41,60,101,100
3405-000,2014,10,15,5,55,76,131,101
3405-000,2014,10,15,6,135,196,331,131
3405-000,2014,10,15,7,383,425,808,331
3405-000,2014,10,15,8,838,1041,1879,808
3405-000,2014,10,15,9,1069,1116,2185,1879
3405-000,2014,10,15,10,920,870,1790,2185
3405-000,2014,10,15,11,1022,917,1939,1790
3405-000,2014,10,15,12,985,790,1775,1939
3405-000,2014,10,15,13,787,776,1563,1775
3405-000,2014,10,15,14,854,873,1727,1563
3405-000,2014,10,15,15,1073,963,2036,1727
3405-000,2014,10,15,16,961,972,1933,2036
3405-000,2014,10,15,17,955,943,1898,1933
3405-000,2014,10,15,18,980,973,1953,1898
3405-000,2014,10,15,19,976,898,1874,1953
3405-000,2014,10,15,20,611,564,1175,1874
3405-000,2014,10,15,21,384,494,878,1175
3405-000,2014,10,15,22,297,345,642,878
3405-000,2014,10,15,23,220,241,461,642
3405-000,2014,10,15,24,120,134,254,461
3405-000,2014,10,16,1,101,110,211,254
3405-000,2014,10,16,2,38,82,120,211
3405-000,2014,10,16,3,46,58,104,120
3405-000,2014,10,16,4,39,77,116,104
3405-000,2014,10,16,5,75,92,167,116
3405-000,2014,10,16,6,144,220,364,167
3405-000,2014,10,16,7,365,430,795,364
3405-000,2014,10,16,8,793,989,1782,795
3405-000,2014,10,16,9,1079,1154,2233,1782
3405-000,2014,10,16,10,907,902,1809,2233
3405-000,2014,10,16,11,954,859,1813,1809
3405-000,2014,10,16,12,1001,811,1812,1813
3405-000,2014,10,16,13,813,739,1552,1812
3405-000,2014,10,16,14,852,861,1713,1552
3405-000,2014,10,16,15,1006,967,1973,1713
3405-000,2014,10,16,16,995,930,1925,1973
3405-000,2014,10,16,17,937,889,1826,1925
3405-000,2014,10,16,18,967,876,1843,1826
3405-000,2014,10,16,19,958,870,1828,1843
3405-000,2014,10,16,20,569,587,1156,1828
3405-000,2014,10,16,21,491,497,988,1156
3405-000,2014,10,16,22,338,381,719,988
3405-000,2014,10,16,23,178,206,384,719
3405-000,2014,10,16,24,124,148,272,384
3405-000,2014,10,17,1,79,106,185,272
3405-000,2014,10,17,2,46,70,116,185
3405-000,2014,10,17,3,24,59,83,116
3405-000,2014,10,17,4,36,68,104,83
3405-000,2014,10,17,5,59,86,145,104
3405-000,2014,10,17,6,113,173,286,145
3405-000,2014,10,17,7,391,402,793,286
3405-000,2014,10,17,8,827,1051,1878,793
3405-000,2014,10,17,9,1096,1087,2183,1878
3405-000,2014,10,17,10,951,895,1846,2183
3405-000,2014,10,17,11,1032,966,1998,1846
3405-000,2014,10,17,12,985,859,1844,1998
3405-000,2014,10,17,13,946,760,1706,1844
3405-000,2014,10,17,14,858,915,1773,1706
3405-000,2014,10,17,15,1020,985,2005,1773
3405-000,2014,10,17,16,1026,979,2005,2005
3405-000,2014,10,17,17,1074,886,1960,2005
3405-000,2014,10,17,18,1123,958,2081,1960
3405-000,2014,10,17,19,1311,1061,2372,2081
3405-000,2014,10,17,20,838,637,1475,2372
3405-000,2014,10,17,21,580,531,1111,1475
3405-000,2014,10,17,22,380,393,773,1111
3405-000,2014,10,17,23,227,210,437,773
3405-000,2014,10,17,24,144,157,301,437
3405-000,2014,10,18,1,108,121,229,301
3405-000,2014,10,18,2,69,96,165,229
3405-000,2014,10,18,3,46,49,95,165
3405-000,2014,10,18,4,33,81,114,95
3405-000,2014,10,18,5,89,98,187,114
3405-000,2014,10,18,6,157,162,319,187
3405-000,2014,10,18,7,320,313,633,319
3405-000,2014,10,18,8,627,560,1187,633
3405-000,2014,10,18,9,892,758,1650,1187
3405-000,2014,10,18,10,916,814,1730,1650
3405-000,2014,10,18,11,958,784,1742,1730
3405-000,2014,10,18,12,936,971,1907,1742
3405-000,2014,10,18,13,929,681,1610,1907
3405-000,2014,10,18,14,707,647,1354,1610
3405-000,2014,10,18,15,721,735,1456,1354
3405-000,2014,10,18,16,779,725,1504,1456
3405-000,2014,10,18,17,821,750,1571,1504
3405-000,2014,10,18,18,874,854,1728,1571
3405-000,2014,10,18,19,709,983,1692,1728
3405-000,2014,10,18,20,488,717,1205,1692
3405-000,2014,10,18,21,350,423,773,1205
3405-000,2014,10,18,22,260,288,548,773
3405-000,2014,10,18,23,205,199,404,548
3405-000,2014,10,18,24,117,131,248,404
3405-000,2014,10,19,1,72,84,156,248
3405-000,2014,10,19,2,52,47,99,156
3405-000,2014,10,19,3,42,37,79,99
3405-000,2014,10,19,4,35,36,71,79
3405-000,2014,10,19,5,36,48,84,71
3405-000,2014,10,19,6,91,61,152,84
3405-000,2014,10,19,7,172,166,338,152
3405-000,2014,10,19,8,322,291,613,338
3405-000,2014,10,19,9,466,354,820,613
3405-000,2014,10,19,10,479,390,869,820
3405-000,2014,10,19,11,582,394,976,869
3405-000,2014,10,19,12,518,459,977,976
3405-000,2014,10,19,13,471,462,933,977
3405-000,2014,10,19,14,476,493,969,933
3405-000,2014,10,19,15,543,599,1142,969
3405-000,2014,10,19,16,613,586,1199,1142
3405-000,2014,10,19,17,603,646,1249,1199
3405-000,2014,10,19,18,612,613,1225,1249
3405-000,2014,10,19,19,580,739,1319,1225
3405-000,2014,10,19,20,421,671,1092,1319
3405-000,2014,10,19,21,325,484,809,1092
3405-000,2014,10,19,22,263,378,641,809
3405-000,2014,10,19,23,173,287,460,641
3405-000,2014,10,19,24,109,177,286,460
3405-000,2014,10,20,1,69,89,158,286
3405-000,2014,10,20,2,42,77,119,158
3405-000,2014,10,20,3,34,47,81,119
3405-000,2014,10,20,4,40,68,108,81
3405-000,2014,10,20,5,63,76,139,108
3405-000,2014,10,20,6,154,182,336,139
3405-000,2014,10,20,7,440,433,873,336
3405-000,2014,10,20,8,816,1150,1966,873
3405-000,2014,10,20,9,1049,1230,2279,1966
3405-000,2014,10,20,10,857,755,1612,2279
3405-000,2014,10,20,11,862,780,1642,1612
3405-000,2014,10,20,12,809,782,1591,1642
3405-000,2014,10,20,13,678,730,1408,1591
3405-000,2014,10,20,14,725,845,1570,1408
3405-000,2014,10,20,15,870,847,1717,1570
3405-000,2014,10,20,16,815,807,1622,1717
3405-000,2014,10,20,17,851,795,1646,1622
3405-000,2014,10,20,18,815,843,1658,1646
3405-000,2014,10,20,19,835,793,1628,1658
3405-000,2014,10,20,20,536,538,1074,1628
3405-000,2014,10,20,21,450,452,902,1074
3405-000,2014,10,20,22,325,338,663,902
3405-000,2014,10,20,23,211,221,432,663
3405-000,2014,10,20,24,123,151,274,432
3405-000,2014,10,21,1,87,82,169,274
3405-000,2014,10,21,2,44,80,124,169
3405-000,2014,10,21,3,32,44,76,124
3405-000,2014,10,21,4,32,61,93,76
3405-000,2014,10,21,5,73,87,160,93
3405-000,2014,10,21,6,123,138,261,160
3405-000,2014,10,21,7,328,316,644,261
3405-000,2014,10,21,8,792,990,1782,644
3405-000,2014,10,21,9,1027,1068,2095,1782
3405-000,2014,10,21,10,853,767,1620,2095
3405-000,2014,10,21,11,851,789,1640,1620
3405-000,2014,10,21,12,755,804,1559,1640
3405-000,2014,10,21,13,618,662,1280,1559
3405-000,2014,10,21,14,729,770,1499,1280
3405-000,2014,10,21,15,836,789,1625,1499
3405-000,2014,10,21,16,853,790,1643,1625
3405-000,2014,10,21,17,826,797,1623,1643
3405-000,2014,10,21,18,795,789,1584,1623
3405-000,2014,10,21,19,778,781,1559,1584
3405-000,2014,10,21,20,489,547,1036,1559
3405-000,2014,10,21,21,433,438,871,1036
3405-000,2014,10,21,22,306,285,591,871
3405-000,2014,10,21,23,191,196,387,591
3405-000,2014,10,21,24,119,139,258,387
3405-000,2014,10,22,1,61,112,173,258
3405-000,2014,10,22,2,37,91,128,173
3405-000,2014,10,22,3,35,56,91,128
3405-000,2014,10,22,4,36,50,86,91
3405-000,2014,10,22,5,46,90,136,86
3405-000,2014,10,22,6,116,166,282,136
3405-000,2014,10,22,7,327,377,704,282
3405-000,2014,10,22,8,733,1061,1794,704
3405-000,2014,10,22,9,1076,1107,2183,1794
3405-000,2014,10,22,10,994,868,1862,2183
3405-000,2014,10,22,11,1011,893,1904,1862
3405-000,2014,10,22,12,1010,865,1875,1904
3405-000,2014,10,22,13,800,766,1566,1875
3405-000,2014,10,22,14,876,880,1756,1566
3405-000,2014,10,22,15,952,940,1892,1756
3405-000,2014,10,22,16,1039,919,1958,1892
3405-000,2014,10,22,17,990,849,1839,1958
3405-000,2014,10,22,18,1083,928,2011,1839
3405-000,2014,10,22,19,1009,956,1965,2011
3405-000,2014,10,22,20,657,566,1223,1965
3405-000,2014,10,22,21,437,461,898,1223
3405-000,2014,10,22,22,366,355,721,898
3405-000,2014,10,22,23,271,240,511,721
3405-000,2014,10,22,24,146,175,321,511
3405-000,2014,10,23,1,98,115,213,321
3405-000,2014,10,23,2,51,96,147,213
3405-000,2014,10,23,3,43,67,110,147
3405-000,2014,10,23,4,73,65,138,110
3405-000,2014,10,23,5,84,88,172,138
3405-000,2014,10,23,6,189,185,374,172
3405-000,2014,10,23,7,449,360,809,374
3405-000,2014,10,23,8,930,1109,2039,809
3405-000,2014,10,23,9,1133,1178,2311,2039
3405-000,2014,10,23,10,988,888,1876,2311
3405-000,2014,10,23,11,1126,904,2030,1876
3405-000,2014,10,23,12,951,860,1811,2030
3405-000,2014,10,23,13,920,799,1719,1811
3405-000,2014,10,23,14,837,888,1725,1719
3405-000,2014,10,23,15,1027,908,1935,1725
3405-000,2014,10,23,16,1012,906,1918,1935
3405-000,2014,10,23,17,1014,890,1904,1918
3405-000,2014,10,23,18,1039,899,1938,1904
3405-000,2014,10,23,19,943,881,1824,1938
3405-000,2014,10,23,20,610,603,1213,1824
3405-000,2014,10,23,21,470,466,936,1213
3405-000,2014,10,23,22,372,410,782,936
3405-000,2014,10,23,23,262,218,480,782
3405-000,2014,10,23,24,165,170,335,480
3405-000,2014,10,24,1,90,108,198,335
3405-000,2014,10,24,2,53,97,150,198
3405-000,2014,10,24,3,49,74,123,150
3405-000,2014,10,24,4,75,92,167,123
3405-000,2014,10,24,5,93,94,187,167
3405-000,2014,10,24,6,196,162,358,187
3405-000,2014,10,24,7,403,406,809,358
3405-000,2014,10,24,8,853,1018,1871,809
3405-000,2014,10,24,9,1099,1135,2234,1871
3405-000,2014,10,24,10,1097,932,2029,2234
3405-000,2014,10,24,11,1070,852,1922,2029
3405-000,2014,10,24,12,932,873,1805,1922
3405-000,2014,10,24,13,870,768,1638,1805
3405-000,2014,10,24,14,849,818,1667,1638
3405-000,2014,10,24,15,929,966,1895,1667
3405-000,2014,10,24,16,1075,887,1962,1895
3405-000,2014,10,24,17,1019,900,1919,1962
3405-000,2014,10,24,18,1172,940,2112,1919
3405-000,2014,10,24,19,1229,994,2223,2112
3405-000,2014,10,24,20,801,625,1426,2223
3405-000,2014,10,24,21,528,496,1024,1426
3405-000,2014,10,24,22,356,369,725,1024
3405-000,2014,10,24,23,262,236,498,725
3405-000,2014,10,24,24,143,161,304,498
3405-000,2014,10,25,1,106,117,223,304
3405-000,2014,10,25,2,56,79,135,223
3405-000,2014,10,25,3,64,61,125,135
3405-000,2014,10,25,4,63,90,153,125
3405-000,2014,10,25,5,70,82,152,153
3405-000,2014,10,25,6,170,151,321,152
3405-000,2014,10,25,7,327,289,616,321
3405-000,2014,10,25,8,622,499,1121,616
3405-000,2014,10,25,9,794,616,1410,1121
3405-000,2014,10,25,10,806,660,1466,1410
3405-000,2014,10,25,11,867,714,1581,1466
3405-000,2014,10,25,12,803,826,1629,1581
3405-000,2014,10,25,13,758,642,1400,1629
3405-000,2014,10,25,14,962,736,1698,1400
3405-000,2014,10,25,15,820,665,1485,1698
3405-000,2014,10,25,16,758,647,1405,1485
3405-000,2014,10,25,17,747,653,1400,1405
3405-000,2014,10,25,18,836,751,1587,1400
3405-000,2014,10,25,19,745,733,1478,1587
3405-000,2014,10,25,20,431,492,923,1478
3405-000,2014,10,25,21,300,339,639,923
3405-000,2014,10,25,22,237,278,515,639
3405-000,2014,10,25,23,156,202,358,515
3405-000,2014,10,25,24,98,124,222,358
3405-000,2014,10,26,1,60,86,146,222
3405-000,2014,10,26,2,40,42,82,146
3405-000,2014,10,26,3,35,43,78,82
3405-000,2014,10,26,4,29,37,66,78
3405-000,2014,10,26,5,41,44,85,66
3405-000,2014,10,26,6,86,61,147,85
3405-000,2014,10,26,7,164,134,298,147
3405-000,2014,10,26,8,273,239,512,298
3405-000,2014,10,26,9,349,326,675,512
3405-000,2014,10,26,10,445,333,778,675
3405-000,2014,10,26,11,499,371,870,778
3405-000,2014,10,26,12,513,425,938,870
3405-000,2014,10,26,13,470,434,904,938
3405-000,2014,10,26,14,496,506,1002,904
3405-000,2014,10,26,15,500,478,978,1002
3405-000,2014,10,26,16,542,609,1151,978
3405-000,2014,10,26,17,554,579,1133,1151
3405-000,2014,10,26,18,611,685,1296,1133
3405-000,2014,10,26,19,516,630,1146,1296
3405-000,2014,10,26,20,358,524,882,1146
3405-000,2014,10,26,21,299,449,748,882
3405-000,2014,10,26,22,207,360,567,748
3405-000,2014,10,26,23,133,281,414,567
3405-000,2014,10,26,24,103,158,261,414
3405-000,2014,10,27,1,47,90,137,261
3405-000,2014,10,27,2,26,72,98,137
3405-000,2014,10,27,3,15,58,73,98
3405-000,2014,10,27,4,34,58,92,73
3405-000,2014,10,27,5,66,90,156,92
3405-000,2014,10,27,6,161,210,371,156
3405-000,2014,10,27,7,373,508,881,371
3405-000,2014,10,27,8,781,1378,2159,881
3405-000,2014,10,27,9,943,1196,2139,2159
3405-000,2014,10,27,10,727,941,1668,2139
3405-000,2014,10,27,11,813,1018,1831,1668
3405-000,2014,10,27,12,880,808,1688,1831
3405-000,2014,10,27,13,750,743,1493,1688
3405-000,2014,10,27,14,845,851,1696,1493
3405-000,2014,10,27,15,924,963,1887,1696
3405-000,2014,10,27,16,911,899,1810,1887
3405-000,2014,10,27,17,905,944,1849,1810
3405-000,2014,10,27,18,860,912,1772,1849
3405-000,2014,10,27,19,800,858,1658,1772
3405-000,2014,10,27,20,514,595,1109,1658
3405-000,2014,10,27,21,377,527,904,1109
3405-000,2014,10,27,22,268,355,623,904
3405-000,2014,10,27,23,190,208,398,623
3405-000,2014,10,27,24,103,163,266,398
3405-000,2014,10,28,1,59,111,170,266
3405-000,2014,10,28,2,43,74,117,170
3405-000,2014,10,28,3,23,68,91,117
3405-000,2014,10,28,4,34,76,110,91
3405-000,2014,10,28,5,52,101,153,110
3405-000,2014,10,28,6,119,187,306,153
3405-000,2014,10,28,7,291,431,722,306
3405-000,2014,10,28,8,758,1104,1862,722
3405-000,2014,10,28,9,985,1155,2140,1862
3405-000,2014,10,28,10,805,892,1697,2140
3405-000,2014,10,28,11,879,892,1771,1697
3405-000,2014,10,28,12,889,895,1784,1771
3405-000,2014,10,28,13,769,747,1516,1784
3405-000,2014,10,28,14,814,903,1717,1516
3405-000,2014,10,28,15,990,977,1967,1717
3405-000,2014,10,28,16,937,938,1875,1967
3405-000,2014,10,28,17,960,902,1862,1875
3405-000,2014,10,28,18,1050,885,1935,1862
3405-000,2014,10,28,19,976,805,1781,1935
3405-000,2014,10,28,20,539,564,1103,1781
3405-000,2014,10,28,21,452,484,936,1103
3405-000,2014,10,28,22,348,367,715,936
3405-000,2014,10,28,23,237,204,441,715
3405-000,2014,10,28,24,142,156,298,441
3405-000,2014,10,29,1,87,103,190,298
3405-000,2014,10,29,2,61,76,137,190
3405-000,2014,10,29,3,64,60,124,137
3405-000,2014,10,29,4,48,62,110,124
3405-000,2014,10,29,5,86,105,191,110
3405-000,2014,10,29,6,179,176,355,191
3405-000,2014,10,29,7,417,410,827,355
3405-000,2014,10,29,8,895,1140,2035,827
3405-000,2014,10,29,9,1099,1177,2276,2035
3405-000,2014,10,29,10,982,847,1829,2276
3405-000,2014,10,29,11,1017,866,1883,1829
3405-000,2014,10,29,12,939,833,1772,1883
3405-000,2014,10,29,13,819,720,1539,1772
3405-000,2014,10,29,14,891,894,1785,1539
3405-000,2014,10,29,15,1022,941,1963,1785
3405-000,2014,10,29,16,1009,899,1908,1963
3405-000,2014,10,29,17,973,887,1860,1908
3405-000,2014,10,29,18,1077,1018,2095,1860
3405-000,2014,10,29,19,1005,956,1961,2095
3405-000,2014,10,29,20,660,578,1238,1961
3405-000,2014,10,29,21,484,455,939,1238
3405-000,2014,10,29,22,342,345,687,939
3405-000,2014,10,29,23,257,219,476,687
3405-000,2014,10,29,24,165,159,324,476
3405-000,2014,10,30,1,96,102,198,324
3405-000,2014,10,30,2,74,64,138,198
3405-000,2014,10,30,3,43,57,100,138
3405-000,2014,10,30,4,49,71,120,100
3405-000,2014,10,30,5,90,109,199,120
3405-000,2014,10,30,6,199,170,369,199
3405-000,2014,10,30,7,402,400,802,369
3405-000,2014,10,30,8,875,1069,1944,802
3405-000,2014,10,30,9,1215,1183,2398,1944
3405-000,2014,10,30,10,1086,875,1961,2398
3405-000,2014,10,30,11,1040,925,1965,1961
3405-000,2014,10,30,12,977,840,1817,1965
3405-000,2014,10,30,13,727,764,1491,1817
3405-000,2014,10,30,14,899,905,1804,1491
3405-000,2014,10,30,15,1009,940,1949,1804
3405-000,2014,10,30,16,1005,880,1885,1949
3405-000,2014,10,30,17,1010,922,1932,1885
3405-000,2014,10,30,18,1062,904,1966,1932
3405-000,2014,10,30,19,1002,895,1897,1966
3405-000,2014,10,30,20,634,590,1224,1897
3405-000,2014,10,30,21,509,487,996,1224
3405-000,2014,10,30,22,368,380,748,996
3405-000,2014,10,30,23,227,221,448,748
3405-000,2014,10,30,24,168,180,348,448
3405-000,2014,10,31,1,93,101,194,348
3405-000,2014,10,31,2,69,80,149,194
3405-000,2014,10,31,3,53,72,125,149
3405-000,2014,10,31,4,53,61,114,125
3405-000,2014,10,31,5,96,83,179,114
3405-000,2014,10,31,6,174,149,323,179
3405-000,2014,10,31,7,399,324,723,323
3405-000,2014,10,31,8,831,962,1793,723
3405-000,2014,10,31,9,1078,1139,2217,1793
3405-000,2014,10,31,10,947,781,1728,2217
3405-000,2014,10,31,11,931,874,1805,1728
3405-000,2014,10,31,12,909,831,1740,1805
3405-000,2014,10,31,13,802,643,1445,1740
3405-000,2014,10,31,14,819,777,1596,1445
3405-000,2014,10,31,15,931,861,1792,1596
3405-000,2014,10,31,16,992,821,1813,1792
3405-000,2014,10,31,17,922,784,1706,1813
3405-000,2014,10,31,18,1043,1035,2078,1706
3405-000,2014,10,31,19,1108,948,2056,2078
3405-000,2014,10,31,20,795,754,1549,2056
3405-000,2014,10,31,21,532,576,1108,1549
3405-000,2014,10,31,22,404,333,737,1108
3405-000,2014,10,31,23,268,195,463,737
3405-000,2014,10,31,24,159,161,320,463
3405-000,2014,11,1,1,118,115,233,320
3405-000,2014,11,1,2,62,61,123,233
3405-000,2014,11,1,3,49,71,120,123
3405-000,2014,11,1,4,52,71,123,120
3405-000,2014,11,1,5,77,92,169,123
3405-000,2014,11,1,6,160,118,278,169
3405-000,2014,11,1,7,319,237,556,278
3405-000,2014,11,1,8,570,456,1026,556
3405-000,2014,11,1,9,793,602,1395,1026
3405-000,2014,11,1,10,708,617,1325,1395
3405-000,2014,11,1,11,733,761,1494,1325
3405-000,2014,11,1,12,745,890,1635,1494
3405-000,2014,11,1,13,708,618,1326,1635
3405-000,2014,11,1,14,709,559,1268,1326
3405-000,2014,11,1,15,683,685,1368,1268
3405-000,2014,11,1,16,714,666,1380,1368
3405-000,2014,11,1,17,721,613,1334,1380
3405-000,2014,11,1,18,753,767,1520,1334
3405-000,2014,11,1,19,684,622,1306,1520
3405-000,2014,11,1,20,477,468,945,1306
3405-000,2014,11,1,21,362,521,883,945
3405-000,2014,11,1,22,350,342,692,883
3405-000,2014,11,1,23,185,191,376,692
3405-000,2014,11,1,24,105,119,224,376
3405-000,2014,11,2,1,79,68,147,224
3405-000,2014,11,2,2,35,42,77,147
3405-000,2014,11,2,3,34,30,64,77
3405-000,2014,11,2,4,33,24,57,64
3405-000,2014,11,2,5,45,37,82,57
3405-000,2014,11,2,6,106,60,166,82
3405-000,2014,11,2,7,163,130,293,166
3405-000,2014,11,2,8,215,194,409,293
3405-000,2014,11,2,9,362,254,616,409
3405-000,2014,11,2,10,350,299,649,616
3405-000,2014,11,2,11,426,372,798,649
3405-000,2014,11,2,12,455,425,880,798
3405-000,2014,11,2,13,391,423,814,880
3405-000,2014,11,2,14,454,429,883,814
3405-000,2014,11,2,15,492,553,1045,883
3405-000,2014,11,2,16,509,617,1126,1045
3405-000,2014,11,2,17,517,659,1176,1126
3405-000,2014,11,2,18,489,774,1263,1176
3405-000,2014,11,2,19,412,627,1039,1263
3405-000,2014,11,2,20,362,580,942,1039
3405-000,2014,11,2,21,321,412,733,942
3405-000,2014,11,2,22,211,343,554,733
3405-000,2014,11,2,23,164,205,369,554
3405-000,2014,11,2,24,93,121,214,369
3405-000,2014,11,3,1,67,99,166,214
3405-000,2014,11,3,2,33,47,80,166
3405-000,2014,11,3,3,21,49,70,80
3405-000,2014,11,3,4,34,55,89,70
3405-000,2014,11,3,5,64,78,142,89
3405-000,2014,11,3,6,153,188,341,142
3405-000,2014,11,3,7,408,539,947,341
3405-000,2014,11,3,8,932,1320,2252,947
3405-000,2014,11,3,9,1031,1279,2310,2252
3405-000,2014,11,3,10,875,798,1673,2310
3405-000,2014,11,3,11,902,838,1740,1673
3405-000,2014,11,3,12,904,837,1741,1740
3405-000,2014,11,3,13,696,739,1435,1741
3405-000,2014,11,3,14,843,835,1678,1435
3405-000,2014,11,3,15,1006,885,1891,1678
3405-000,2014,11,3,16,957,893,1850,1891
3405-000,2014,11,3,17,910,878,1788,1850
3405-000,2014,11,3,18,1009,930,1939,1788
3405-000,2014,11,3,19,956,876,1832,1939
3405-000,2014,11,3,20,580,572,1152,1832
3405-000,2014,11,3,21,489,492,981,1152
3405-000,2014,11,3,22,353,376,729,981
3405-000,2014,11,3,23,210,212,422,729
3405-000,2014,11,3,24,156,172,328,422
3405-000,2014,11,4,1,99,94,193,328
3405-000,2014,11,4,2,56,77,133,193
3405-000,2014,11,4,3,38,66,104,133
3405-000,2014,11,4,4,46,66,112,104
3405-000,2014,11,4,5,79,95,174,112
3405-000,2014,11,4,6,161,185,346,174
3405-000,2014,11,4,7,400,421,821,346
3405-000,2014,11,4,8,886,1073,1959,821
3405-000,2014,11,4,9,1147,1131,2278,1959
3405-000,2014,11,4,10,1066,838,1904,2278
3405-000,2014,11,4,11,1017,919,1936,1904
3405-000,2014,11,4,12,971,891,1862,1936
3405-000,2014,11,4,13,838,749,1587,1862
3405-000,2014,11,4,14,858,844,1702,1587
3405-000,2014,11,4,15,996,886,1882,1702
3405-000,2014,11,4,16,991,918,1909,1882
3405-000,2014,11,4,17,999,814,1813,1909
3405-000,2014,11,4,18,1082,996,2078,1813
3405-000,2014,11,4,19,962,878,1840,2078
3405-000,2014,11,4,20,651,562,1213,1840
3405-000,2014,11,4,21,491,477,968,1213
3405-000,2014,11,4,22,347,377,724,968
3405-000,2014,11,4,23,253,252,505,724
3405-000,2014,11,4,24,144,151,295,505
3405-000,2014,11,5,1,84,125,209,295
3405-000,2014,11,5,2,55,76,131,209
3405-000,2014,11,5,3,48,58,106,131
3405-000,2014,11,5,4,48,69,117,106
3405-000,2014,11,5,5,100,93,193,117
3405-000,2014,11,5,6,166,133,299,193
3405-000,2014,11,5,7,409,391,800,299
3405-000,2014,11,5,8,857,1084,1941,800
3405-000,2014,11,5,9,1153,1119,2272,1941
3405-000,2014,11,5,10,1018,819,1837,2272
3405-000,2014,11,5,11,1003,855,1858,1837
3405-000,2014,11,5,12,1031,882,1913,1858
3405-000,2014,11,5,13,820,701,1521,1913
3405-000,2014,11,5,14,931,887,1818,1521
3405-000,2014,11,5,15,1017,960,1977,1818
3405-000,2014,11,5,16,1023,927,1950,1977
3405-000,2014,11,5,17,985,820,1805,1950
3405-000,2014,11,5,18,1108,993,2101,1805
3405-000,2014,11,5,19,935,891,1826,2101
3405-000,2014,11,5,20,628,598,1226,1826
3405-000,2014,11,5,21,459,438,897,1226
3405-000,2014,11,5,22,378,335,713,897
3405-000,2014,11,5,23,246,228,474,713
3405-000,2014,11,5,24,144,164,308,474
3405-000,2014,11,6,1,77,97,174,308
3405-000,2014,11,6,2,58,79,137,174
3405-000,2014,11,6,3,64,54,118,137
3405-000,2014,11,6,4,48,70,118,118
3405-000,2014,11,6,5,82,95,177,118
3405-000,2014,11,6,6,165,192,357,177
3405-000,2014,11,6,7,416,371,787,357
3405-000,2014,11,6,8,906,1087,1993,787
3405-000,2014,11,6,9,1186,1150,2336,1993
3405-000,2014,11,6,10,1057,895,1952,2336
3405-000,2014,11,6,11,1063,1025,2088,1952
3405-000,2014,11,6,12,954,903,1857,2088
3405-000,2014,11,6,13,840,727,1567,1857
3405-000,2014,11,6,14,876,888,1764,1567
3405-000,2014,11,6,15,989,942,1931,1764
3405-000,2014,11,6,16,1002,893,1895,1931
3405-000,2014,11,6,17,953,919,1872,1895
3405-000,2014,11,6,18,1095,882,1977,1872
3405-000,2014,11,6,19,952,891,1843,1977
3405-000,2014,11,6,20,644,605,1249,1843
3405-000,2014,11,6,21,516,497,1013,1249
3405-000,2014,11,6,22,359,389,748,1013
3405-000,2014,11,6,23,231,204,435,748
3405-000,2014,11,6,24,135,160,295,435
3405-000,2014,11,7,1,96,119,215,295
3405-000,2014,11,7,2,64,73,137,215
3405-000,2014,11,7,3,55,62,117,137
3405-000,2014,11,7,4,51,69,120,117
3405-000,2014,11,7,5,95,94,189,120
3405-000,2014,11,7,6,185,169,354,189
3405-000,2014,11,7,7,412,398,810,354
3405-000,2014,11,7,8,906,1064,1970,810
3405-000,2014,11,7,9,1205,1169,2374,1970
3405-000,2014,11,7,10,985,908,1893,2374
3405-000,2014,11,7,11,1092,925,2017,1893
3405-000,2014,11,7,12,995,853,1848,2017
3405-000,2014,11,7,13,882,748,1630,1848
3405-000,2014,11,7,14,922,838,1760,1630
3405-000,2014,11,7,15,1110,952,2062,1760
3405-000,2014,11,7,16,1137,951,2088,2062
3405-000,2014,11,7,17,1058,966,2024,2088
3405-000,2014,11,7,18,1210,980,2190,2024
3405-000,2014,11,7,19,1286,920,2206,2190
3405-000,2014,11,7,20,785,629,1414,2206
3405-000,2014,11,7,21,571,507,1078,1414
3405-000,2014,11,7,22,407,385,792,1078
3405-000,2014,11,7,23,278,256,534,792
3405-000,2014,11,7,24,162,144,306,534
3405-000,2014,11,8,1,108,97,205,306
3405-000,2014,11,8,2,74,72,146,205
3405-000,2014,11,8,3,59,60,119,146
3405-000,2014,11,8,4,71,65,136,119
3405-000,2014,11,8,5,95,106,201,136
3405-000,2014,11,8,6,184,164,348,201
3405-000,2014,11,8,7,385,267,652,348
3405-000,2014,11,8,8,651,501,1152,652
3405-000,2014,11,8,9,883,665,1548,1152
3405-000,2014,11,8,10,824,711,1535,1548
3405-000,2014,11,8,11,882,748,1630,1535
3405-000,2014,11,8,12,835,799,1634,1630
3405-000,2014,11,8,13,675,696,1371,1634
3405-000,2014,11,8,14,645,681,1326,1371
3405-000,2014,11,8,15,741,634,1375,1326
3405-000,2014,11,8,16,761,696,1457,1375
3405-000,2014,11,8,17,804,626,1430,1457
3405-000,2014,11,8,18,828,724,1552,1430
3405-000,2014,11,8,19,688,635,1323,1552
3405-000,2014,11,8,20,462,443,905,1323
3405-000,2014,11,8,21,345,362,707,905
3405-000,2014,11,8,22,251,262,513,707
3405-000,2014,11,8,23,175,195,370,513
3405-000,2014,11,8,24,93,97,190,370
3405-000,2014,11,9,1,81,58,139,190
3405-000,2014,11,9,2,44,43,87,139
3405-000,2014,11,9,3,34,38,72,87
3405-000,2014,11,9,4,36,30,66,72
3405-000,2014,11,9,5,39,35,74,66
3405-000,2014,11,9,6,88,57,145,74
3405-000,2014,11,9,7,177,142,319,145
3405-000,2014,11,9,8,280,249,529,319
3405-000,2014,11,9,9,406,304,710,529
3405-000,2014,11,9,10,441,327,768,710
3405-000,2014,11,9,11,482,396,878,768
3405-000,2014,11,9,12,484,421,905,878
3405-000,2014,11,9,13,454,389,843,905
3405-000,2014,11,9,14,451,515,966,843
3405-000,2014,11,9,15,531,553,1084,966
3405-000,2014,11,9,16,549,674,1223,1084
3405-000,2014,11,9,17,554,737,1291,1223
3405-000,2014,11,9,18,578,884,1462,1291
3405-000,2014,11,9,19,541,835,1376,1462
3405-000,2014,11,9,20,389,551,940,1376
3405-000,2014,11,9,21,378,578,956,940
3405-000,2014,11,9,22,272,467,739,956
3405-000,2014,11,9,23,172,325,497,739
3405-000,2014,11,9,24,105,183,288,497
3405-000,2014,11,10,1,65,90,155,288
3405-000,2014,11,10,2,43,67,110,155
3405-000,2014,11,10,3,32,51,83,110
3405-000,2014,11,10,4,44,56,100,83
3405-000,2014,11,10,5,76,92,168,100
3405-000,2014,11,10,6,181,223,404,168
3405-000,2014,11,10,7,454,536,990,404
3405-000,2014,11,10,8,927,1340,2267,990
3405-000,2014,11,10,9,1139,1267,2406,2267
3405-000,2014,11,10,10,950,813,1763,2406
3405-000,2014,11,10,11,994,876,1870,1763
3405-000,2014,11,10,12,895,854,1749,1870
3405-000,2014,11,10,13,740,758,1498,1749
3405-000,2014,11,10,14,802,856,1658,1498
3405-000,2014,11,10,15,1013,987,2000,1658
3405-000,2014,11,10,16,1005,879,1884,2000
3405-000,2014,11,10,17,1034,895,1929,1884
3405-000,2014,11,10,18,1025,947,1972,1929
3405-000,2014,11,10,19,973,891,1864,1972
3405-000,2014,11,10,20,581,623,1204,1864
3405-000,2014,11,10,21,519,504,1023,1204
3405-000,2014,11,10,22,399,361,760,1023
3405-000,2014,11,10,23,235,228,463,760
3405-000,2014,11,10,24,160,162,322,463
3405-000,2014,11,11,1,76,98,174,322
3405-000,2014,11,11,2,66,84,150,174
3405-000,2014,11,11,3,49,64,113,150
3405-000,2014,11,11,4,50,72,122,113
3405-000,2014,11,11,5,83,102,185,122
3405-000,2014,11,11,6,180,187,367,185
3405-000,2014,11,11,7,390,423,813,367
3405-000,2014,11,11,8,866,1032,1898,813
3405-000,2014,11,11,9,1170,1208,2378,1898
3405-000,2014,11,11,10,1030,909,1939,2378
3405-000,2014,11,11,11,1043,917,1960,1939
3405-000,2014,11,11,12,981,902,1883,1960
3405-000,2014,11,11,13,888,770,1658,1883
3405-000,2014,11,11,14,866,879,1745,1658
3405-000,2014,11,11,15,1025,955,1980,1745
3405-000,2014,11,11,16,1035,919,1954,1980
3405-000,2014,11,11,17,1049,929,1978,1954
3405-000,2014,11,11,18,1018,885,1903,1978
3405-000,2014,11,11,19,984,896,1880,1903
3405-000,2014,11,11,20,666,571,1237,1880
3405-000,2014,11,11,21,487,474,961,1237
3405-000,2014,11,11,22,363,383,746,961
3405-000,2014,11,11,23,272,244,516,746
3405-000,2014,11,11,24,165,157,322,516
3405-000,2014,11,12,1,104,120,224,322
3405-000,2014,11,12,2,64,67,131,224
3405-000,2014,11,12,3,43,63,106,131
3405-000,2014,11,12,4,52,56,108,106
3405-000,2014,11,12,5,81,91,172,108
3405-000,2014,11,12,6,156,163,319,172
3405-000,2014,11,12,7,365,364,729,319
3405-000,2014,11,12,8,839,997,1836,729
3405-000,2014,11,12,9,1147,1165,2312,1836
3405-000,2014,11,12,10,1003,900,1903,2312
3405-000,2014,11,12,11,1006,883,1889,1903
3405-000,2014,11,12,12,973,857,1830,1889
3405-000,2014,11,12,13,791,746,1537,1830
3405-000,2014,11,12,14,871,916,1787,1537
3405-000,2014,11,12,15,1008,983,1991,1787
3405-000,2014,11,12,16,979,913,1892,1991
3405-000,2014,11,12,17,1025,900,1925,1892
3405-000,2014,11,12,18,963,921,1884,1925
3405-000,2014,11,12,19,980,890,1870,1884
3405-000,2014,11,12,20,629,563,1192,1870
3405-000,2014,11,12,21,421,426,847,1192
3405-000,2014,11,12,22,365,310,675,847
3405-000,2014,11,12,23,228,212,440,675
3405-000,2014,11,12,24,146,147,293,440
3405-000,2014,11,13,1,92,103,195,293
3405-000,2014,11,13,2,55,80,135,195
3405-000,2014,11,13,3,40,53,93,135
3405-000,2014,11,13,4,55,60,115,93
3405-000,2014,11,13,5,71,99,170,115
3405-000,2014,11,13,6,178,175,353,170
3405-000,2014,11,13,7,375,390,765,353
3405-000,2014,11,13,8,878,1000,1878,765
3405-000,2014,11,13,9,1115,1132,2247,1878
3405-000,2014,11,13,10,978,845,1823,2247
3405-000,2014,11,13,11,1000,870,1870,1823
3405-000,2014,11,13,12,977,884,1861,1870
3405-000,2014,11,13,13,837,743,1580,1861
3405-000,2014,11,13,14,894,895,1789,1580
3405-000,2014,11,13,15,1013,960,1973,1789
3405-000,2014,11,13,16,1016,955,1971,1973
3405-000,2014,11,13,17,1013,894,1907,1971
3405-000,2014,11,13,18,1052,907,1959,1907
3405-000,2014,11,13,19,877,894,1771,1959
3405-000,2014,11,13,20,647,576,1223,1771
3405-000,2014,11,13,21,506,513,1019,1223
3405-000,2014,11,13,22,352,359,711,1019
3405-000,2014,11,13,23,226,222,448,711
3405-000,2014,11,13,24,133,136,269,448
3405-000,2014,11,14,1,72,116,188,269
3405-000,2014,11,14,2,56,84,140,188
3405-000,2014,11,14,3,43,53,96,140
3405-000,2014,11,14,4,53,68,121,96
3405-000,2014,11,14,5,89,96,185,121
3405-000,2014,11,14,6,173,200,373,185
3405-000,2014,11,14,7,419,384,803,373
3405-000,2014,11,14,8,859,1009,1868,803
3405-000,2014,11,14,9,1180,1107,2287,1868
3405-000,2014,11,14,10,1035,872,1907,2287
3405-000,2014,11,14,11,1057,909,1966,1907
3405-000,2014,11,14,12,1030,867,1897,1966
3405-000,2014,11,14,13,856,767,1623,1897
3405-000,2014,11,14,14,894,878,1772,1623
3405-000,2014,11,14,15,1109,965,2074,1772
3405-000,2014,11,14,16,1075,956,2031,2074
3405-000,2014,11,14,17,1135,967,2102,2031
3405-000,2014,11,14,18,1178,1022,2200,2102
3405-000,2014,11,14,19,1399,997,2396,2200
3405-000,2014,11,14,20,859,692,1551,2396
3405-000,2014,11,14,21,623,534,1157,1551
3405-000,2014,11,14,22,435,357,792,1157
3405-000,2014,11,14,23,282,225,507,792
3405-000,2014,11,14,24,165,130,295,507
3405-000,2014,11,15,1,112,126,238,295
3405-000,2014,11,15,2,76,76,152,238
3405-000,2014,11,15,3,56,74,130,152
3405-000,2014,11,15,4,73,63,136,130
3405-000,2014,11,15,5,65,95,160,136
3405-000,2014,11,15,6,184,133,317,160
3405-000,2014,11,15,7,315,304,619,317
3405-000,2014,11,15,8,606,551,1157,619
3405-000,2014,11,15,9,858,692,1550,1157
3405-000,2014,11,15,10,819,695,1514,1550
3405-000,2014,11,15,11,856,890,1746,1514
3405-000,2014,11,15,12,893,759,1652,1746
3405-000,2014,11,15,13,811,633,1444,1652
3405-000,2014,11,15,14,697,700,1397,1444
3405-000,2014,11,15,15,759,740,1499,1397
3405-000,2014,11,15,16,849,710,1559,1499
3405-000,2014,11,15,17,802,773,1575,1559
3405-000,2014,11,15,18,872,931,1803,1575
3405-000,2014,11,15,19,685,894,1579,1803
3405-000,2014,11,15,20,474,639,1113,1579
3405-000,2014,11,15,21,323,452,775,1113
3405-000,2014,11,15,22,255,323,578,775
3405-000,2014,11,15,23,197,212,409,578
3405-000,2014,11,15,24,126,137,263,409
3405-000,2014,11,16,1,90,78,168,263
3405-000,2014,11,16,2,51,57,108,168
3405-000,2014,11,16,3,55,37,92,108
3405-000,2014,11,16,4,25,41,66,92
3405-000,2014,11,16,5,45,34,79,66
3405-000,2014,11,16,6,92,75,167,79
3405-000,2014,11,16,7,174,149,323,167
3405-000,2014,11,16,8,275,250,525,323
3405-000,2014,11,16,9,421,308,729,525
3405-000,2014,11,16,10,447,347,794,729
3405-000,2014,11,16,11,541,417,958,794
3405-000,2014,11,16,12,464,420,884,958
3405-000,2014,11,16,13,448,449,897,884
3405-000,2014,11,16,14,494,481,975,897
3405-000,2014,11,16,15,537,593,1130,975
3405-000,2014,11,16,16,564,714,1278,1130
3405-000,2014,11,16,17,599,759,1358,1278
3405-000,2014,11,16,18,647,863,1510,1358
3405-000,2014,11,16,19,546,849,1395,1510
3405-000,2014,11,16,20,451,550,1001,1395
3405-000,2014,11,16,21,359,612,971,1001
3405-000,2014,11,16,22,278,627,905,971
3405-000,2014,11,16,23,193,297,490,905
3405-000,2014,11,16,24,122,162,284,490
3405-000,2014,11,17,1,57,101,158,284
3405-000,2014,11,17,2,41,56,97,158
3405-000,2014,11,17,3,22,54,76,97
3405-000,2014,11,17,4,47,52,99,76
3405-000,2014,11,17,5,80,105,185,99
3405-000,2014,11,17,6,193,213,406,185
3405-000,2014,11,17,7,406,510,916,406
3405-000,2014,11,17,8,887,1239,2126,916
3405-000,2014,11,17,9,1132,1309,2441,2126
3405-000,2014,11,17,10,935,771,1706,2441
3405-000,2014,11,17,11,991,864,1855,1706
3405-000,2014,11,17,12,980,866,1846,1855
3405-000,2014,11,17,13,791,739,1530,1846
3405-000,2014,11,17,14,790,911,1701,1530
3405-000,2014,11,17,15,1016,903,1919,1701
3405-000,2014,11,17,16,996,890,1886,1919
3405-000,2014,11,17,17,985,888,1873,1886
3405-000,2014,11,17,18,1008,824,1832,1873
3405-000,2014,11,17,19,914,870,1784,1832
3405-000,2014,11,17,20,605,563,1168,1784
3405-000,2014,11,17,21,481,461,942,1168
3405-000,2014,11,17,22,351,402,753,942
3405-000,2014,11,17,23,209,210,419,753
3405-000,2014,11,17,24,145,155,300,419
3405-000,2014,11,18,1,71,100,171,300
3405-000,2014,11,18,2,59,73,132,171
3405-000,2014,11,18,3,41,55,96,132
3405-000,2014,11,18,4,63,84,147,96
3405-000,2014,11,18,5,92,83,175,147
3405-000,2014,11,18,6,163,173,336,175
3405-000,2014,11,18,7,387,349,736,336
3405-000,2014,11,18,8,902,917,1819,736
3405-000,2014,11,18,9,1267,1168,2435,1819
3405-000,2014,11,18,10,1016,909,1925,2435
3405-000,2014,11,18,11,1007,928,1935,1925
3405-000,2014,11,18,12,1052,928,1980,1935
3405-000,2014,11,18,13,771,716,1487,1980
3405-000,2014,11,18,14,858,904,1762,1487
3405-000,2014,11,18,15,1033,974,2007,1762
3405-000,2014,11,18,16,1055,932,1987,2007
3405-000,2014,11,18,17,1016,966,1982,1987
3405-000,2014,11,18,18,1038,869,1907,1982
3405-000,2014,11,18,19,971,854,1825,1907
3405-000,2014,11,18,20,610,579,1189,1825
3405-000,2014,11,18,21,512,501,1013,1189
3405-000,2014,11,18,22,338,342,680,1013
3405-000,2014,11,18,23,240,215,455,680
3405-000,2014,11,18,24,151,155,306,455
3405-000,2014,11,19,1,88,97,185,306
3405-000,2014,11,19,2,46,89,135,185
3405-000,2014,11,19,3,49,47,96,135
3405-000,2014,11,19,4,62,67,129,96
3405-000,2014,11,19,5,87,101,188,129
3405-000,2014,11,19,6,144,179,323,188
3405-000,2014,11,19,7,377,355,732,323
3405-000,2014,11,19,8,891,1021,1912,732
3405-000,2014,11,19,9,1203,1140,2343,1912
3405-000,2014,11,19,10,999,871,1870,2343
3405-000,2014,11,19,11,1046,915,1961,1870
3405-000,2014,11,19,12,967,885,1852,1961
3405-000,2014,11,19,13,817,785,1602,1852
3405-000,2014,11,19,14,884,951,1835,1602
3405-000,2014,11,19,15,988,915,1903,1835
3405-000,2014,11,19,16,1004,916,1920,1903
3405-000,2014,11,19,17,1026,932,1958,1920
3405-000,2014,11,19,18,1104,933,2037,1958
3405-000,2014,11,19,19,998,891,1889,2037
3405-000,2014,11,19,20,601,582,1183,1889
3405-000,2014,11,19,21,518,461,979,1183
3405-000,2014,11,19,22,347,331,678,979
3405-000,2014,11,19,23,232,222,454,678
3405-000,2014,11,19,24,146,143,289,454
3405-000,2014,11,20,1,103,120,223,289
3405-000,2014,11,20,2,45,75,120,223
3405-000,2014,11,20,3,56,63,119,120
3405-000,2014,11,20,4,45,73,118,119
3405-000,2014,11,20,5,78,89,167,118
3405-000,2014,11,20,6,155,172,327,167
3405-000,2014,11,20,7,415,364,779,327
3405-000,2014,11,20,8,891,1051,1942,779
3405-000,2014,11,20,9,1187,1171,2358,1942
3405-000,2014,11,20,10,1040,884,1924,2358
3405-000,2014,11,20,11,991,869,1860,1924
3405-000,2014,11,20,12,980,965,1945,1860
3405-000,2014,11,20,13,843,744,1587,1945
3405-000,2014,11,20,14,892,851,1743,1587
3405-000,2014,11,20,15,983,942,1925,1743
3405-000,2014,11,20,16,1032,904,1936,1925
3405-000,2014,11,20,17,978,894,1872,1936
3405-000,2014,11,20,18,965,937,1902,1872
3405-000,2014,11,20,19,930,859,1789,1902
3405-000,2014,11,20,20,606,575,1181,1789
3405-000,2014,11,20,21,458,460,918,1181
3405-000,2014,11,20,22,381,340,721,918
3405-000,2014,11,20,23,238,204,442,721
3405-000,2014,11,20,24,139,150,289,442
3405-000,2014,11,21,1,97,110,207,289
3405-000,2014,11,21,2,55,71,126,207
3405-000,2014,11,21,3,56,66,122,126
3405-000,2014,11,21,4,54,77,131,122
3405-000,2014,11,21,5,102,95,197,131
3405-000,2014,11,21,6,175,202,377,197
3405-000,2014,11,21,7,399,441,840,377
3405-000,2014,11,21,8,886,1067,1953,840
3405-000,2014,11,21,9,1131,1135,2266,1953
3405-000,2014,11,21,10,1015,902,1917,2266
3405-000,2014,11,21,11,1104,987,2091,1917
3405-000,2014,11,21,12,1029,931,1960,2091
3405-000,2014,11,21,13,919,800,1719,1960
3405-000,2014,11,21,14,898,901,1799,1719
3405-000,2014,11,21,15,1032,977,2009,1799
3405-000,2014,11,21,16,1119,954,2073,2009
3405-000,2014,11,21,17,1086,922,2008,2073
3405-000,2014,11,21,18,1311,978,2289,2008
3405-000,2014,11,21,19,1351,968,2319,2289
3405-000,2014,11,21,20,860,668,1528,2319
3405-000,2014,11,21,21,600,578,1178,1528
3405-000,2014,11,21,22,424,370,794,1178
3405-000,2014,11,21,23,280,209,489,794
3405-000,2014,11,21,24,159,181,340,489
3405-000,2014,11,22,1,107,138,245,340
3405-000,2014,11,22,2,92,76,168,245
3405-000,2014,11,22,3,49,76,125,168
3405-000,2014,11,22,4,60,71,131,125
3405-000,2014,11,22,5,81,101,182,131
3405-000,2014,11,22,6,176,168,344,182
3405-000,2014,11,22,7,354,293,647,344
3405-000,2014,11,22,8,665,522,1187,647
3405-000,2014,11,22,9,876,662,1538,1187
3405-000,2014,11,22,10,850,672,1522,1538
3405-000,2014,11,22,11,842,781,1623,1522
3405-000,2014,11,22,12,896,794,1690,1623
3405-000,2014,11,22,13,764,851,1615,1690
3405-000,2014,11,22,14,846,698,1544,1615
3405-000,2014,11,22,15,934,744,1678,1544
3405-000,2014,11,22,16,912,856,1768,1678
3405-000,2014,11,22,17,1062,862,1924,1768
3405-000,2014,11,22,18,1073,996,2069,1924
3405-000,2014,11,22,19,810,1032,1842,2069
3405-000,2014,11,22,20,460,639,1099,1842
3405-000,2014,11,22,21,350,449,799,1099
3405-000,2014,11,22,22,282,276,558,799
3405-000,2014,11,22,23,177,169,346,558
3405-000,2014,11,22,24,93,99,192,346
3405-000,2014,11,23,1,87,80,167,192
3405-000,2014,11,23,2,39,34,73,167
3405-000,2014,11,23,3,35,31,66,73
3405-000,2014,11,23,4,26,39,65,66
3405-000,2014,11,23,5,41,43,84,65
3405-000,2014,11,23,6,93,73,166,84
3405-000,2014,11,23,7,172,139,311,166
3405-000,2014,11,23,8,272,258,530,311
3405-000,2014,11,23,9,434,281,715,530
3405-000,2014,11,23,10,493,352,845,715
3405-000,2014,11,23,11,522,418,940,845
3405-000,2014,11,23,12,459,442,901,940
3405-000,2014,11,23,13,455,519,974,901
3405-000,2014,11,23,14,506,527,1033,974
3405-000,2014,11,23,15,579,719,1298,1033
3405-000,2014,11,23,16,550,774,1324,1298
3405-000,2014,11,23,17,581,670,1251,1324
3405-000,2014,11,23,18,596,697,1293,1251
3405-000,2014,11,23,19,507,599,1106,1293
3405-000,2014,11,23,20,433,503,936,1106
3405-000,2014,11,23,21,392,569,961,936
3405-000,2014,11,23,22,295,500,795,961
3405-000,2014,11,23,23,234,455,689,795
3405-000,2014,11,23,24,93,216,309,689
3405-000,2014,11,24,1,83,101,184,309
3405-000,2014,11,24,2,44,64,108,184
3405-000,2014,11,24,3,37,47,84,108
3405-000,2014,11,24,4,50,95,145,84
3405-000,2014,11,24,5,77,97,174,145
3405-000,2014,11,24,6,189,200,389,174
3405-000,2014,11,24,7,456,514,970,389
3405-000,2014,11,24,8,911,1331,2242,970
3405-000,2014,11,24,9,1093,1132,2225,2242
3405-000,2014,11,24,10,896,797,1693,2225
3405-000,2014,11,24,11,1001,853,1854,1693
3405-000,2014,11,24,12,812,824,1636,1854
3405-000,2014,11,24,13,719,799,1518,1636
3405-000,2014,11,24,14,818,860,1678,1518
3405-000,2014,11,24,15,974,864,1838,1678
3405-000,2014,11,24,16,926,856,1782,1838
3405-000,2014,11,24,17,967,832,1799,1782
3405-000,2014,11,24,18,930,822,1752,1799
3405-000,2014,11,24,19,880,772,1652,1752
3405-000,2014,11,24,20,554,569,1123,1652
3405-000,2014,11,24,21,485,442,927,1123
3405-000,2014,11,24,22,327,348,675,927
3405-000,2014,11,24,23,208,216,424,675
3405-000,2014,11,24,24,131,145,276,424
3405-000,2014,11,25,1,72,82,154,276
3405-000,2014,11,25,2,58,76,134,154
3405-000,2014,11,25,3,42,57,99,134
3405-000,2014,11,25,4,54,69,123,99
3405-000,2014,11,25,5,90,97,187,123
3405-000,2014,11,25,6,184,168,352,187
3405-000,2014,11,25,7,403,395,798,352
3405-000,2014,11,25,8,911,1093,2004,798
3405-000,2014,11,25,9,1159,1090,2249,2004
3405-000,2014,11,25,10,965,886,1851,2249
3405-000,2014,11,25,11,1009,859,1868,1851
3405-000,2014,11,25,12,935,888,1823,1868
3405-000,2014,11,25,13,811,792,1603,1823
3405-000,2014,11,25,14,946,920,1866,1603
3405-000,2014,11,25,15,1058,988,2046,1866
3405-000,2014,11,25,16,1016,906,1922,2046
3405-000,2014,11,25,17,990,897,1887,1922
3405-000,2014,11,25,18,1040,929,1969,1887
3405-000,2014,11,25,19,900,834,1734,1969
3405-000,2014,11,25,20,530,591,1121,1734
3405-000,2014,11,25,21,454,478,932,1121
3405-000,2014,11,25,22,372,346,718,932
3405-000,2014,11,25,23,260,220,480,718
3405-000,2014,11,25,24,159,170,329,480
3405-000,2014,11,26,1,86,96,182,329
3405-000,2014,11,26,2,62,71,133,182
3405-000,2014,11,26,3,50,60,110,133
3405-000,2014,11,26,4,59,67,126,110
3405-000,2014,11,26,5,88,95,183,126
3405-000,2014,11,26,6,175,179,354,183
3405-000,2014,11,26,7,457,413,870,354
3405-000,2014,11,26,8,915,1084,1999,870
3405-000,2014,11,26,9,1117,1187,2304,1999
3405-000,2014,11,26,10,984,858,1842,2304
3405-000,2014,11,26,11,988,853,1841,1842
3405-000,2014,11,26,12,933,883,1816,1841
3405-000,2014,11,26,13,800,804,1604,1816
3405-000,2014,11,26,14,860,890,1750,1604
3405-000,2014,11,26,15,990,938,1928,1750
3405-000,2014,11,26,16,1024,949,1973,1928
3405-000,2014,11,26,17,1051,859,1910,1973
3405-000,2014,11,26,18,1094,990,2084,1910
3405-000,2014,11,26,19,1203,893,2096,2084
3405-000,2014,11,26,20,582,525,1107,2096
3405-000,2014,11,26,21,445,414,859,1107
3405-000,2014,11,26,22,318,347,665,859
3405-000,2014,11,26,23,231,204,435,665
3405-000,2014,11,26,24,168,173,341,435
3405-000,2014,11,27,1,94,109,203,341
3405-000,2014,11,27,2,63,70,133,203
3405-000,2014,11,27,3,30,66,96,133
3405-000,2014,11,27,4,57,78,135,96
3405-000,2014,11,27,5,96,96,192,135
3405-000,2014,11,27,6,175,161,336,192
3405-000,2014,11,27,7,425,419,844,336
3405-000,2014,11,27,8,903,1131,2034,844
3405-000,2014,11,27,9,1198,1114,2312,2034
3405-000,2014,11,27,10,1039,855,1894,2312
3405-000,2014,11,27,11,1046,976,2022,1894
3405-000,2014,11,27,12,1008,809,1817,2022
3405-000,2014,11,27,13,786,754,1540,1817
3405-000,2014,11,27,14,903,905,1808,1540
3405-000,2014,11,27,15,1006,964,1970,1808
3405-000,2014,11,27,16,1003,842,1845,1970
3405-000,2014,11,27,17,1025,910,1935,1845
3405-000,2014,11,27,18,1066,945,2011,1935
3405-000,2014,11,27,19,1006,860,1866,2011
3405-000,2014,11,27,20,619,585,1204,1866
3405-000,2014,11,27,21,521,437,958,1204
3405-000,2014,11,27,22,362,408,770,958
3405-000,2014,11,27,23,235,221,456,770
3405-000,2014,11,27,24,163,168,331,456
3405-000,2014,11,28,1,116,85,201,331
3405-000,2014,11,28,2,60,89,149,201
3405-000,2014,11,28,3,53,63,116,149
3405-000,2014,11,28,4,64,79,143,116
3405-000,2014,11,28,5,97,106,203,143
3405-000,2014,11,28,6,193,169,362,203
3405-000,2014,11,28,7,381,367,748,362
3405-000,2014,11,28,8,893,995,1888,748
3405-000,2014,11,28,9,1097,1080,2177,1888
3405-000,2014,11,28,10,988,858,1846,2177
3405-000,2014,11,28,11,927,817,1744,1846
3405-000,2014,11,28,12,849,812,1661,1744
3405-000,2014,11,28,13,833,779,1612,1661
3405-000,2014,11,28,14,1033,888,1921,1612
3405-000,2014,11,28,15,958,842,1800,1921
3405-000,2014,11,28,16,959,831,1790,1800
3405-000,2014,11,28,17,1018,855,1873,1790
3405-000,2014,11,28,18,1149,883,2032,1873
3405-000,2014,11,28,19,1157,910,2067,2032
3405-000,2014,11,28,20,708,603,1311,2067
3405-000,2014,11,28,21,558,475,1033,1311
3405-000,2014,11,28,22,387,320,707,1033
3405-000,2014,11,28,23,292,222,514,707
3405-000,2014,11,28,24,155,151,306,514
3405-000,2014,11,29,1,102,122,224,306
3405-000,2014,11,29,2,73,76,149,224
3405-000,2014,11,29,3,55,56,111,149
3405-000,2014,11,29,4,51,66,117,111
3405-000,2014,11,29,5,79,80,159,117
3405-000,2014,11,29,6,175,136,311,159
3405-000,2014,11,29,7,356,287,643,311
3405-000,2014,11,29,8,598,551,1149,643
3405-000,2014,11,29,9,820,646,1466,1149
3405-000,2014,11,29,10,807,657,1464,1466
3405-000,2014,11,29,11,852,722,1574,1464
3405-000,2014,11,29,12,952,843,1795,1574
3405-000,2014,11,29,13,838,791,1629,1795
3405-000,2014,11,29,14,795,717,1512,1629
3405-000,2014,11,29,15,882,695,1577,1512
3405-000,2014,11,29,16,811,783,1594,1577
3405-000,2014,11,29,17,859,724,1583,1594
3405-000,2014,11,29,18,859,952,1811,1583
3405-000,2014,11,29,19,725,763,1488,1811
3405-000,2014,11,29,20,515,543,1058,1488
3405-000,2014,11,29,21,349,369,718,1058
3405-000,2014,11,29,22,265,258,523,718
3405-000,2014,11,29,23,179,184,363,523
3405-000,2014,11,29,24,114,132,246,363
3405-000,2014,11,30,1,79,72,151,246
3405-000,2014,11,30,2,60,54,114,151
3405-000,2014,11,30,3,38,43,81,114
3405-000,2014,11,30,4,43,49,92,81
3405-000,2014,11,30,5,49,39,88,92
3405-000,2014,11,30,6,102,62,164,88
3405-000,2014,11,30,7,133,124,257,164
3405-000,2014,11,30,8,221,200,421,257
3405-000,2014,11,30,9,310,277,587,421
3405-000,2014,11,30,10,387,253,640,587
3405-000,2014,11,30,11,394,392,786,640
3405-000,2014,11,30,12,405,410,815,786
3405-000,2014,11,30,13,451,423,874,815
3405-000,2014,11,30,14,480,460,940,874
3405-000,2014,11,30,15,536,555,1091,940
3405-000,2014,11,30,16,521,656,1177,1091
3405-000,2014,11,30,17,536,720,1256,1177
3405-000,2014,11,30,18,565,669,1234,1256
3405-000,2014,11,30,19,443,702,1145,1234
3405-000,2014,11,30,20,364,647,1011,1145
3405-000,2014,11,30,21,342,385,727,1011
3405-000,2014,11,30,22,256,348,604,727
3405-000,2014,11,30,23,200,307,507,604
3405-000,2014,11,30,24,97,162,259,507
3405-000,2014,12,1,1,66,99,165,259
3405-000,2014,12,1,2,46,71,117,165
3405-000,2014,12,1,3,24,76,100,117
3405-000,2014,12,1,4,44,58,102,100
3405-000,2014,12,1,5,85,100,185,102
3405-000,2014,12,1,6,187,193,380,185
3405-000,2014,12,1,7,446,491,937,380
3405-000,2014,12,1,8,913,1298,2211,937
3405-000,2014,12,1,9,1041,1075,2116,2211
3405-000,2014,12,1,10,802,746,1548,2116
3405-000,2014,12,1,11,754,738,1492,1548
3405-000,2014,12,1,12,711,752,1463,1492
3405-000,2014,12,1,13,719,642,1361,1463
3405-000,2014,12,1,14,715,775,1490,1361
3405-000,2014,12,1,15,823,869,1692,1490
3405-000,2014,12,1,16,830,833,1663,1692
3405-000,2014,12,1,17,868,700,1568,1663
3405-000,2014,12,1,18,886,744,1630,1568
3405-000,2014,12,1,19,727,729,1456,1630
3405-000,2014,12,1,20,447,495,942,1456
3405-000,2014,12,1,21,381,399,780,942
3405-000,2014,12,1,22,250,274,524,780
3405-000,2014,12,1,23,183,185,368,524
3405-000,2014,12,1,24,104,123,227,368
3405-000,2014,12,2,1,84,77,161,227
3405-000,2014,12,2,2,63,63,126,161
3405-000,2014,12,2,3,37,59,96,126
3405-000,2014,12,2,4,60,66,126,96
3405-000,2014,12,2,5,63,77,140,126
3405-000,2014,12,2,6,133,134,267,140
3405-000,2014,12,2,7,379,318,697,267
3405-000,2014,12,2,8,792,945,1737,697
3405-000,2014,12,2,9,1009,973,1982,1737
3405-000,2014,12,2,10,847,769,1616,1982
3405-000,2014,12,2,11,885,839,1724,1616
3405-000,2014,12,2,12,943,816,1759,1724
3405-000,2014,12,2,13,760,708,1468,1759
3405-000,2014,12,2,14,770,813,1583,1468
3405-000,2014,12,2,15,956,861,1817,1583
3405-000,2014,12,2,16,1012,907,1919,1817
3405-000,2014,12,2,17,956,813,1769,1919
3405-000,2014,12,2,18,1003,845,1848,1769
3405-000,2014,12,2,19,904,765,1669,1848
3405-000,2014,12,2,20,514,535,1049,1669
3405-000,2014,12,2,21,396,433,829,1049
3405-000,2014,12,2,22,297,371,668,829
3405-000,2014,12,2,23,200,177,377,668
3405-000,2014,12,2,24,142,140,282,377
3405-000,2014,12,3,1,77,70,147,282
3405-000,2014,12,3,2,59,67,126,147
3405-000,2014,12,3,3,32,48,80,126
3405-000,2014,12,3,4,49,52,101,80
3405-000,2014,12,3,5,37,48,85,101
3405-000,2014,12,3,6,118,70,188,85
3405-000,2014,12,3,7,270,168,438,188
3405-000,2014,12,3,8,618,724,1342,438
3405-000,2014,12,3,9,779,834,1613,1342
3405-000,2014,12,3,10,775,657,1432,1613
3405-000,2014,12,3,11,764,768,1532,1432
3405-000,2014,12,3,12,819,748,1567,1532
3405-000,2014,12,3,13,727,717,1444,1567
3405-000,2014,12,3,14,754,835,1589,1444
3405-000,2014,12,3,15,849,819,1668,1589
3405-000,2014,12,3,16,930,771,1701,1668
3405-000,2014,12,3,17,888,797,1685,1701
3405-000,2014,12,3,18,800,768,1568,1685
3405-000,2014,12,3,19,728,727,1455,1568
3405-000,2014,12,3,20,452,453,905,1455
3405-000,2014,12,3,21,327,332,659,905
3405-000,2014,12,3,22,260,257,517,659
3405-000,2014,12,3,23,164,183,347,517
3405-000,2014,12,3,24,91,113,204,347
3405-000,2014,12,4,1,71,59,130,204
3405-000,2014,12,4,2,54,60,114,130
3405-000,2014,12,4,3,38,61,99,114
3405-000,2014,12,4,4,33,49,82,99
3405-000,2014,12,4,5,43,56,99,82
3405-000,2014,12,4,6,126,126,252,99
3405-000,2014,12,4,7,296,260,556,252
3405-000,2014,12,4,8,681,792,1473,556
3405-000,2014,12,4,9,875,909,1784,1473
3405-000,2014,12,4,10,731,714,1445,1784
3405-000,2014,12,4,11,876,776,1652,1445
3405-000,2014,12,4,12,826,788,1614,1652
3405-000,2014,12,4,13,711,698,1409,1614
3405-000,2014,12,4,14,825,837,1662,1409
3405-000,2014,12,4,15,972,854,1826,1662
3405-000,2014,12,4,16,961,837,1798,1826
3405-000,2014,12,4,17,875,831,1706,1798
3405-000,2014,12,4,18,958,834,1792,1706
3405-000,2014,12,4,19,801,771,1572,1792
3405-000,2014,12,4,20,456,483,939,1572
3405-000,2014,12,4,21,435,391,826,939
3405-000,2014,12,4,22,278,305,583,826
3405-000,2014,12,4,23,171,182,353,583
3405-000,2014,12,4,24,98,104,202,353
3405-000,2014,12,5,1,80,75,155,202
3405-000,2014,12,5,2,47,72,119,155
3405-000,2014,12,5,3,33,45,78,119
3405-000,2014,12,5,4,51,54,105,78
3405-000,2014,12,5,5,64,63,127,105
3405-000,2014,12,5,6,120,146,266,127
3405-000,2014,12,5,7,343,273,616,266
3405-000,2014,12,5,8,700,895,1595,616
3405-000,2014,12,5,9,922,905,1827,1595
3405-000,2014,12,5,10,794,737,1531,1827
3405-000,2014,12,5,11,773,844,1617,1531
3405-000,2014,12,5,12,782,779,1561,1617
3405-000,2014,12,5,13,680,711,1391,1561
3405-000,2014,12,5,14,732,804,1536,1391
3405-000,2014,12,5,15,830,938,1768,1536
3405-000,2014,12,5,16,919,922,1841,1768
3405-000,2014,12,5,17,933,806,1739,1841
3405-000,2014,12,5,18,1010,889,1899,1739
3405-000,2014,12,5,19,1090,870,1960,1899
3405-000,2014,12,5,20,671,582,1253,1960
3405-000,2014,12,5,21,465,408,873,1253
3405-000,2014,12,5,22,351,300,651,873
3405-000,2014,12,5,23,218,179,397,651
3405-000,2014,12,5,24,120,155,275,397
3405-000,2014,12,6,1,87,102,189,275
3405-000,2014,12,6,2,54,87,141,189
3405-000,2014,12,6,3,46,60,106,141
3405-000,2014,12,6,4,41,62,103,106
3405-000,2014,12,6,5,55,65,120,103
3405-000,2014,12,6,6,107,105,212,120
3405-000,2014,12,6,7,244,222,466,212
3405-000,2014,12,6,8,540,422,962,466
3405-000,2014,12,6,9,708,523,1231,962
3405-000,2014,12,6,10,690,535,1225,1231
3405-000,2014,12,6,11,734,660,1394,1225
3405-000,2014,12,6,12,738,790,1528,1394
3405-000,2014,12,6,13,723,855,1578,1528
3405-000,2014,12,6,14,679,634,1313,1578
3405-000,2014,12,6,15,729,642,1371,1313
3405-000,2014,12,6,16,713,735,1448,1371
3405-000,2014,12,6,17,749,604,1353,1448
3405-000,2014,12,6,18,777,639,1416,1353
3405-000,2014,12,6,19,543,509,1052,1416
3405-000,2014,12,6,20,370,348,718,1052
3405-000,2014,12,6,21,244,244,488,718
3405-000,2014,12,6,22,208,196,404,488
3405-000,2014,12,6,23,136,156,292,404
3405-000,2014,12,6,24,94,105,199,292
3405-000,2014,12,7,1,70,76,146,199
3405-000,2014,12,7,2,44,51,95,146
3405-000,2014,12,7,3,27,36,63,95
3405-000,2014,12,7,4,28,39,67,63
3405-000,2014,12,7,5,40,32,72,67
3405-000,2014,12,7,6,51,58,109,72
3405-000,2014,12,7,7,107,106,213,109
3405-000,2014,12,7,8,199,182,381,213
3405-000,2014,12,7,9,256,189,445,381
3405-000,2014,12,7,10,342,272,614,445
3405-000,2014,12,7,11,374,326,700,614
3405-000,2014,12,7,12,372,425,797,700
3405-000,2014,12,7,13,386,428,814,797
3405-000,2014,12,7,14,424,436,860,814
3405-000,2014,12,7,15,460,492,952,860
3405-000,2014,12,7,16,473,493,966,952
3405-000,2014,12,7,17,492,534,1026,966
3405-000,2014,12,7,18,514,568,1082,1026
3405-000,2014,12,7,19,395,466,861,1082
3405-000,2014,12,7,20,298,388,686,861
3405-000,2014,12,7,21,282,309,591,686
3405-000,2014,12,7,22,235,312,547,591
3405-000,2014,12,7,23,158,256,414,547
3405-000,2014,12,7,24,121,165,286,414
3405-000,2014,12,8,1,60,101,161,286
3405-000,2014,12,8,2,37,77,114,161
3405-000,2014,12,8,3,30,48,78,114
3405-000,2014,12,8,4,34,46,80,78
3405-000,2014,12,8,5,58,60,118,80
3405-000,2014,12,8,6,153,146,299,118
3405-000,2014,12,8,7,383,366,749,299
3405-000,2014,12,8,8,800,1105,1905,749
3405-000,2014,12,8,9,958,1088,2046,1905
3405-000,2014,12,8,10,832,689,1521,2046
3405-000,2014,12,8,11,879,783,1662,1521
3405-000,2014,12,8,12,829,764,1593,1662
3405-000,2014,12,8,13,756,677,1433,1593
3405-000,2014,12,8,14,818,816,1634,1433
3405-000,2014,12,8,15,905,904,1809,1634
3405-000,2014,12,8,16,854,837,1691,1809
3405-000,2014,12,8,17,863,815,1678,1691
3405-000,2014,12,8,18,944,848,1792,1678
3405-000,2014,12,8,19,816,775,1591,1792
3405-000,2014,12,8,20,535,563,1098,1591
3405-000,2014,12,8,21,381,440,821,1098
3405-000,2014,12,8,22,337,322,659,821
3405-000,2014,12,8,23,187,193,380,659
3405-000,2014,12,8,24,113,146,259,380
3405-000,2014,12,9,1,67,122,189,259
3405-000,2014,12,9,2,47,86,133,189
3405-000,2014,12,9,3,35,41,76,133
3405-000,2014,12,9,4,52,65,117,76
3405-000,2014,12,9,5,81,89,170,117
3405-000,2014,12,9,6,160,170,330,170
3405-000,2014,12,9,7,382,333,715,330
3405-000,2014,12,9,8,814,997,1811,715
3405-000,2014,12,9,9,1082,1061,2143,1811
3405-000,2014,12,9,10,909,812,1721,2143
3405-000,2014,12,9,11,987,879,1866,1721
3405-000,2014,12,9,12,907,846,1753,1866
3405-000,2014,12,9,13,764,706,1470,1753
3405-000,2014,12,9,14,831,824,1655,1470
3405-000,2014,12,9,15,925,929,1854,1655
3405-000,2014,12,9,16,1018,869,1887,1854
3405-000,2014,12,9,17,1001,845,1846,1887
3405-000,2014,12,9,18,1055,853,1908,1846
3405-000,2014,12,9,19,986,799,1785,1908
3405-000,2014,12,9,20,574,583,1157,1785
3405-000,2014,12,9,21,434,438,872,1157
3405-000,2014,12,9,22,317,328,645,872
3405-000,2014,12,9,23,208,202,410,645
3405-000,2014,12,9,24,136,165,301,410
3405-000,2014,12,10,1,83,120,203,301
3405-000,2014,12,10,2,52,68,120,203
3405-000,2014,12,10,3,37,47,84,120
3405-000,2014,12,10,4,45,55,100,84
3405-000,2014,12,10,5,88,72,160,100
3405-000,2014,12,10,6,146,167,313,160
3405-000,2014,12,10,7,366,344,710,313
3405-000,2014,12,10,8,834,1029,1863,710
3405-000,2014,12,10,9,1101,1138,2239,1863
3405-000,2014,12,10,10,1004,837,1841,2239
3405-000,2014,12,10,11,954,877,1831,1841
3405-000,2014,12,10,12,951,864,1815,1831
3405-000,2014,12,10,13,786,738,1524,1815
3405-000,2014,12,10,14,889,881,1770,1524
3405-000,2014,12,10,15,947,921,1868,1770
3405-000,2014,12,10,16,939,899,1838,1868
3405-000,2014,12,10,17,938,881,1819,1838
3405-000,2014,12,10,18,1063,868,1931,1819
3405-000,2014,12,10,19,945,842,1787,1931
3405-000,2014,12,10,20,542,516,1058,1787
3405-000,2014,12,10,21,423,448,871,1058
3405-000,2014,12,10,22,312,317,629,871
3405-000,2014,12,10,23,235,218,453,629
3405-000,2014,12,10,24,139,144,283,453
3405-000,2014,12,11,1,93,112,205,283
3405-000,2014,12,11,2,53,75,128,205
3405-000,2014,12,11,3,39,46,85,128
3405-000,2014,12,11,4,37,57,94,85
3405-000,2014,12,11,5,77,68,145,94
3405-000,2014,12,11,6,157,124,281,145
3405-000,2014,12,11,7,357,344,701,281
3405-000,2014,12,11,8,796,955,1751,701
3405-000,2014,12,11,9,1115,1080,2195,1751
3405-000,2014,12,11,10,956,802,1758,2195
3405-000,2014,12,11,11,903,882,1785,1758
3405-000,2014,12,11,12,911,790,1701,1785
3405-000,2014,12,11,13,772,775,1547,1701
3405-000,2014,12,11,14,897,837,1734,1547
3405-000,2014,12,11,15,966,929,1895,1734
3405-000,2014,12,11,16,960,911,1871,1895
3405-000,2014,12,11,17,969,879,1848,1871
3405-000,2014,12,11,18,1008,867,1875,1848
3405-000,2014,12,11,19,885,779,1664,1875
3405-000,2014,12,11,20,541,522,1063,1664
3405-000,2014,12,11,21,438,422,860,1063
3405-000,2014,12,11,22,323,341,664,860
3405-000,2014,12,11,23,250,231,481,664
3405-000,2014,12,11,24,138,157,295,481
3405-000,2014,12,12,1,78,115,193,295
3405-000,2014,12,12,2,58,78,136,193
3405-000,2014,12,12,3,53,57,110,136
3405-000,2014,12,12,4,48,63,111,110
3405-000,2014,12,12,5,78,84,162,111
3405-000,2014,12,12,6,157,127,284,162
3405-000,2014,12,12,7,367,320,687,284
3405-000,2014,12,12,8,816,1014,1830,687
3405-000,2014,12,12,9,1071,1124,2195,1830
3405-000,2014,12,12,10,890,811,1701,2195
3405-000,2014,12,12,11,1008,939,1947,1701
3405-000,2014,12,12,12,924,857,1781,1947
3405-000,2014,12,12,13,809,757,1566,1781
3405-000,2014,12,12,14,879,832,1711,1566
3405-000,2014,12,12,15,1063,954,2017,1711
3405-000,2014,12,12,16,1111,981,2092,2017
3405-000,2014,12,12,17,1066,866,1932,2092
3405-000,2014,12,12,18,1063,921,1984,1932
3405-000,2014,12,12,19,1138,814,1952,1984
3405-000,2014,12,12,20,942,560,1502,1952
3405-000,2014,12,12,21,449,416,865,1502
3405-000,2014,12,12,22,306,270,576,865
3405-000,2014,12,12,23,210,154,364,576
3405-000,2014,12,12,24,133,126,259,364
3405-000,2014,12,13,1,84,86,170,259
3405-000,2014,12,13,2,53,44,97,170
3405-000,2014,12,13,3,35,65,100,97
3405-000,2014,12,13,4,48,54,102,100
3405-000,2014,12,13,5,50,61,111,102
3405-000,2014,12,13,6,99,83,182,111
3405-000,2014,12,13,7,168,160,328,182
3405-000,2014,12,13,8,381,311,692,328
3405-000,2014,12,13,9,596,461,1057,692
3405-000,2014,12,13,10,597,536,1133,1057
3405-000,2014,12,13,11,649,689,1338,1133
3405-000,2014,12,13,12,679,762,1441,1338
3405-000,2014,12,13,13,584,655,1239,1441
3405-000,2014,12,13,14,612,544,1156,1239
3405-000,2014,12,13,15,665,528,1193,1156
3405-000,2014,12,13,16,697,613,1310,1193
3405-000,2014,12,13,17,667,596,1263,1310
3405-000,2014,12,13,18,766,662,1428,1263
3405-000,2014,12,13,19,563,487,1050,1428
3405-000,2014,12,13,20,301,327,628,1050
3405-000,2014,12,13,21,243,221,464,628
3405-000,2014,12,13,22,220,174,394,464
3405-000,2014,12,13,23,196,145,341,394
3405-000,2014,12,13,24,68,116,184,341
3405-000,2014,12,14,1,71,57,128,184
3405-000,2014,12,14,2,44,57,101,128
3405-000,2014,12,14,3,34,40,74,101
3405-000,2014,12,14,4,37,43,80,74
3405-000,2014,12,14,5,25,47,72,80
3405-000,2014,12,14,6,56,48,104,72
3405-000,2014,12,14,7,107,92,199,104
3405-000,2014,12,14,8,184,157,341,199
3405-000,2014,12,14,9,282,257,539,341
3405-000,2014,12,14,10,321,267,588,539
3405-000,2014,12,14,11,448,339,787,588
3405-000,2014,12,14,12,445,415,860,787
3405-000,2014,12,14,13,407,388,795,860
3405-000,2014,12,14,14,410,454,864,795
3405-000,2014,12,14,15,437,476,913,864
3405-000,2014,12,14,16,547,597,1144,913
3405-000,2014,12,14,17,531,577,1108,1144
3405-000,2014,12,14,18,459,549,1008,1108
3405-000,2014,12,14,19,333,501,834,1008
3405-000,2014,12,14,20,277,368,645,834
3405-000,2014,12,14,21,253,288,541,645
3405-000,2014,12,14,22,178,250,428,541
3405-000,2014,12,14,23,111,212,323,428
3405-000,2014,12,14,24,72,127,199,323
3405-000,2014,12,15,1,33,86,119,199
3405-000,2014,12,15,2,33,66,99,119
3405-000,2014,12,15,3,27,41,68,99
3405-000,2014,12,15,4,50,43,93,68
3405-000,2014,12,15,5,68,72,140,93
3405-000,2014,12,15,6,155,206,361,140
3405-000,2014,12,15,7,408,425,833,361
3405-000,2014,12,15,8,843,1183,2026,833
3405-000,2014,12,15,9,1066,1150,2216,2026
3405-000,2014,12,15,10,860,794,1654,2216
3405-000,2014,12,15,11,996,863,1859,1654
3405-000,2014,12,15,12,916,888,1804,1859
3405-000,2014,12,15,13,783,759,1542,1804
3405-000,2014,12,15,14,827,830,1657,1542
3405-000,2014,12,15,15,988,906,1894,1657
3405-000,2014,12,15,16,919,885,1804,1894
3405-000,2014,12,15,17,950,821,1771,1804
3405-000,2014,12,15,18,925,823,1748,1771
3405-000,2014,12,15,19,812,803,1615,1748
3405-000,2014,12,15,20,521,504,1025,1615
3405-000,2014,12,15,21,398,440,838,1025
3405-000,2014,12,15,22,319,332,651,838
3405-000,2014,12,15,23,196,196,392,651
3405-000,2014,12,15,24,130,140,270,392
3405-000,2014,12,16,1,73,96,169,270
3405-000,2014,12,16,2,49,87,136,169
3405-000,2014,12,16,3,46,50,96,136
3405-000,2014,12,16,4,52,56,108,96
3405-000,2014,12,16,5,56,64,120,108
3405-000,2014,12,16,6,122,131,253,120
3405-000,2014,12,16,7,303,252,555,253
3405-000,2014,12,16,8,774,850,1624,555
3405-000,2014,12,16,9,1050,979,2029,1624
3405-000,2014,12,16,10,831,756,1587,2029
3405-000,2014,12,16,11,863,833,1696,1587
3405-000,2014,12,16,12,907,1028,1935,1696
3405-000,2014,12,16,13,722,933,1655,1935
3405-000,2014,12,16,14,822,992,1814,1655
3405-000,2014,12,16,15,908,945,1853,1814
3405-000,2014,12,16,16,904,891,1795,1853
3405-000,2014,12,16,17,942,857,1799,1795
3405-000,2014,12,16,18,934,850,1784,1799
3405-000,2014,12,16,19,835,825,1660,1784
3405-000,2014,12,16,20,492,466,958,1660
3405-000,2014,12,16,21,427,417,844,958
3405-000,2014,12,16,22,312,330,642,844
3405-000,2014,12,16,23,190,192,382,642
3405-000,2014,12,16,24,141,134,275,382
3405-000,2014,12,17,1,86,115,201,275
3405-000,2014,12,17,2,51,68,119,201
3405-000,2014,12,17,3,31,52,83,119
3405-000,2014,12,17,4,51,55,106,83
3405-000,2014,12,17,5,55,77,132,106
3405-000,2014,12,17,6,116,120,236,132
3405-000,2014,12,17,7,337,287,624,236
3405-000,2014,12,17,8,766,942,1708,624
3405-000,2014,12,17,9,1049,1015,2064,1708
3405-000,2014,12,17,10,905,764,1669,2064
3405-000,2014,12,17,11,855,849,1704,1669
3405-000,2014,12,17,12,867,852,1719,1704
3405-000,2014,12,17,13,768,655,1423,1719
3405-000,2014,12,17,14,836,854,1690,1423
3405-000,2014,12,17,15,912,944,1856,1690
3405-000,2014,12,17,16,931,838,1769,1856
3405-000,2014,12,17,17,889,819,1708,1769
3405-000,2014,12,17,18,975,853,1828,1708
3405-000,2014,12,17,19,825,778,1603,1828
3405-000,2014,12,17,20,548,501,1049,1603
3405-000,2014,12,17,21,433,433,866,1049
3405-000,2014,12,17,22,291,301,592,866
3405-000,2014,12,17,23,241,184,425,592
3405-000,2014,12,17,24,142,138,280,425
3405-000,2014,12,18,1,75,82,157,280
3405-000,2014,12,18,2,50,69,119,157
3405-000,2014,12,18,3,29,58,87,119
3405-000,2014,12,18,4,43,39,82,87
3405-000,2014,12,18,5,75,84,159,82
3405-000,2014,12,18,6,148,151,299,159
3405-000,2014,12,18,7,341,309,650,299
3405-000,2014,12,18,8,795,982,1777,650
3405-000,2014,12,18,9,1058,1060,2118,1777
3405-000,2014,12,18,10,896,780,1676,2118
3405-000,2014,12,18,11,870,795,1665,1676
3405-000,2014,12,18,12,884,851,1735,1665
3405-000,2014,12,18,13,776,782,1558,1735
3405-000,2014,12,18,14,897,850,1747,1558
3405-000,2014,12,18,15,933,905,1838,1747
3405-000,2014,12,18,16,978,875,1853,1838
3405-000,2014,12,18,17,998,849,1847,1853
3405-000,2014,12,18,18,1022,887,1909,1847
3405-000,2014,12,18,19,874,772,1646,1909
3405-000,2014,12,18,20,575,523,1098,1646
3405-000,2014,12,18,21,440,463,903,1098
3405-000,2014,12,18,22,325,320,645,903
3405-000,2014,12,18,23,222,199,421,645
3405-000,2014,12,18,24,123,130,253,421
3405-000,2014,12,19,1,93,93,186,253
3405-000,2014,12,19,2,69,84,153,186
3405-000,2014,12,19,3,40,53,93,153
3405-000,2014,12,19,4,49,66,115,93
3405-000,2014,12,19,5,79,88,167,115
3405-000,2014,12,19,6,144,151,295,167
3405-000,2014,12,19,7,348,325,673,295
3405-000,2014,12,19,8,812,985,1797,673
3405-000,2014,12,19,9,1087,1066,2153,1797
3405-000,2014,12,19,10,928,815,1743,2153
3405-000,2014,12,19,11,934,878,1812,1743
3405-000,2014,12,19,12,1029,877,1906,1812
3405-000,2014,12,19,13,867,793,1660,1906
3405-000,2014,12,19,14,933,833,1766,1660
3405-000,2014,12,19,15,1038,885,1923,1766
3405-000,2014,12,19,16,1020,938,1958,1923
3405-000,2014,12,19,17,1046,765,1811,1958
3405-000,2014,12,19,18,1080,972,2052,1811
3405-000,2014,12,19,19,1301,915,2216,2052
3405-000,2014,12,19,20,773,587,1360,2216
3405-000,2014,12,19,21,498,444,942,1360
3405-000,2014,12,19,22,391,315,706,942
3405-000,2014,12,19,23,245,202,447,706
3405-000,2014,12,19,24,168,139,307,447
3405-000,2014,12,20,1,101,93,194,307
3405-000,2014,12,20,2,85,85,170,194
3405-000,2014,12,20,3,59,56,115,170
3405-000,2014,12,20,4,47,54,101,115
3405-000,2014,12,20,5,57,62,119,101
3405-000,2014,12,20,6,119,108,227,119
3405-000,2014,12,20,7,246,189,435,227
3405-000,2014,12,20,8,507,391,898,435
3405-000,2014,12,20,9,714,513,1227,898
3405-000,2014,12,20,10,741,521,1262,1227
3405-000,2014,12,20,11,745,582,1327,1262
3405-000,2014,12,20,12,789,679,1468,1327
3405-000,2014,12,20,13,678,654,1332,1468
3405-000,2014,12,20,14,702,656,1358,1332
3405-000,2014,12,20,15,723,618,1341,1358
3405-000,2014,12,20,16,655,634,1289,1341
3405-000,2014,12,20,17,705,702,1407,1289
3405-000,2014,12,20,18,748,748,1496,1407
3405-000,2014,12,20,19,624,605,1229,1496
3405-000,2014,12,20,20,360,325,685,1229
3405-000,2014,12,20,21,311,271,582,685
3405-000,2014,12,20,22,255,237,492,582
3405-000,2014,12,20,23,142,158,300,492
3405-000,2014,12,20,24,100,123,223,300
3405-000,2014,12,21,1,66,78,144,223
3405-000,2014,12,21,2,51,50,101,144
3405-000,2014,12,21,3,49,38,87,101
3405-000,2014,12,21,4,26,39,65,87
3405-000,2014,12,21,5,41,48,89,65
3405-000,2014,12,21,6,51,61,112,89
3405-000,2014,12,21,7,90,105,195,112
3405-000,2014,12,21,8,209,200,409,195
3405-000,2014,12,21,9,289,242,531,409
3405-000,2014,12,21,10,338,270,608,531
3405-000,2014,12,21,11,407,364,771,608
3405-000,2014,12,21,12,415,414,829,771
3405-000,2014,12,21,13,393,442,835,829
3405-000,2014,12,21,14,430,432,862,835
3405-000,2014,12,21,15,466,519,985,862
3405-000,2014,12,21,16,503,602,1105,985
3405-000,2014,12,21,17,491,632,1123,1105
3405-000,2014,12,21,18,525,518,1043,1123
3405-000,2014,12,21,19,355,438,793,1043
3405-000,2014,12,21,20,240,317,557,793
3405-000,2014,12,21,21,209,266,475,557
3405-000,2014,12,21,22,207,248,455,475
3405-000,2014,12,21,23,123,214,337,455
3405-000,2014,12,21,24,84,149,233,337
3405-000,2014,12,22,1,57,81,138,233
3405-000,2014,12,22,2,40,55,95,138
3405-000,2014,12,22,3,18,36,54,95
3405-000,2014,12,22,4,38,59,97,54
3405-000,2014,12,22,5,63,79,142,97
3405-000,2014,12,22,6,153,158,311,142
3405-000,2014,12,22,7,355,431,786,311
3405-000,2014,12,22,8,745,1137,1882,786
3405-000,2014,12,22,9,935,1127,2062,1882
3405-000,2014,12,22,10,761,612,1373,2062
3405-000,2014,12,22,11,692,564,1256,1373
3405-000,2014,12,22,12,650,600,1250,1256
3405-000,2014,12,22,13,590,588,1178,1250
3405-000,2014,12,22,14,663,711,1374,1178
3405-000,2014,12,22,15,769,861,1630,1374
3405-000,2014,12,22,16,868,746,1614,1630
3405-000,2014,12,22,17,978,687,1665,1614
3405-000,2014,12,22,18,898,754,1652,1665
3405-000,2014,12,22,19,826,733,1559,1652
3405-000,2014,12,22,20,499,496,995,1559
3405-000,2014,12,22,21,382,383,765,995
3405-000,2014,12,22,22,275,338,613,765
3405-000,2014,12,22,23,191,188,379,613
3405-000,2014,12,22,24,118,117,235,379
3405-000,2014,12,23,1,74,94,168,235
3405-000,2014,12,23,2,59,71,130,168
3405-000,2014,12,23,3,39,50,89,130
3405-000,2014,12,23,4,44,70,114,89
3405-000,2014,12,23,5,71,84,155,114
3405-000,2014,12,23,6,141,133,274,155
3405-000,2014,12,23,7,314,284,598,274
3405-000,2014,12,23,8,766,911,1677,598
3405-000,2014,12,23,9,1047,1061,2108,1677
3405-000,2014,12,23,10,860,820,1680,2108
3405-000,2014,12,23,11,942,897,1839,1680
3405-000,2014,12,23,12,991,904,1895,1839
3405-000,2014,12,23,13,782,731,1513,1895
3405-000,2014,12,23,14,871,870,1741,1513
3405-000,2014,12,23,15,1030,966,1996,1741
3405-000,2014,12,23,16,1023,935,1958,1996
3405-000,2014,12,23,17,1000,871,1871,1958
3405-000,2014,12,23,18,1006,886,1892,1871
3405-000,2014,12,23,19,956,773,1729,1892
3405-000,2014,12,23,20,567,537,1104,1729
3405-000,2014,12,23,21,440,423,863,1104
3405-000,2014,12,23,22,356,352,708,863
3405-000,2014,12,23,23,245,195,440,708
3405-000,2014,12,23,24,153,147,300,440
3405-000,2014,12,24,1,97,104,201,300
3405-000,2014,12,24,2,72,73,145,201
3405-000,2014,12,24,3,43,69,112,145
3405-000,2014,12,24,4,76,59,135,112
3405-000,2014,12,24,5,78,105,183,135
3405-000,2014,12,24,6,157,163,320,183
3405-000,2014,12,24,7,341,333,674,320
3405-000,2014,12,24,8,766,919,1685,674
3405-000,2014,12,24,9,1077,1106,2183,1685
3405-000,2014,12,24,10,933,829,1762,2183
3405-000,2014,12,24,11,949,818,1767,1762
3405-000,2014,12,24,12,960,871,1831,1767
3405-000,2014,12,24,13,836,739,1575,1831
3405-000,2014,12,24,14,848,870,1718,1575
3405-000,2014,12,24,15,1032,928,1960,1718
3405-000,2014,12,24,16,1006,921,1927,1960
3405-000,2014,12,24,17,1028,893,1921,1927
3405-000,2014,12,24,18,1291,954,2245,1921
3405-000,2014,12,24,19,1565,1009,2574,2245
3405-000,2014,12,24,20,918,615,1533,2574
3405-000,2014,12,24,21,514,398,912,1533
3405-000,2014,12,24,22,357,329,686,912
3405-000,2014,12,24,23,257,167,424,686
3405-000,2014,12,24,24,148,155,303,424
3405-000,2014,12,25,1,101,100,201,303
3405-000,2014,12,25,2,68,65,133,201
3405-000,2014,12,25,3,50,55,105,133
3405-000,2014,12,25,4,51,60,111,105
3405-000,2014,12,25,5,60,69,129,111
3405-000,2014,12,25,6,109,128,237,129
3405-000,2014,12,25,7,209,174,383,237
3405-000,2014,12,25,8,380,314,694,383
3405-000,2014,12,25,9,491,396,887,694
3405-000,2014,12,25,10,469,380,849,887
3405-000,2014,12,25,11,520,449,969,849
3405-000,2014,12,25,12,507,446,953,969
3405-000,2014,12,25,13,444,458,902,953
3405-000,2014,12,25,14,569,473,1042,902
3405-000,2014,12,25,15,535,528,1063,1042
3405-000,2014,12,25,16,509,529,1038,1063
3405-000,2014,12,25,17,494,518,1012,1038
3405-000,2014,12,25,18,581,517,1098,1012
3405-000,2014,12,25,19,429,414,843,1098
3405-000,2014,12,25,20,326,295,621,843
3405-000,2014,12,25,21,270,263,533,621
3405-000,2014,12,25,22,229,187,416,533
3405-000,2014,12,25,23,159,173,332,416
3405-000,2014,12,25,24,100,144,244,332
3405-000,2014,12,26,1,58,98,156,244
3405-000,2014,12,26,2,36,53,89,156
3405-000,2014,12,26,3,35,58,93,89
3405-000,2014,12,26,4,31,52,83,93
3405-000,2014,12,26,5,71,66,137,83
3405-000,2014,12,26,6,135,184,319,137
3405-000,2014,12,26,7,329,373,702,319
3405-000,2014,12,26,8,779,942,1721,702
3405-000,2014,12,26,9,1014,1049,2063,1721
3405-000,2014,12,26,10,865,756,1621,2063
3405-000,2014,12,26,11,907,850,1757,1621
3405-000,2014,12,26,12,932,858,1790,1757
3405-000,2014,12,26,13,757,749,1506,1790
3405-000,2014,12,26,14,865,761,1626,1506
3405-000,2014,12,26,15,959,903,1862,1626
3405-000,2014,12,26,16,966,852,1818,1862
3405-000,2014,12,26,17,909,878,1787,1818
3405-000,2014,12,26,18,1141,852,1993,1787
3405-000,2014,12,26,19,1081,793,1874,1993
3405-000,2014,12,26,20,640,535,1175,1874
3405-000,2014,12,26,21,450,397,847,1175
3405-000,2014,12,26,22,352,317,669,847
3405-000,2014,12,26,23,272,225,497,669
3405-000,2014,12,26,24,177,292,469,497
3405-000,2014,12,27,1,92,131,223,469
3405-000,2014,12,27,2,74,78,152,223
3405-000,2014,12,27,3,50,59,109,152
3405-000,2014,12,27,4,54,64,118,109
3405-000,2014,12,27,5,81,83,164,118
3405-000,2014,12,27,6,123,151,274,164
3405-000,2014,12,27,7,191,221,412,274
3405-000,2014,12,27,8,520,422,942,412
3405-000,2014,12,27,9,672,527,1199,942
3405-000,2014,12,27,10,668,547,1215,1199
3405-000,2014,12,27,11,720,620,1340,1215
3405-000,2014,12,27,12,787,655,1442,1340
3405-000,2014,12,27,13,619,683,1302,1442
3405-000,2014,12,27,14,731,631,1362,1302
3405-000,2014,12,27,15,683,701,1384,1362
3405-000,2014,12,27,16,717,686,1403,1384
3405-000,2014,12,27,17,774,754,1528,1403
3405-000,2014,12,27,18,745,860,1605,1528
3405-000,2014,12,27,19,606,524,1130,1605
3405-000,2014,12,27,20,385,357,742,1130
3405-000,2014,12,27,21,276,249,525,742
3405-000,2014,12,27,22,270,214,484,525
3405-000,2014,12,27,23,160,158,318,484
3405-000,2014,12,27,24,103,122,225,318
3405-000,2014,12,28,1,75,83,158,225
3405-000,2014,12,28,2,50,45,95,158
3405-000,2014,12,28,3,37,43,80,95
3405-000,2014,12,28,4,25,38,63,80
3405-000,2014,12,28,5,39,37,76,63
3405-000,2014,12,28,6,61,64,125,76
3405-000,2014,12,28,7,134,107,241,125
3405-000,2014,12,28,8,208,167,375,241
3405-000,2014,12,28,9,324,267,591,375
3405-000,2014,12,28,10,326,246,572,591
3405-000,2014,12,28,11,431,337,768,572
3405-000,2014,12,28,12,415,369,784,768
3405-000,2014,12,28,13,443,401,844,784
3405-000,2014,12,28,14,454,445,899,844
3405-000,2014,12,28,15,447,453,900,899
3405-000,2014,12,28,16,501,546,1047,900
3405-000,2014,12,28,17,464,615,1079,1047
3405-000,2014,12,28,18,502,646,1148,1079
3405-000,2014,12,28,19,359,492,851,1148
3405-000,2014,12,28,20,279,410,689,851
3405-000,2014,12,28,21,245,347,592,689
3405-000,2014,12,28,22,177,272,449,592
3405-000,2014,12,28,23,139,223,362,449
3405-000,2014,12,28,24,95,140,235,362
3405-000,2014,12,29,1,55,82,137,235
3405-000,2014,12,29,2,34,60,94,137
3405-000,2014,12,29,3,29,50,79,94
3405-000,2014,12,29,4,36,55,91,79
3405-000,2014,12,29,5,76,84,160,91
3405-000,2014,12,29,6,157,201,358,160
3405-000,2014,12,29,7,417,444,861,358
3405-000,2014,12,29,8,838,1244,2082,861
3405-000,2014,12,29,9,1108,1133,2241,2082
3405-000,2014,12,29,10,910,822,1732,2241
3405-000,2014,12,29,11,931,865,1796,1732
3405-000,2014,12,29,12,953,873,1826,1796
3405-000,2014,12,29,13,777,753,1530,1826
3405-000,2014,12,29,14,893,868,1761,1530
3405-000,2014,12,29,15,1052,1029,2081,1761
3405-000,2014,12,29,16,1002,945,1947,2081
3405-000,2014,12,29,17,920,880,1800,1947
3405-000,2014,12,29,18,995,928,1923,1800
3405-000,2014,12,29,19,836,857,1693,1923
3405-000,2014,12,29,20,611,539,1150,1693
3405-000,2014,12,29,21,445,437,882,1150
3405-000,2014,12,29,22,370,320,690,882
3405-000,2014,12,29,23,247,204,451,690
3405-000,2014,12,29,24,169,162,331,451
3405-000,2014,12,30,1,117,124,241,331
3405-000,2014,12,30,2,70,88,158,241
3405-000,2014,12,30,3,69,61,130,158
3405-000,2014,12,30,4,41,79,120,130
3405-000,2014,12,30,5,99,106,205,120
3405-000,2014,12,30,6,154,169,323,205
3405-000,2014,12,30,7,357,316,673,323
3405-000,2014,12,30,8,810,920,1730,673
3405-000,2014,12,30,9,1075,1096,2171,1730
3405-000,2014,12,30,10,896,853,1749,2171
3405-000,2014,12,30,11,945,898,1843,1749
3405-000,2014,12,30,12,1058,841,1899,1843
3405-000,2014,12,30,13,857,763,1620,1899
3405-000,2014,12,30,14,842,904,1746,1620
3405-000,2014,12,30,15,1064,943,2007,1746
3405-000,2014,12,30,16,993,962,1955,2007
3405-000,2014,12,30,17,1050,813,1863,1955
3405-000,2014,12,30,18,1029,878,1907,1863
3405-000,2014,12,30,19,986,869,1855,1907
3405-000,2014,12,30,20,596,581,1177,1855
3405-000,2014,12,30,21,476,425,901,1177
3405-000,2014,12,30,22,366,336,702,901
3405-000,2014,12,30,23,282,212,494,702
3405-000,2014,12,30,24,171,167,338,494
3405-000,2014,12,31,1,116,111,227,338
3405-000,2014,12,31,2,81,105,186,227
3405-000,2014,12,31,3,67,62,129,186
3405-000,2014,12,31,4,60,67,127,129
3405-000,2014,12,31,5,84,89,173,127
3405-000,2014,12,31,6,150,120,270,173
3405-000,2014,12,31,7,301,288,589,270
3405-000,2014,12,31,8,621,722,1343,589
3405-000,2014,12,31,9,987,882,1869,1343
3405-000,2014,12,31,10,724,609,1333,1869
3405-000,2014,12,31,11,780,696,1476,1333
3405-000,2014,12,31,12,820,725,1545,1476
3405-000,2014,12,31,13,743,630,1373,1545
3405-000,2014,12,31,14,812,707,1519,1373
3405-000,2014,12,31,15,923,711,1634,1519
3405-000,2014,12,31,16,955,861,1816,1634
3405-000,2014,12,31,17,975,783,1758,1816
3405-000,2014,12,31,18,1070,820,1890,1758
3405-000,2014,12,31,19,962,679,1641,1890
3405-000,2014,12,31,20,641,417,1058,1641
3405-000,2014,12,31,21,410,299,709,1058
3405-000,2014,12,31,22,296,216,512,709
3405-000,2014,12,31,23,211,181,392,512
3405-000,2014,12,31,24,116,108,224,392
3405-000,2015,1,1,1,94,92,186,224
3405-000,2015,1,1,2,92,82,174,186
3405-000,2015,1,1,3,68,61,129,174
3405-000,2015,1,1,4,40,57,97,129
3405-000,2015,1,1,5,50,48,98,97
3405-000,2015,1,1,6,81,69,150,98
3405-000,2015,1,1,7,142,79,221,150
3405-000,2015,1,1,8,190,144,334,221
3405-000,2015,1,1,9,250,173,423,334
3405-000,2015,1,1,10,296,228,524,423
3405-000,2015,1,1,11,450,294,744,524
3405-000,2015,1,1,12,495,356,851,744
3405-000,2015,1,1,13,424,404,828,851
3405-000,2015,1,1,14,442,371,813,828
3405-000,2015,1,1,15,426,392,818,813
3405-000,2015,1,1,16,436,470,906,818
3405-000,2015,1,1,17,444,448,892,906
3405-000,2015,1,1,18,383,412,795,892
3405-000,2015,1,1,19,341,336,677,795
3405-000,2015,1,1,20,248,299,547,677
3405-000,2015,1,1,21,216,282,498,547
3405-000,2015,1,1,22,169,212,381,498
3405-000,2015,1,1,23,113,148,261,381
3405-000,2015,1,1,24,87,84,171,261
3405-000,2015,1,2,1,41,62,103,171
3405-000,2015,1,2,2,26,43,69,103
3405-000,2015,1,2,3,23,48,71,69
3405-000,2015,1,2,4,28,35,63,71
3405-000,2015,1,2,5,72,61,133,63
3405-000,2015,1,2,6,98,111,209,133
3405-000,2015,1,2,7,258,266,524,209
3405-000,2015,1,2,8,507,682,1189,524
3405-000,2015,1,2,9,778,760,1538,1189
3405-000,2015,1,2,10,632,519,1151,1538
3405-000,2015,1,2,11,742,589,1331,1151
3405-000,2015,1,2,12,748,609,1357,1331
3405-000,2015,1,2,13,611,590,1201,1357
3405-000,2015,1,2,14,703,689,1392,1201
3405-000,2015,1,2,15,757,685,1442,1392
3405-000,2015,1,2,16,746,720,1466,1442
3405-000,2015,1,2,17,737,681,1418,1466
3405-000,2015,1,2,18,796,739,1535,1418
3405-000,2015,1,2,19,823,732,1555,1535
3405-000,2015,1,2,20,523,478,1001,1555
3405-000,2015,1,2,21,370,324,694,1001
3405-000,2015,1,2,22,264,276,540,694
3405-000,2015,1,2,23,202,178,380,540
3405-000,2015,1,2,24,128,117,245,380
3405-000,2015,1,3,1,67,80,147,245
3405-000,2015,1,3,2,49,66,115,147
3405-000,2015,1,3,3,35,48,83,115
3405-000,2015,1,3,4,35,54,89,83
3405-000,2015,1,3,5,51,61,112,89
3405-000,2015,1,3,6,93,116,209,112
3405-000,2015,1,3,7,204,167,371,209
3405-000,2015,1,3,8,391,329,720,371
3405-000,2015,1,3,9,536,455,991,720
3405-000,2015,1,3,10,583,455,1038,991
3405-000,2015,1,3,11,636,461,1097,1038
3405-000,2015,1,3,12,698,498,1196,1097
3405-000,2015,1,3,13,688,516,1204,1196
3405-000,2015,1,3,14,670,621,1291,1204
3405-000,2015,1,3,15,661,585,1246,1291
3405-000,2015,1,3,16,632,594,1226,1246
3405-000,2015,1,3,17,683,611,1294,1226
3405-000,2015,1,3,18,642,668,1310,1294
3405-000,2015,1,3,19,525,491,1016,1310
3405-000,2015,1,3,20,350,352,702,1016
3405-000,2015,1,3,21,275,270,545,702
3405-000,2015,1,3,22,214,191,405,545
3405-000,2015,1,3,23,145,150,295,405
3405-000,2015,1,3,24,87,101,188,295
3405-000,2015,1,4,1,60,76,136,188
3405-000,2015,1,4,2,50,49,99,136
3405-000,2015,1,4,3,32,38,70,99
3405-000,2015,1,4,4,29,33,62,70
3405-000,2015,1,4,5,23,31,54,62
3405-000,2015,1,4,6,61,64,125,54
3405-000,2015,1,4,7,130,110,240,125
3405-000,2015,1,4,8,182,159,341,240
3405-000,2015,1,4,9,270,214,484,341
3405-000,2015,1,4,10,349,249,598,484
3405-000,2015,1,4,11,397,367,764,598
3405-000,2015,1,4,12,424,346,770,764
3405-000,2015,1,4,13,390,388,778,770
3405-000,2015,1,4,14,406,478,884,778
3405-000,2015,1,4,15,514,514,1028,884
3405-000,2015,1,4,16,513,575,1088,1028
3405-000,2015,1,4,17,512,612,1124,1088
3405-000,2015,1,4,18,491,618,1109,1124
3405-000,2015,1,4,19,405,459,864,1109
3405-000,2015,1,4,20,282,398,680,864
3405-000,2015,1,4,21,242,327,569,680
3405-000,2015,1,4,22,200,281,481,569
3405-000,2015,1,4,23,133,246,379,481
3405-000,2015,1,4,24,105,137,242,379
3405-000,2015,1,5,1,60,85,145,242
3405-000,2015,1,5,2,39,71,110,145
3405-000,2015,1,5,3,22,44,66,110
3405-000,2015,1,5,4,35,60,95,66
3405-000,2015,1,5,5,73,88,161,95
3405-000,2015,1,5,6,181,183,364,161
3405-000,2015,1,5,7,391,446,837,364
3405-000,2015,1,5,8,874,1263,2137,837
3405-000,2015,1,5,9,1065,1160,2225,2137
3405-000,2015,1,5,10,800,723,1523,2225
3405-000,2015,1,5,11,902,808,1710,1523
3405-000,2015,1,5,12,804,828,1632,1710
3405-000,2015,1,5,13,749,717,1466,1632
3405-000,2015,1,5,14,789,789,1578,1466
3405-000,2015,1,5,15,1030,950,1980,1578
3405-000,2015,1,5,16,933,884,1817,1980
3405-000,2015,1,5,17,966,813,1779,1817
3405-000,2015,1,5,18,990,823,1813,1779
3405-000,2015,1,5,19,910,807,1717,1813
3405-000,2015,1,5,20,539,551,1090,1717
3405-000,2015,1,5,21,466,443,909,1090
3405-000,2015,1,5,22,330,358,688,909
3405-000,2015,1,5,23,205,194,399,688
3405-000,2015,1,5,24,113,125,238,399
3405-000,2015,1,6,1,85,109,194,238
3405-000,2015,1,6,2,58,68,126,194
3405-000,2015,1,6,3,45,53,98,126
3405-000,2015,1,6,4,51,59,110,98
3405-000,2015,1,6,5,88,99,187,110
3405-000,2015,1,6,6,149,157,306,187
3405-000,2015,1,6,7,351,272,623,306
3405-000,2015,1,6,8,798,959,1757,623
3405-000,2015,1,6,9,1034,1026,2060,1757
3405-000,2015,1,6,10,895,789,1684,2060
3405-000,2015,1,6,11,917,847,1764,1684
3405-000,2015,1,6,12,862,843,1705,1764
3405-000,2015,1,6,13,718,732,1450,1705
3405-000,2015,1,6,14,856,750,1606,1450
3405-000,2015,1,6,15,935,902,1837,1606
3405-000,2015,1,6,16,965,878,1843,1837
3405-000,2015,1,6,17,958,821,1779,1843
3405-000,2015,1,6,18,927,783,1710,1779
3405-000,2015,1,6,19,863,828,1691,1710
3405-000,2015,1,6,20,549,552,1101,1691
3405-000,2015,1,6,21,448,436,884,1101
3405-000,2015,1,6,22,313,351,664,884
3405-000,2015,1,6,23,190,200,390,664
3405-000,2015,1,6,24,135,133,268,390
3405-000,2015,1,7,1,73,107,180,268
3405-000,2015,1,7,2,62,66,128,180
3405-000,2015,1,7,3,42,51,93,128
3405-000,2015,1,7,4,48,46,94,93
3405-000,2015,1,7,5,69,80,149,94
3405-000,2015,1,7,6,132,140,272,149
3405-000,2015,1,7,7,332,334,666,272
3405-000,2015,1,7,8,787,932,1719,666
3405-000,2015,1,7,9,1069,1067,2136,1719
3405-000,2015,1,7,10,921,781,1702,2136
3405-000,2015,1,7,11,946,829,1775,1702
3405-000,2015,1,7,12,870,806,1676,1775
3405-000,2015,1,7,13,711,695,1406,1676
3405-000,2015,1,7,14,850,844,1694,1406
3405-000,2015,1,7,15,985,903,1888,1694
3405-000,2015,1,7,16,961,848,1809,1888
3405-000,2015,1,7,17,916,802,1718,1809
3405-000,2015,1,7,18,998,903,1901,1718
3405-000,2015,1,7,19,942,811,1753,1901
3405-000,2015,1,7,20,515,537,1052,1753
3405-000,2015,1,7,21,433,409,842,1052
3405-000,2015,1,7,22,329,339,668,842
3405-000,2015,1,7,23,215,182,397,668
3405-000,2015,1,7,24,131,135,266,397
3405-000,2015,1,8,1,85,118,203,266
3405-000,2015,1,8,2,48,65,113,203
3405-000,2015,1,8,3,34,43,77,113
3405-000,2015,1,8,4,45,72,117,77
3405-000,2015,1,8,5,79,87,166,117
3405-000,2015,1,8,6,129,158,287,166
3405-000,2015,1,8,7,349,349,698,287
3405-000,2015,1,8,8,816,997,1813,698
3405-000,2015,1,8,9,1113,1060,2173,1813
3405-000,2015,1,8,10,904,757,1661,2173
3405-000,2015,1,8,11,992,870,1862,1661
3405-000,2015,1,8,12,950,926,1876,1862
3405-000,2015,1,8,13,757,730,1487,1876
3405-000,2015,1,8,14,832,819,1651,1487
3405-000,2015,1,8,15,1000,947,1947,1651
3405-000,2015,1,8,16,982,877,1859,1947
3405-000,2015,1,8,17,1005,813,1818,1859
3405-000,2015,1,8,18,969,858,1827,1818
3405-000,2015,1,8,19,902,830,1732,1827
3405-000,2015,1,8,20,548,563,1111,1732
3405-000,2015,1,8,21,510,446,956,1111
3405-000,2015,1,8,22,311,303,614,956
3405-000,2015,1,8,23,216,220,436,614
3405-000,2015,1,8,24,133,150,283,436
3405-000,2015,1,9,1,89,109,198,283
3405-000,2015,1,9,2,50,61,111,198
3405-000,2015,1,9,3,44,55,99,111
3405-000,2015,1,9,4,48,62,110,99
3405-000,2015,1,9,5,80,90,170,110
3405-000,2015,1,9,6,157,150,307,170
3405-000,2015,1,9,7,320,337,657,307
3405-000,2015,1,9,8,809,932,1741,657
3405-000,2015,1,9,9,1136,1091,2227,1741
3405-000,2015,1,9,10,901,855,1756,2227
3405-000,2015,1,9,11,1008,820,1828,1756
3405-000,2015,1,9,12,943,867,1810,1828
3405-000,2015,1,9,13,808,741,1549,1810
3405-000,2015,1,9,14,878,882,1760,1549
3405-000,2015,1,9,15,1019,932,1951,1760
3405-000,2015,1,9,16,1073,956,2029,1951
3405-000,2015,1,9,17,1064,783,1847,2029
3405-000,2015,1,9,18,1163,918,2081,1847
3405-000,2015,1,9,19,1239,913,2152,2081
3405-000,2015,1,9,20,816,624,1440,2152
3405-000,2015,1,9,21,523,466,989,1440
3405-000,2015,1,9,22,415,327,742,989
3405-000,2015,1,9,23,286,172,458,742
3405-000,2015,1,9,24,151,164,315,458
3405-000,2015,1,10,1,89,113,202,315
3405-000,2015,1,10,2,80,99,179,202
3405-000,2015,1,10,3,62,68,130,179
3405-000,2015,1,10,4,47,49,96,130
3405-000,2015,1,10,5,61,81,142,96
3405-000,2015,1,10,6,125,143,268,142
3405-000,2015,1,10,7,278,240,518,268
3405-000,2015,1,10,8,569,437,1006,518
3405-000,2015,1,10,9,756,605,1361,1006
3405-000,2015,1,10,10,724,606,1330,1361
3405-000,2015,1,10,11,814,620,1434,1330
3405-000,2015,1,10,12,849,689,1538,1434
3405-000,2015,1,10,13,804,685,1489,1538
3405-000,2015,1,10,14,701,660,1361,1489
3405-000,2015,1,10,15,736,616,1352,1361
3405-000,2015,1,10,16,695,649,1344,1352
3405-000,2015,1,10,17,780,665,1445,1344
3405-000,2015,1,10,18,766,841,1607,1445
3405-000,2015,1,10,19,629,550,1179,1607
3405-000,2015,1,10,20,355,392,747,1179
3405-000,2015,1,10,21,298,269,567,747
3405-000,2015,1,10,22,216,203,419,567
3405-000,2015,1,10,23,178,156,334,419
3405-000,2015,1,10,24,113,118,231,334
3405-000,2015,1,11,1,83,96,179,231
3405-000,2015,1,11,2,46,50,96,179
3405-000,2015,1,11,3,24,49,73,96
3405-000,2015,1,11,4,25,35,60,73
3405-000,2015,1,11,5,32,36,68,60
3405-000,2015,1,11,6,53,50,103,68
3405-000,2015,1,11,7,116,105,221,103
3405-000,2015,1,11,8,239,151,390,221
3405-000,2015,1,11,9,333,255,588,390
3405-000,2015,1,11,10,388,280,668,588
3405-000,2015,1,11,11,472,345,817,668
3405-000,2015,1,11,12,436,390,826,817
3405-000,2015,1,11,13,395,419,814,826
3405-000,2015,1,11,14,433,426,859,814
3405-000,2015,1,11,15,467,477,944,859
3405-000,2015,1,11,16,485,542,1027,944
3405-000,2015,1,11,17,483,502,985,1027
3405-000,2015,1,11,18,454,497,951,985
3405-000,2015,1,11,19,353,449,802,951
3405-000,2015,1,11,20,286,363,649,802
3405-000,2015,1,11,21,207,304,511,649
3405-000,2015,1,11,22,185,251,436,511
3405-000,2015,1,11,23,146,228,374,436
3405-000,2015,1,11,24,84,140,224,374
3405-000,2015,1,12,1,45,102,147,224
3405-000,2015,1,12,2,27,51,78,147
3405-000,2015,1,12,3,29,40,69,78
3405-000,2015,1,12,4,40,49,89,69
3405-000,2015,1,12,5,57,91,148,89
3405-000,2015,1,12,6,162,182,344,148
3405-000,2015,1,12,7,379,439,818,344
3405-000,2015,1,12,8,842,1213,2055,818
3405-000,2015,1,12,9,1089,1203,2292,2055
3405-000,2015,1,12,10,861,740,1601,2292
3405-000,2015,1,12,11,926,835,1761,1601
3405-000,2015,1,12,12,906,836,1742,1761
3405-000,2015,1,12,13,754,694,1448,1742
3405-000,2015,1,12,14,841,848,1689,1448
3405-000,2015,1,12,15,991,924,1915,1689
3405-000,2015,1,12,16,982,963,1945,1915
3405-000,2015,1,12,17,935,840,1775,1945
3405-000,2015,1,12,18,965,830,1795,1775
3405-000,2015,1,12,19,862,773,1635,1795
3405-000,2015,1,12,20,584,538,1122,1635
3405-000,2015,1,12,21,450,433,883,1122
3405-000,2015,1,12,22,358,355,713,883
3405-000,2015,1,12,23,218,180,398,713
3405-000,2015,1,12,24,116,124,240,398
3405-000,2015,1,13,1,76,89,165,240
3405-000,2015,1,13,2,54,78,132,165
3405-000,2015,1,13,3,42,54,96,132
3405-000,2015,1,13,4,54,65,119,96
3405-000,2015,1,13,5,67,86,153,119
3405-000,2015,1,13,6,150,152,302,153
3405-000,2015,1,13,7,352,333,685,302
3405-000,2015,1,13,8,792,967,1759,685
3405-000,2015,1,13,9,1145,1146,2291,1759
3405-000,2015,1,13,10,931,768,1699,2291
3405-000,2015,1,13,11,912,823,1735,1699
3405-000,2015,1,13,12,914,824,1738,1735
3405-000,2015,1,13,13,799,720,1519,1738
3405-000,2015,1,13,14,834,859,1693,1519
3405-000,2015,1,13,15,1024,934,1958,1693
3405-000,2015,1,13,16,1018,854,1872,1958
3405-000,2015,1,13,17,969,835,1804,1872
3405-000,2015,1,13,18,958,821,1779,1804
3405-000,2015,1,13,19,896,758,1654,1779
3405-000,2015,1,13,20,558,536,1094,1654
3405-000,2015,1,13,21,466,442,908,1094
3405-000,2015,1,13,22,322,349,671,908
3405-000,2015,1,13,23,216,199,415,671
3405-000,2015,1,13,24,147,149,296,415
3405-000,2015,1,14,1,86,120,206,296
3405-000,2015,1,14,2,48,67,115,206
3405-000,2015,1,14,3,42,52,94,115
3405-000,2015,1,14,4,64,67,131,94
3405-000,2015,1,14,5,69,79,148,131
3405-000,2015,1,14,6,144,152,296,148
3405-000,2015,1,14,7,346,315,661,296
3405-000,2015,1,14,8,826,924,1750,661
3405-000,2015,1,14,9,1128,1136,2264,1750
3405-000,2015,1,14,10,897,901,1798,2264
3405-000,2015,1,14,11,1012,825,1837,1798
3405-000,2015,1,14,12,920,877,1797,1837
3405-000,2015,1,14,13,750,752,1502,1797
3405-000,2015,1,14,14,812,814,1626,1502
3405-000,2015,1,14,15,1012,874,1886,1626
3405-000,2015,1,14,16,938,875,1813,1886
3405-000,2015,1,14,17,934,831,1765,1813
3405-000,2015,1,14,18,1033,900,1933,1765
3405-000,2015,1,14,19,909,907,1816,1933
3405-000,2015,1,14,20,545,504,1049,1816
3405-000,2015,1,14,21,448,385,833,1049
3405-000,2015,1,14,22,332,336,668,833
3405-000,2015,1,14,23,246,208,454,668
3405-000,2015,1,14,24,129,149,278,454
3405-000,2015,1,15,1,86,91,177,278
3405-000,2015,1,15,2,57,79,136,177
3405-000,2015,1,15,3,46,61,107,136
3405-000,2015,1,15,4,46,52,98,107
3405-000,2015,1,15,5,83,101,184,98
3405-000,2015,1,15,6,141,191,332,184
3405-000,2015,1,15,7,351,340,691,332
3405-000,2015,1,15,8,843,919,1762,691
3405-000,2015,1,15,9,1102,1069,2171,1762
3405-000,2015,1,15,10,948,823,1771,2171
3405-000,2015,1,15,11,962,894,1856,1771
3405-000,2015,1,15,12,929,886,1815,1856
3405-000,2015,1,15,13,793,759,1552,1815
3405-000,2015,1,15,14,899,882,1781,1552
3405-000,2015,1,15,15,962,916,1878,1781
3405-000,2015,1,15,16,959,858,1817,1878
3405-000,2015,1,15,17,1002,833,1835,1817
3405-000,2015,1,15,18,998,911,1909,1835
3405-000,2015,1,15,19,916,896,1812,1909
3405-000,2015,1,15,20,617,536,1153,1812
3405-000,2015,1,15,21,443,436,879,1153
3405-000,2015,1,15,22,361,373,734,879
3405-000,2015,1,15,23,214,214,428,734
3405-000,2015,1,15,24,154,148,302,428
3405-000,2015,1,16,1,88,107,195,302
3405-000,2015,1,16,2,63,80,143,195
3405-000,2015,1,16,3,37,58,95,143
3405-000,2015,1,16,4,54,53,107,95
3405-000,2015,1,16,5,82,91,173,107
3405-000,2015,1,16,6,137,165,302,173
3405-000,2015,1,16,7,379,306,685,302
3405-000,2015,1,16,8,796,897,1693,685
3405-000,2015,1,16,9,1060,1113,2173,1693
3405-000,2015,1,16,10,966,851,1817,2173
3405-000,2015,1,16,11,972,867,1839,1817
3405-000,2015,1,16,12,968,844,1812,1839
3405-000,2015,1,16,13,835,707,1542,1812
3405-000,2015,1,16,14,871,879,1750,1542
3405-000,2015,1,16,15,952,922,1874,1750
3405-000,2015,1,16,16,994,815,1809,1874
3405-000,2015,1,16,17,1042,804,1846,1809
3405-000,2015,1,16,18,1038,832,1870,1846
3405-000,2015,1,16,19,1239,929,2168,1870
3405-000,2015,1,16,20,737,688,1425,2168
3405-000,2015,1,16,21,561,576,1137,1425
3405-000,2015,1,16,22,391,338,729,1137
3405-000,2015,1,16,23,241,189,430,729
3405-000,2015,1,16,24,145,141,286,430
3405-000,2015,1,17,1,104,120,224,286
3405-000,2015,1,17,2,79,59,138,224
3405-000,2015,1,17,3,43,62,105,138
3405-000,2015,1,17,4,44,58,102,105
3405-000,2015,1,17,5,68,68,136,102
3405-000,2015,1,17,6,130,124,254,136
3405-000,2015,1,17,7,246,209,455,254
3405-000,2015,1,17,8,538,374,912,455
3405-000,2015,1,17,9,720,568,1288,912
3405-000,2015,1,17,10,681,533,1214,1288
3405-000,2015,1,17,11,702,607,1309,1214
3405-000,2015,1,17,12,724,588,1312,1309
3405-000,2015,1,17,13,662,568,1230,1312
3405-000,2015,1,17,14,640,596,1236,1230
3405-000,2015,1,17,15,700,585,1285,1236
3405-000,2015,1,17,16,646,582,1228,1285
3405-000,2015,1,17,17,686,581,1267,1228
3405-000,2015,1,17,18,756,825,1581,1267
3405-000,2015,1,17,19,604,574,1178,1581
3405-000,2015,1,17,20,401,349,750,1178
3405-000,2015,1,17,21,276,266,542,750
3405-000,2015,1,17,22,208,231,439,542
3405-000,2015,1,17,23,151,137,288,439
3405-000,2015,1,17,24,101,130,231,288
3405-000,2015,1,18,1,68,89,157,231
3405-000,2015,1,18,2,47,46,93,157
3405-000,2015,1,18,3,31,45,76,93
3405-000,2015,1,18,4,25,29,54,76
3405-000,2015,1,18,5,49,35,84,54
3405-000,2015,1,18,6,63,76,139,84
3405-000,2015,1,18,7,107,99,206,139
3405-000,2015,1,18,8,196,194,390,206
3405-000,2015,1,18,9,328,244,572,390
3405-000,2015,1,18,10,344,276,620,572
3405-000,2015,1,18,11,409,318,727,620
3405-000,2015,1,18,12,439,382,821,727
3405-000,2015,1,18,13,413,406,819,821
3405-000,2015,1,18,14,412,479,891,819
3405-000,2015,1,18,15,468,470,938,891
3405-000,2015,1,18,16,509,570,1079,938
3405-000,2015,1,18,17,501,582,1083,1079
3405-000,2015,1,18,18,511,572,1083,1083
3405-000,2015,1,18,19,411,552,963,1083
3405-000,2015,1,18,20,302,422,724,963
3405-000,2015,1,18,21,259,290,549,724
3405-000,2015,1,18,22,200,262,462,549
3405-000,2015,1,18,23,137,237,374,462
3405-000,2015,1,18,24,99,178,277,374
3405-000,2015,1,19,1,54,96,150,277
3405-000,2015,1,19,2,42,54,96,150
3405-000,2015,1,19,3,32,37,69,96
3405-000,2015,1,19,4,34,49,83,69
3405-000,2015,1,19,5,75,87,162,83
3405-000,2015,1,19,6,154,178,332,162
3405-000,2015,1,19,7,386,403,789,332
3405-000,2015,1,19,8,809,1078,1887,789
3405-000,2015,1,19,9,1051,1060,2111,1887
3405-000,2015,1,19,10,838,772,1610,2111
3405-000,2015,1,19,11,906,792,1698,1610
3405-000,2015,1,19,12,846,834,1680,1698
3405-000,2015,1,19,13,740,738,1478,1680
3405-000,2015,1,19,14,788,834,1622,1478
3405-000,2015,1,19,15,940,976,1916,1622
3405-000,2015,1,19,16,994,829,1823,1916
3405-000,2015,1,19,17,912,837,1749,1823
3405-000,2015,1,19,18,883,826,1709,1749
3405-000,2015,1,19,19,872,888,1760,1709
3405-000,2015,1,19,20,572,545,1117,1760
3405-000,2015,1,19,21,428,430,858,1117
3405-000,2015,1,19,22,305,345,650,858
3405-000,2015,1,19,23,218,206,424,650
3405-000,2015,1,19,24,140,160,300,424
3405-000,2015,1,20,1,81,116,197,300
3405-000,2015,1,20,2,58,63,121,197
3405-000,2015,1,20,3,40,57,97,121
3405-000,2015,1,20,4,52,60,112,97
3405-000,2015,1,20,5,90,93,183,112
3405-000,2015,1,20,6,135,154,289,183
3405-000,2015,1,20,7,333,310,643,289
3405-000,2015,1,20,8,813,944,1757,643
3405-000,2015,1,20,9,1179,1080,2259,1757
3405-000,2015,1,20,10,965,886,1851,2259
3405-000,2015,1,20,11,953,881,1834,1851
3405-000,2015,1,20,12,898,847,1745,1834
3405-000,2015,1,20,13,749,724,1473,1745
3405-000,2015,1,20,14,876,828,1704,1473
3405-000,2015,1,20,15,980,926,1906,1704
3405-000,2015,1,20,16,991,855,1846,1906
3405-000,2015,1,20,17,1009,840,1849,1846
3405-000,2015,1,20,18,976,875,1851,1849
3405-000,2015,1,20,19,916,858,1774,1851
3405-000,2015,1,20,20,580,539,1119,1774
3405-000,2015,1,20,21,523,468,991,1119
3405-000,2015,1,20,22,305,340,645,991
3405-000,2015,1,20,23,226,222,448,645
3405-000,2015,1,20,24,139,154,293,448
3405-000,2015,1,21,1,73,86,159,293
3405-000,2015,1,21,2,59,76,135,159
3405-000,2015,1,21,3,47,62,109,135
3405-000,2015,1,21,4,54,56,110,109
3405-000,2015,1,21,5,79,86,165,110
3405-000,2015,1,21,6,159,157,316,165
3405-000,2015,1,21,7,380,392,772,316
3405-000,2015,1,21,8,856,1018,1874,772
3405-000,2015,1,21,9,1105,1057,2162,1874
3405-000,2015,1,21,10,974,807,1781,2162
3405-000,2015,1,21,11,950,865,1815,1781
3405-000,2015,1,21,12,918,863,1781,1815
3405-000,2015,1,21,13,787,714,1501,1781
3405-000,2015,1,21,14,848,896,1744,1501
3405-000,2015,1,21,15,1040,802,1842,1744
3405-000,2015,1,21,16,917,861,1778,1842
3405-000,2015,1,21,17,962,856,1818,1778
3405-000,2015,1,21,18,994,929,1923,1818
3405-000,2015,1,21,19,936,816,1752,1923
3405-000,2015,1,21,20,579,552,1131,1752
3405-000,2015,1,21,21,433,377,810,1131
3405-000,2015,1,21,22,303,307,610,810
3405-000,2015,1,21,23,213,197,410,610
3405-000,2015,1,21,24,139,134,273,410
3405-000,2015,1,22,1,78,92,170,273
3405-000,2015,1,22,2,44,73,117,170
3405-000,2015,1,22,3,45,48,93,117
3405-000,2015,1,22,4,41,62,103,93
3405-000,2015,1,22,5,89,78,167,103
3405-000,2015,1,22,6,135,153,288,167
3405-000,2015,1,22,7,356,325,681,288
3405-000,2015,1,22,8,819,935,1754,681
3405-000,2015,1,22,9,1134,1094,2228,1754
3405-000,2015,1,22,10,927,813,1740,2228
3405-000,2015,1,22,11,1030,850,1880,1740
3405-000,2015,1,22,12,911,882,1793,1880
3405-000,2015,1,22,13,765,715,1480,1793
3405-000,2015,1,22,14,779,871,1650,1480
3405-000,2015,1,22,15,939,929,1868,1650
3405-000,2015,1,22,16,996,829,1825,1868
3405-000,2015,1,22,17,846,784,1630,1825
3405-000,2015,1,22,18,845,865,1710,1630
3405-000,2015,1,22,19,817,753,1570,1710
3405-000,2015,1,22,20,569,546,1115,1570
3405-000,2015,1,22,21,444,443,887,1115
3405-000,2015,1,22,22,335,324,659,887
3405-000,2015,1,22,23,230,197,427,659
3405-000,2015,1,22,24,116,159,275,427
3405-000,2015,1,23,1,84,109,193,275
3405-000,2015,1,23,2,48,76,124,193
3405-000,2015,1,23,3,50,53,103,124
3405-000,2015,1,23,4,41,52,93,103
3405-000,2015,1,23,5,79,82,161,93
3405-000,2015,1,23,6,148,161,309,161
3405-000,2015,1,23,7,391,320,711,309
3405-000,2015,1,23,8,829,962,1791,711
3405-000,2015,1,23,9,1144,1071,2215,1791
3405-000,2015,1,23,10,957,810,1767,2215
3405-000,2015,1,23,11,976,832,1808,1767
3405-000,2015,1,23,12,899,811,1710,1808
3405-000,2015,1,23,13,766,791,1557,1710
3405-000,2015,1,23,14,889,870,1759,1557
3405-000,2015,1,23,15,1018,953,1971,1759
3405-000,2015,1,23,16,1013,894,1907,1971
3405-000,2015,1,23,17,1036,806,1842,1907
3405-000,2015,1,23,18,1127,940,2067,1842
3405-000,2015,1,23,19,1224,950,2174,2067
3405-000,2015,1,23,20,745,639,1384,2174
3405-000,2015,1,23,21,491,453,944,1384
3405-000,2015,1,23,22,395,323,718,944
3405-000,2015,1,23,23,255,235,490,718
3405-000,2015,1,23,24,166,135,301,490
3405-000,2015,1,24,1,95,108,203,301
3405-000,2015,1,24,2,77,82,159,203
3405-000,2015,1,24,3,38,47,85,159
3405-000,2015,1,24,4,40,69,109,85
3405-000,2015,1,24,5,59,96,155,109
3405-000,2015,1,24,6,141,129,270,155
3405-000,2015,1,24,7,326,227,553,270
3405-000,2015,1,24,8,587,462,1049,553
3405-000,2015,1,24,9,823,615,1438,1049
3405-000,2015,1,24,10,787,686,1473,1438
3405-000,2015,1,24,11,772,668,1440,1473
3405-000,2015,1,24,12,821,644,1465,1440
3405-000,2015,1,24,13,702,583,1285,1465
3405-000,2015,1,24,14,695,607,1302,1285
3405-000,2015,1,24,15,762,588,1350,1302
3405-000,2015,1,24,16,724,615,1339,1350
3405-000,2015,1,24,17,751,638,1389,1339
3405-000,2015,1,24,18,805,753,1558,1389
3405-000,2015,1,24,19,603,565,1168,1558
3405-000,2015,1,24,20,402,399,801,1168
3405-000,2015,1,24,21,286,279,565,801
3405-000,2015,1,24,22,231,219,450,565
3405-000,2015,1,24,23,159,139,298,450
3405-000,2015,1,24,24,110,141,251,298
3405-000,2015,1,25,1,77,79,156,251
3405-000,2015,1,25,2,38,66,104,156
3405-000,2015,1,25,3,35,49,84,104
3405-000,2015,1,25,4,29,32,61,84
3405-000,2015,1,25,5,33,40,73,61
3405-000,2015,1,25,6,79,57,136,73
3405-000,2015,1,25,7,148,97,245,136
3405-000,2015,1,25,8,229,195,424,245
3405-000,2015,1,25,9,340,290,630,424
3405-000,2015,1,25,10,371,258,629,630
3405-000,2015,1,25,11,489,307,796,629
3405-000,2015,1,25,12,392,386,778,796
3405-000,2015,1,25,13,426,404,830,778
3405-000,2015,1,25,14,421,450,871,830
3405-000,2015,1,25,15,462,495,957,871
3405-000,2015,1,25,16,532,618,1150,957
3405-000,2015,1,25,17,492,586,1078,1150
3405-000,2015,1,25,18,460,645,1105,1078
3405-000,2015,1,25,19,341,625,966,1105
3405-000,2015,1,25,20,305,431,736,966
3405-000,2015,1,25,21,252,336,588,736
3405-000,2015,1,25,22,209,251,460,588
3405-000,2015,1,25,23,135,213,348,460
3405-000,2015,1,25,24,98,140,238,348
3405-000,2015,1,26,1,54,103,157,238
3405-000,2015,1,26,2,37,61,98,157
3405-000,2015,1,26,3,38,51,89,98
3405-000,2015,1,26,4,47,54,101,89
3405-000,2015,1,26,5,79,94,173,101
3405-000,2015,1,26,6,197,186,383,173
3405-000,2015,1,26,7,408,452,860,383
3405-000,2015,1,26,8,845,1232,2077,860
3405-000,2015,1,26,9,1049,1083,2132,2077
3405-000,2015,1,26,10,819,761,1580,2132
3405-000,2015,1,26,11,905,782,1687,1580
3405-000,2015,1,26,12,840,775,1615,1687
3405-000,2015,1,26,13,728,758,1486,1615
3405-000,2015,1,26,14,841,827,1668,1486
3405-000,2015,1,26,15,940,859,1799,1668
3405-000,2015,1,26,16,911,856,1767,1799
3405-000,2015,1,26,17,898,785,1683,1767
3405-000,2015,1,26,18,861,843,1704,1683
3405-000,2015,1,26,19,806,802,1608,1704
3405-000,2015,1,26,20,514,514,1028,1608
3405-000,2015,1,26,21,440,469,909,1028
3405-000,2015,1,26,22,300,354,654,909
3405-000,2015,1,26,23,225,188,413,654
3405-000,2015,1,26,24,99,153,252,413
3405-000,2015,1,27,1,71,74,145,252
3405-000,2015,1,27,2,47,63,110,145
3405-000,2015,1,27,3,39,62,101,110
3405-000,2015,1,27,4,49,61,110,101
3405-000,2015,1,27,5,90,107,197,110
3405-000,2015,1,27,6,171,150,321,197
3405-000,2015,1,27,7,357,344,701,321
3405-000,2015,1,27,8,878,1012,1890,701
3405-000,2015,1,27,9,1117,1058,2175,1890
3405-000,2015,1,27,10,931,886,1817,2175
3405-000,2015,1,27,11,985,876,1861,1817
3405-000,2015,1,27,12,904,796,1700,1861
3405-000,2015,1,27,13,721,701,1422,1700
3405-000,2015,1,27,14,886,855,1741,1422
3405-000,2015,1,27,15,1061,900,1961,1741
3405-000,2015,1,27,16,1022,837,1859,1961
3405-000,2015,1,27,17,951,822,1773,1859
3405-000,2015,1,27,18,925,923,1848,1773
3405-000,2015,1,27,19,879,844,1723,1848
3405-000,2015,1,27,20,529,542,1071,1723
3405-000,2015,1,27,21,475,509,984,1071
3405-000,2015,1,27,22,311,358,669,984
3405-000,2015,1,27,23,239,192,431,669
3405-000,2015,1,27,24,137,120,257,431
3405-000,2015,1,28,1,79,111,190,257
3405-000,2015,1,28,2,58,67,125,190
3405-000,2015,1,28,3,28,53,81,125
3405-000,2015,1,28,4,53,70,123,81
3405-000,2015,1,28,5,67,82,149,123
3405-000,2015,1,28,6,163,154,317,149
3405-000,2015,1,28,7,371,327,698,317
3405-000,2015,1,28,8,847,969,1816,698
3405-000,2015,1,28,9,1094,1038,2132,1816
3405-000,2015,1,28,10,967,831,1798,2132
3405-000,2015,1,28,11,942,860,1802,1798
3405-000,2015,1,28,12,906,781,1687,1802
3405-000,2015,1,28,13,763,705,1468,1687
3405-000,2015,1,28,14,884,878,1762,1468
3405-000,2015,1,28,15,978,905,1883,1762
3405-000,2015,1,28,16,943,895,1838,1883
3405-000,2015,1,28,17,962,820,1782,1838
3405-000,2015,1,28,18,1009,892,1901,1782
3405-000,2015,1,28,19,939,861,1800,1901
3405-000,2015,1,28,20,585,541,1126,1800
3405-000,2015,1,28,21,435,442,877,1126
3405-000,2015,1,28,22,332,299,631,877
3405-000,2015,1,28,23,255,212,467,631
3405-000,2015,1,28,24,128,157,285,467
3405-000,2015,1,29,1,94,116,210,285
3405-000,2015,1,29,2,63,66,129,210
3405-000,2015,1,29,3,45,61,106,129
3405-000,2015,1,29,4,47,73,120,106
3405-000,2015,1,29,5,88,83,171,120
3405-000,2015,1,29,6,164,157,321,171
3405-000,2015,1,29,7,378,330,708,321
3405-000,2015,1,29,8,839,995,1834,708
3405-000,2015,1,29,9,1149,1079,2228,1834
3405-000,2015,1,29,10,976,834,1810,2228
3405-000,2015,1,29,11,973,872,1845,1810
3405-000,2015,1,29,12,903,866,1769,1845
3405-000,2015,1,29,13,834,707,1541,1769
3405-000,2015,1,29,14,870,882,1752,1541
3405-000,2015,1,29,15,923,904,1827,1752
3405-000,2015,1,29,16,997,839,1836,1827
3405-000,2015,1,29,17,928,827,1755,1836
3405-000,2015,1,29,18,931,844,1775,1755
3405-000,2015,1,29,19,846,835,1681,1775
3405-000,2015,1,29,20,547,542,1089,1681
3405-000,2015,1,29,21,459,466,925,1089
3405-000,2015,1,29,22,309,351,660,925
3405-000,2015,1,29,23,214,217,431,660
3405-000,2015,1,29,24,137,161,298,431
3405-000,2015,1,30,1,87,117,204,298
3405-000,2015,1,30,2,63,79,142,204
3405-000,2015,1,30,3,50,59,109,142
3405-000,2015,1,30,4,44,56,100,109
3405-000,2015,1,30,5,64,88,152,100
3405-000,2015,1,30,6,171,155,326,152
3405-000,2015,1,30,7,376,334,710,326
3405-000,2015,1,30,8,811,985,1796,710
3405-000,2015,1,30,9,1171,1046,2217,1796
3405-000,2015,1,30,10,923,871,1794,2217
3405-000,2015,1,30,11,1008,889,1897,1794
3405-000,2015,1,30,12,967,910,1877,1897
3405-000,2015,1,30,13,783,729,1512,1877
3405-000,2015,1,30,14,912,855,1767,1512
3405-000,2015,1,30,15,1051,924,1975,1767
3405-000,2015,1,30,16,991,838,1829,1975
3405-000,2015,1,30,17,1020,820,1840,1829
3405-000,2015,1,30,18,1147,930,2077,1840
3405-000,2015,1,30,19,1202,945,2147,2077
3405-000,2015,1,30,20,791,604,1395,2147
3405-000,2015,1,30,21,583,496,1079,1395
3405-000,2015,1,30,22,421,352,773,1079
3405-000,2015,1,30,23,246,187,433,773
3405-000,2015,1,30,24,151,139,290,433
3405-000,2015,1,31,1,117,120,237,290
3405-000,2015,1,31,2,74,105,179,237
3405-000,2015,1,31,3,49,59,108,179
3405-000,2015,1,31,4,58,66,124,108
3405-000,2015,1,31,5,76,79,155,124
3405-000,2015,1,31,6,130,138,268,155
3405-000,2015,1,31,7,292,238,530,268
3405-000,2015,1,31,8,624,444,1068,530
3405-000,2015,1,31,9,807,624,1431,1068
3405-000,2015,1,31,10,801,626,1427,1431
3405-000,2015,1,31,11,853,651,1504,1427
3405-000,2015,1,31,12,780,620,1400,1504
3405-000,2015,1,31,13,671,616,1287,1400
3405-000,2015,1,31,14,724,638,1362,1287
3405-000,2015,1,31,15,705,631,1336,1362
3405-000,2015,1,31,16,725,593,1318,1336
3405-000,2015,1,31,17,727,645,1372,1318
3405-000,2015,1,31,18,822,817,1639,1372
3405-000,2015,1,31,19,568,546,1114,1639
3405-000,2015,1,31,20,327,357,684,1114
3405-000,2015,1,31,21,302,276,578,684
3405-000,2015,1,31,22,249,228,477,578
3405-000,2015,1,31,23,160,162,322,477
3405-000,2015,1,31,24,107,106,213,322
3405-000,2015,2,1,1,65,66,131,213
3405-000,2015,2,1,2,39,44,83,131
3405-000,2015,2,1,3,35,42,77,83
3405-000,2015,2,1,4,25,32,57,77
3405-000,2015,2,1,5,34,36,70,57
3405-000,2015,2,1,6,76,60,136,70
3405-000,2015,2,1,7,140,103,243,136
3405-000,2015,2,1,8,234,207,441,243
3405-000,2015,2,1,9,293,235,528,441
3405-000,2015,2,1,10,365,293,658,528
3405-000,2015,2,1,11,450,359,809,658
3405-000,2015,2,1,12,409,401,810,809
3405-000,2015,2,1,13,426,475,901,810
3405-000,2015,2,1,14,486,431,917,901
3405-000,2015,2,1,15,484,541,1025,917
3405-000,2015,2,1,16,510,599,1109,1025
3405-000,2015,2,1,17,571,596,1167,1109
3405-000,2015,2,1,18,536,587,1123,1167
3405-000,2015,2,1,19,429,466,895,1123
3405-000,2015,2,1,20,322,404,726,895
3405-000,2015,2,1,21,266,302,568,726
3405-000,2015,2,1,22,226,267,493,568
3405-000,2015,2,1,23,148,256,404,493
3405-000,2015,2,1,24,72,151,223,404
3405-000,2015,2,2,1,65,97,162,223
3405-000,2015,2,2,2,39,64,103,162
3405-000,2015,2,2,3,33,46,79,103
3405-000,2015,2,2,4,40,45,85,79
3405-000,2015,2,2,5,82,95,177,85
3405-000,2015,2,2,6,182,197,379,177
3405-000,2015,2,2,7,429,482,911,379
3405-000,2015,2,2,8,916,1308,2224,911
3405-000,2015,2,2,9,1109,1153,2262,2224
3405-000,2015,2,2,10,880,778,1658,2262
3405-000,2015,2,2,11,915,818,1733,1658
3405-000,2015,2,2,12,906,794,1700,1733
3405-000,2015,2,2,13,721,695,1416,1700
3405-000,2015,2,2,14,850,871,1721,1416
3405-000,2015,2,2,15,1038,1000,2038,1721
3405-000,2015,2,2,16,978,907,1885,2038
3405-000,2015,2,2,17,927,815,1742,1885
3405-000,2015,2,2,18,972,856,1828,1742
3405-000,2015,2,2,19,895,800,1695,1828
3405-000,2015,2,2,20,593,587,1180,1695
3405-000,2015,2,2,21,482,481,963,1180
3405-000,2015,2,2,22,340,349,689,963
3405-000,2015,2,2,23,227,222,449,689
3405-000,2015,2,2,24,123,149,272,449
3405-000,2015,2,3,1,77,110,187,272
3405-000,2015,2,3,2,48,68,116,187
3405-000,2015,2,3,3,53,64,117,116
3405-000,2015,2,3,4,59,70,129,117
3405-000,2015,2,3,5,66,93,159,129
3405-000,2015,2,3,6,146,174,320,159
3405-000,2015,2,3,7,397,342,739,320
3405-000,2015,2,3,8,881,1124,2005,739
3405-000,2015,2,3,9,1154,1127,2281,2005
3405-000,2015,2,3,10,949,839,1788,2281
3405-000,2015,2,3,11,1040,891,1931,1788
3405-000,2015,2,3,12,955,869,1824,1931
3405-000,2015,2,3,13,788,789,1577,1824
3405-000,2015,2,3,14,894,824,1718,1577
3405-000,2015,2,3,15,1027,924,1951,1718
3405-000,2015,2,3,16,1007,897,1904,1951
3405-000,2015,2,3,17,1007,866,1873,1904
3405-000,2015,2,3,18,1007,872,1879,1873
3405-000,2015,2,3,19,900,851,1751,1879
3405-000,2015,2,3,20,606,571,1177,1751
3405-000,2015,2,3,21,479,472,951,1177
3405-000,2015,2,3,22,366,339,705,951
3405-000,2015,2,3,23,244,207,451,705
3405-000,2015,2,3,24,134,151,285,451
3405-000,2015,2,4,1,76,103,179,285
3405-000,2015,2,4,2,49,52,101,179
3405-000,2015,2,4,3,44,63,107,101
3405-000,2015,2,4,4,53,59,112,107
3405-000,2015,2,4,5,85,74,159,112
3405-000,2015,2,4,6,157,165,322,159
3405-000,2015,2,4,7,374,349,723,322
3405-000,2015,2,4,8,858,1026,1884,723
3405-000,2015,2,4,9,1138,1115,2253,1884
3405-000,2015,2,4,10,1052,804,1856,2253
3405-000,2015,2,4,11,934,951,1885,1856
3405-000,2015,2,4,12,933,991,1924,1885
3405-000,2015,2,4,13,779,841,1620,1924
3405-000,2015,2,4,14,893,878,1771,1620
3405-000,2015,2,4,15,1023,858,1881,1771
3405-000,2015,2,4,16,980,832,1812,1881
3405-000,2015,2,4,17,939,827,1766,1812
3405-000,2015,2,4,18,987,915,1902,1766
3405-000,2015,2,4,19,976,866,1842,1902
3405-000,2015,2,4,20,604,503,1107,1842
3405-000,2015,2,4,21,386,456,842,1107
3405-000,2015,2,4,22,340,329,669,842
3405-000,2015,2,4,23,246,192,438,669
3405-000,2015,2,4,24,132,151,283,438
3405-000,2015,2,5,1,92,105,197,283
3405-000,2015,2,5,2,38,70,108,197
3405-000,2015,2,5,3,56,59,115,108
3405-000,2015,2,5,4,49,65,114,115
3405-000,2015,2,5,5,71,100,171,114
3405-000,2015,2,5,6,176,171,347,171
3405-000,2015,2,5,7,371,347,718,347
3405-000,2015,2,5,8,856,1051,1907,718
3405-000,2015,2,5,9,1161,1171,2332,1907
3405-000,2015,2,5,10,1013,809,1822,2332
3405-000,2015,2,5,11,985,894,1879,1822
3405-000,2015,2,5,12,992,834,1826,1879
3405-000,2015,2,5,13,779,752,1531,1826
3405-000,2015,2,5,14,855,865,1720,1531
3405-000,2015,2,5,15,1058,921,1979,1720
3405-000,2015,2,5,16,1041,875,1916,1979
3405-000,2015,2,5,17,957,968,1925,1916
3405-000,2015,2,5,18,1067,894,1961,1925
3405-000,2015,2,5,19,905,862,1767,1961
3405-000,2015,2,5,20,624,558,1182,1767
3405-000,2015,2,5,21,516,468,984,1182
3405-000,2015,2,5,22,334,357,691,984
3405-000,2015,2,5,23,239,226,465,691
3405-000,2015,2,5,24,146,151,297,465
3405-000,2015,2,6,1,104,104,208,297
3405-000,2015,2,6,2,52,78,130,208
3405-000,2015,2,6,3,54,72,126,130
3405-000,2015,2,6,4,60,87,147,126
3405-000,2015,2,6,5,83,87,170,147
3405-000,2015,2,6,6,148,171,319,170
3405-000,2015,2,6,7,382,361,743,319
3405-000,2015,2,6,8,835,1053,1888,743
3405-000,2015,2,6,9,1128,1141,2269,1888
3405-000,2015,2,6,10,1029,836,1865,2269
3405-000,2015,2,6,11,1022,901,1923,1865
3405-000,2015,2,6,12,1025,870,1895,1923
3405-000,2015,2,6,13,830,769,1599,1895
3405-000,2015,2,6,14,903,901,1804,1599
3405-000,2015,2,6,15,1097,953,2050,1804
3405-000,2015,2,6,16,1029,923,1952,2050
3405-000,2015,2,6,17,1004,886,1890,1952
3405-000,2015,2,6,18,1196,940,2136,1890
3405-000,2015,2,6,19,1171,948,2119,2136
3405-000,2015,2,6,20,800,621,1421,2119
3405-000,2015,2,6,21,541,464,1005,1421
3405-000,2015,2,6,22,398,360,758,1005
3405-000,2015,2,6,23,279,216,495,758
3405-000,2015,2,6,24,126,162,288,495
3405-000,2015,2,7,1,116,123,239,288
3405-000,2015,2,7,2,56,73,129,239
3405-000,2015,2,7,3,49,72,121,129
3405-000,2015,2,7,4,52,68,120,121
3405-000,2015,2,7,5,83,77,160,120
3405-000,2015,2,7,6,145,143,288,160
3405-000,2015,2,7,7,288,246,534,288
3405-000,2015,2,7,8,584,499,1083,534
3405-000,2015,2,7,9,815,584,1399,1083
3405-000,2015,2,7,10,810,625,1435,1399
3405-000,2015,2,7,11,799,645,1444,1435
3405-000,2015,2,7,12,795,649,1444,1444
3405-000,2015,2,7,13,718,657,1375,1444
3405-000,2015,2,7,14,733,620,1353,1375
3405-000,2015,2,7,15,767,629,1396,1353
3405-000,2015,2,7,16,708,652,1360,1396
3405-000,2015,2,7,17,740,668,1408,1360
3405-000,2015,2,7,18,839,804,1643,1408
3405-000,2015,2,7,19,628,577,1205,1643
3405-000,2015,2,7,20,386,415,801,1205
3405-000,2015,2,7,21,304,296,600,801
3405-000,2015,2,7,22,257,230,487,600
3405-000,2015,2,7,23,182,169,351,487
3405-000,2015,2,7,24,101,137,238,351
3405-000,2015,2,8,1,65,92,157,238
3405-000,2015,2,8,2,53,58,111,157
3405-000,2015,2,8,3,36,21,57,111
3405-000,2015,2,8,4,39,40,79,57
3405-000,2015,2,8,5,26,30,56,79
3405-000,2015,2,8,6,65,69,134,56
3405-000,2015,2,8,7,143,102,245,134
3405-000,2015,2,8,8,216,229,445,245
3405-000,2015,2,8,9,338,296,634,445
3405-000,2015,2,8,10,417,276,693,634
3405-000,2015,2,8,11,462,348,810,693
3405-000,2015,2,8,12,385,420,805,810
3405-000,2015,2,8,13,370,392,762,805
3405-000,2015,2,8,14,454,459,913,762
3405-000,2015,2,8,15,486,497,983,913
3405-000,2015,2,8,16,449,491,940,983
3405-000,2015,2,8,17,481,518,999,940
3405-000,2015,2,8,18,462,519,981,999
3405-000,2015,2,8,19,367,419,786,981
3405-000,2015,2,8,20,305,346,651,786
3405-000,2015,2,8,21,242,304,546,651
3405-000,2015,2,8,22,216,249,465,546
3405-000,2015,2,8,23,137,237,374,465
3405-000,2015,2,8,24,83,129,212,374
3405-000,2015,2,9,1,49,73,122,212
3405-000,2015,2,9,2,51,58,109,122
3405-000,2015,2,9,3,27,46,73,109
3405-000,2015,2,9,4,40,57,97,73
3405-000,2015,2,9,5,66,64,130,97
3405-000,2015,2,9,6,165,204,369,130
3405-000,2015,2,9,7,435,478,913,369
3405-000,2015,2,9,8,895,1285,2180,913
3405-000,2015,2,9,9,1102,1150,2252,2180
3405-000,2015,2,9,10,904,796,1700,2252
3405-000,2015,2,9,11,919,816,1735,1700
3405-000,2015,2,9,12,851,825,1676,1735
3405-000,2015,2,9,13,723,713,1436,1676
3405-000,2015,2,9,14,847,853,1700,1436
3405-000,2015,2,9,15,1003,874,1877,1700
3405-000,2015,2,9,16,946,874,1820,1877
3405-000,2015,2,9,17,923,799,1722,1820
3405-000,2015,2,9,18,959,784,1743,1722
3405-000,2015,2,9,19,881,853,1734,1743
3405-000,2015,2,9,20,592,563,1155,1734
3405-000,2015,2,9,21,483,420,903,1155
3405-000,2015,2,9,22,311,370,681,903
3405-000,2015,2,9,23,225,203,428,681
3405-000,2015,2,9,24,126,147,273,428
3405-000,2015,2,10,1,73,84,157,273
3405-000,2015,2,10,2,45,79,124,157
3405-000,2015,2,10,3,44,58,102,124
3405-000,2015,2,10,4,59,60,119,102
3405-000,2015,2,10,5,86,85,171,119
3405-000,2015,2,10,6,162,145,307,171
3405-000,2015,2,10,7,382,314,696,307
3405-000,2015,2,10,8,850,1033,1883,696
3405-000,2015,2,10,9,1184,1102,2286,1883
3405-000,2015,2,10,10,964,815,1779,2286
3405-000,2015,2,10,11,1028,905,1933,1779
3405-000,2015,2,10,12,969,921,1890,1933
3405-000,2015,2,10,13,776,810,1586,1890
3405-000,2015,2,10,14,943,931,1874,1586
3405-000,2015,2,10,15,1078,954,2032,1874
3405-000,2015,2,10,16,1096,893,1989,2032
3405-000,2015,2,10,17,950,880,1830,1989
3405-000,2015,2,10,18,993,859,1852,1830
3405-000,2015,2,10,19,878,871,1749,1852
3405-000,2015,2,10,20,634,523,1157,1749
3405-000,2015,2,10,21,485,491,976,1157
3405-000,2015,2,10,22,359,336,695,976
3405-000,2015,2,10,23,246,231,477,695
3405-000,2015,2,10,24,147,159,306,477
3405-000,2015,2,11,1,89,107,196,306
3405-000,2015,2,11,2,58,76,134,196
3405-000,2015,2,11,3,42,63,105,134
3405-000,2015,2,11,4,43,68,111,105
3405-000,2015,2,11,5,83,77,160,111
3405-000,2015,2,11,6,148,170,318,160
3405-000,2015,2,11,7,345,332,677,318
3405-000,2015,2,11,8,880,1010,1890,677
3405-000,2015,2,11,9,1149,1123,2272,1890
3405-000,2015,2,11,10,950,877,1827,2272
3405-000,2015,2,11,11,1030,951,1981,1827
3405-000,2015,2,11,12,966,840,1806,1981
3405-000,2015,2,11,13,802,782,1584,1806
3405-000,2015,2,11,14,971,975,1946,1584
3405-000,2015,2,11,15,1086,1034,2120,1946
3405-000,2015,2,11,16,1053,882,1935,2120
3405-000,2015,2,11,17,1039,916,1955,1935
3405-000,2015,2,11,18,1096,954,2050,1955
3405-000,2015,2,11,19,962,856,1818,2050
3405-000,2015,2,11,20,589,549,1138,1818
3405-000,2015,2,11,21,471,477,948,1138
3405-000,2015,2,11,22,361,332,693,948
3405-000,2015,2,11,23,237,233,470,693
3405-000,2015,2,11,24,151,149,300,470
3405-000,2015,2,12,1,89,119,208,300
3405-000,2015,2,12,2,57,72,129,208
3405-000,2015,2,12,3,54,59,113,129
3405-000,2015,2,12,4,53,54,107,113
3405-000,2015,2,12,5,99,104,203,107
3405-000,2015,2,12,6,162,132,294,203
3405-000,2015,2,12,7,394,359,753,294
3405-000,2015,2,12,8,908,1011,1919,753
3405-000,2015,2,12,9,1131,1127,2258,1919
3405-000,2015,2,12,10,1017,839,1856,2258
3405-000,2015,2,12,11,1046,901,1947,1856
3405-000,2015,2,12,12,986,882,1868,1947
3405-000,2015,2,12,13,802,819,1621,1868
3405-000,2015,2,12,14,941,875,1816,1621
3405-000,2015,2,12,15,1120,973,2093,1816
3405-000,2015,2,12,16,1130,933,2063,2093
3405-000,2015,2,12,17,1035,984,2019,2063
3405-000,2015,2,12,18,1004,946,1950,2019
3405-000,2015,2,12,19,882,894,1776,1950
3405-000,2015,2,12,20,666,627,1293,1776
3405-000,2015,2,12,21,499,443,942,1293
3405-000,2015,2,12,22,384,401,785,942
3405-000,2015,2,12,23,237,230,467,785
3405-000,2015,2,12,24,162,193,355,467
3405-000,2015,2,13,1,95,95,190,355
3405-000,2015,2,13,2,59,78,137,190
3405-000,2015,2,13,3,45,60,105,137
3405-000,2015,2,13,4,44,68,112,105
3405-000,2015,2,13,5,88,104,192,112
3405-000,2015,2,13,6,165,158,323,192
3405-000,2015,2,13,7,376,367,743,323
3405-000,2015,2,13,8,892,997,1889,743
3405-000,2015,2,13,9,1196,1112,2308,1889
3405-000,2015,2,13,10,1012,939,1951,2308
3405-000,2015,2,13,11,984,986,1970,1951
3405-000,2015,2,13,12,1083,918,2001,1970
3405-000,2015,2,13,13,869,894,1763,2001
3405-000,2015,2,13,14,958,974,1932,1763
3405-000,2015,2,13,15,1140,987,2127,1932
3405-000,2015,2,13,16,1055,989,2044,2127
3405-000,2015,2,13,17,1082,886,1968,2044
3405-000,2015,2,13,18,1238,950,2188,1968
3405-000,2015,2,13,19,1296,997,2293,2188
3405-000,2015,2,13,20,781,619,1400,2293
3405-000,2015,2,13,21,623,522,1145,1400
3405-000,2015,2,13,22,428,377,805,1145
3405-000,2015,2,13,23,276,227,503,805
3405-000,2015,2,13,24,161,163,324,503
3405-000,2015,2,14,1,109,122,231,324
3405-000,2015,2,14,2,78,89,167,231
3405-000,2015,2,14,3,58,65,123,167
3405-000,2015,2,14,4,62,71,133,123
3405-000,2015,2,14,5,80,98,178,133
3405-000,2015,2,14,6,162,121,283,178
3405-000,2015,2,14,7,301,237,538,283
3405-000,2015,2,14,8,602,504,1106,538
3405-000,2015,2,14,9,857,643,1500,1106
3405-000,2015,2,14,10,819,656,1475,1500
3405-000,2015,2,14,11,836,715,1551,1475
3405-000,2015,2,14,12,834,710,1544,1551
3405-000,2015,2,14,13,730,631,1361,1544
3405-000,2015,2,14,14,736,721,1457,1361
3405-000,2015,2,14,15,753,646,1399,1457
3405-000,2015,2,14,16,717,662,1379,1399
3405-000,2015,2,14,17,757,658,1415,1379
3405-000,2015,2,14,18,819,736,1555,1415
3405-000,2015,2,14,19,633,561,1194,1555
3405-000,2015,2,14,20,404,394,798,1194
3405-000,2015,2,14,21,310,280,590,798
3405-000,2015,2,14,22,251,266,517,590
3405-000,2015,2,14,23,192,154,346,517
3405-000,2015,2,14,24,99,133,232,346
3405-000,2015,2,15,1,89,71,160,232
3405-000,2015,2,15,2,55,43,98,160
3405-000,2015,2,15,3,30,36,66,98
3405-000,2015,2,15,4,33,38,71,66
3405-000,2015,2,15,5,33,35,68,71
3405-000,2015,2,15,6,92,74,166,68
3405-000,2015,2,15,7,134,134,268,166
3405-000,2015,2,15,8,293,235,528,268
3405-000,2015,2,15,9,443,341,784,528
3405-000,2015,2,15,10,436,333,769,784
3405-000,2015,2,15,11,454,401,855,769
3405-000,2015,2,15,12,405,444,849,855
3405-000,2015,2,15,13,439,434,873,849
3405-000,2015,2,15,14,499,471,970,873
3405-000,2015,2,15,15,517,480,997,970
3405-000,2015,2,15,16,476,481,957,997
3405-000,2015,2,15,17,505,552,1057,957
3405-000,2015,2,15,18,558,589,1147,1057
3405-000,2015,2,15,19,403,450,853,1147
3405-000,2015,2,15,20,311,340,651,853
3405-000,2015,2,15,21,260,295,555,651
3405-000,2015,2,15,22,226,243,469,555
3405-000,2015,2,15,23,156,205,361,469
3405-000,2015,2,15,24,94,127,221,361
3405-000,2015,2,16,1,66,78,144,221
3405-000,2015,2,16,2,49,79,128,144
3405-000,2015,2,16,3,40,45,85,128
3405-000,2015,2,16,4,41,52,93,85
3405-000,2015,2,16,5,66,88,154,93
3405-000,2015,2,16,6,192,155,347,154
3405-000,2015,2,16,7,401,398,799,347
3405-000,2015,2,16,8,841,1206,2047,799
3405-000,2015,2,16,9,1094,1099,2193,2047
3405-000,2015,2,16,10,902,783,1685,2193
3405-000,2015,2,16,11,988,882,1870,1685
3405-000,2015,2,16,12,929,875,1804,1870
3405-000,2015,2,16,13,823,784,1607,1804
3405-000,2015,2,16,14,931,954,1885,1607
3405-000,2015,2,16,15,1089,1042,2131,1885
3405-000,2015,2,16,16,1037,992,2029,2131
3405-000,2015,2,16,17,1071,864,1935,2029
3405-000,2015,2,16,18,992,872,1864,1935
3405-000,2015,2,16,19,887,852,1739,1864
3405-000,2015,2,16,20,622,590,1212,1739
3405-000,2015,2,16,21,506,449,955,1212
3405-000,2015,2,16,22,330,376,706,955
3405-000,2015,2,16,23,241,229,470,706
3405-000,2015,2,16,24,163,160,323,470
3405-000,2015,2,17,1,87,115,202,323
3405-000,2015,2,17,2,80,93,173,202
3405-000,2015,2,17,3,58,46,104,173
3405-000,2015,2,17,4,50,58,108,104
3405-000,2015,2,17,5,87,86,173,108
3405-000,2015,2,17,6,142,146,288,173
3405-000,2015,2,17,7,351,278,629,288
3405-000,2015,2,17,8,765,889,1654,629
3405-000,2015,2,17,9,1086,992,2078,1654
3405-000,2015,2,17,10,860,694,1554,2078
3405-000,2015,2,17,11,1001,861,1862,1554
3405-000,2015,2,17,12,972,772,1744,1862
3405-000,2015,2,17,13,802,718,1520,1744
3405-000,2015,2,17,14,953,810,1763,1520
3405-000,2015,2,17,15,1080,839,1919,1763
3405-000,2015,2,17,16,1266,964,2230,1919
3405-000,2015,2,17,17,1250,980,2230,2230
3405-000,2015,2,17,18,1074,1314,2388,2230
3405-000,2015,2,17,19,950,914,1864,2388
3405-000,2015,2,17,20,711,689,1400,1864
3405-000,2015,2,17,21,639,592,1231,1400
3405-000,2015,2,17,22,568,570,1138,1231
3405-000,2015,2,17,23,311,469,780,1138
3405-000,2015,2,17,24,151,336,487,780
3405-000,2015,2,18,1,106,176,282,487
3405-000,2015,2,18,2,75,114,189,282
3405-000,2015,2,18,3,61,71,132,189
3405-000,2015,2,18,4,69,67,136,132
3405-000,2015,2,18,5,68,89,157,136
3405-000,2015,2,18,6,191,104,295,157
3405-000,2015,2,18,7,294,154,448,295
3405-000,2015,2,18,8,374,385,759,448
3405-000,2015,2,18,9,626,808,1434,759
3405-000,2015,2,18,10,797,503,1300,1434
3405-000,2015,2,18,11,928,678,1606,1300
3405-000,2015,2,18,12,822,823,1645,1606
3405-000,2015,2,18,13,750,709,1459,1645
3405-000,2015,2,18,14,595,921,1516,1459
3405-000,2015,2,18,15,464,538,1002,1516
3405-000,2015,2,18,16,413,520,933,1002
3405-000,2015,2,18,17,378,393,771,933
3405-000,2015,2,18,18,320,314,634,771
3405-000,2015,2,18,19,271,241,512,634
3405-000,2015,2,18,20,216,189,405,512
3405-000,2015,2,18,21,196,172,368,405
3405-000,2015,2,18,22,132,123,255,368
3405-000,2015,2,18,23,112,100,212,255
3405-000,2015,2,18,24,74,51,125,212
3405-000,2015,2,19,1,46,59,105,125
3405-000,2015,2,19,2,28,24,52,105
3405-000,2015,2,19,3,24,18,42,52
3405-000,2015,2,19,4,23,21,44,42
3405-000,2015,2,19,5,23,11,34,44
3405-000,2015,2,19,6,78,48,126,34
3405-000,2015,2,19,7,203,114,317,126
3405-000,2015,2,19,8,336,243,579,317
3405-000,2015,2,19,9,324,228,552,579
3405-000,2015,2,19,10,460,197,657,552
3405-000,2015,2,19,11,702,357,1059,657
3405-000,2015,2,19,12,855,616,1471,1059
3405-000,2015,2,19,13,1023,714,1737,1471
3405-000,2015,2,19,14,959,693,1652,1737
3405-000,2015,2,19,15,1010,793,1803,1652
3405-000,2015,2,19,16,1167,848,2015,1803
3405-000,2015,2,19,17,1017,1049,2066,2015
3405-000,2015,2,19,18,849,850,1699,2066
3405-000,2015,2,19,19,762,717,1479,1699
3405-000,2015,2,19,20,543,644,1187,1479
3405-000,2015,2,19,21,408,570,978,1187
3405-000,2015,2,19,22,229,341,570,978
3405-000,2015,2,19,23,141,237,378,570
3405-000,2015,2,19,24,90,163,253,378
3405-000,2015,2,20,1,61,93,154,253
3405-000,2015,2,20,2,40,65,105,154
3405-000,2015,2,20,3,20,37,57,105
3405-000,2015,2,20,4,11,20,31,57
3405-000,2015,2,20,5,31,22,53,31
3405-000,2015,2,20,6,78,43,121,53
3405-000,2015,2,20,7,92,51,143,121
3405-000,2015,2,20,8,129,125,254,143
3405-000,2015,2,20,9,214,175,389,254
3405-000,2015,2,20,10,347,257,604,389
3405-000,2015,2,20,11,470,391,861,604
3405-000,2015,2,20,12,557,553,1110,861
3405-000,2015,2,20,13,554,537,1091,1110
3405-000,2015,2,20,14,539,541,1080,1091
3405-000,2015,2,20,15,463,607,1070,1080
3405-000,2015,2,20,16,492,631,1123,1070
3405-000,2015,2,20,17,593,566,1159,1123
3405-000,2015,2,20,18,545,504,1049,1159
3405-000,2015,2,20,19,467,478,945,1049
3405-000,2015,2,20,20,411,390,801,945
3405-000,2015,2,20,21,463,364,827,801
3405-000,2015,2,20,22,353,355,708,827
3405-000,2015,2,20,23,164,345,509,708
3405-000,2015,2,20,24,106,243,349,509
3405-000,2015,2,21,1,79,232,311,349
3405-000,2015,2,21,2,72,125,197,311
3405-000,2015,2,21,3,38,45,83,197
3405-000,2015,2,21,4,31,43,74,83
3405-000,2015,2,21,5,47,35,82,74
3405-000,2015,2,21,6,95,64,159,82
3405-000,2015,2,21,7,111,98,209,159
3405-000,2015,2,21,8,211,213,424,209
3405-000,2015,2,21,9,373,262,635,424
3405-000,2015,2,21,10,401,316,717,635
3405-000,2015,2,21,11,428,380,808,717
3405-000,2015,2,21,12,465,449,914,808
3405-000,2015,2,21,13,479,471,950,914
3405-000,2015,2,21,14,456,498,954,950
3405-000,2015,2,21,15,481,526,1007,954
3405-000,2015,2,21,16,510,545,1055,1007
3405-000,2015,2,21,17,503,546,1049,1055
3405-000,2015,2,21,18,539,554,1093,1049
3405-000,2015,2,21,19,454,426,880,1093
3405-000,2015,2,21,20,326,391,717,880
3405-000,2015,2,21,21,220,400,620,717
3405-000,2015,2,21,22,187,248,435,620
3405-000,2015,2,21,23,144,191,335,435
3405-000,2015,2,21,24,75,97,172,335
3405-000,2015,2,22,1,64,72,136,172
3405-000,2015,2,22,2,37,59,96,136
3405-000,2015,2,22,3,19,31,50,96
3405-000,2015,2,22,4,21,27,48,50
3405-000,2015,2,22,5,35,23,58,48
3405-000,2015,2,22,6,49,44,93,58
3405-000,2015,2,22,7,103,54,157,93
3405-000,2015,2,22,8,149,146,295,157
3405-000,2015,2,22,9,339,203,542,295
3405-000,2015,2,22,10,327,202,529,542
3405-000,2015,2,22,11,377,262,639,529
3405-000,2015,2,22,12,332,349,681,639
3405-000,2015,2,22,13,401,382,783,681
3405-000,2015,2,22,14,407,442,849,783
3405-000,2015,2,22,15,462,482,944,849
3405-000,2015,2,22,16,466,506,972,944
3405-000,2015,2,22,17,410,531,941,972
3405-000,2015,2,22,18,395,517,912,941
3405-000,2015,2,22,19,378,412,790,912
3405-000,2015,2,22,20,263,357,620,790
3405-000,2015,2,22,21,275,292,567,620
3405-000,2015,2,22,22,209,251,460,567
3405-000,2015,2,22,23,123,222,345,460
3405-000,2015,2,22,24,85,126,211,345
3405-000,2015,2,23,1,60,91,151,211
3405-000,2015,2,23,2,35,54,89,151
3405-000,2015,2,23,3,28,55,83,89
3405-000,2015,2,23,4,38,71,109,83
3405-000,2015,2,23,5,74,81,155,109
3405-000,2015,2,23,6,194,206,400,155
3405-000,2015,2,23,7,416,431,847,400
3405-000,2015,2,23,8,952,1293,2245,847
3405-000,2015,2,23,9,1085,1126,2211,2245
3405-000,2015,2,23,10,899,743,1642,2211
3405-000,2015,2,23,11,952,797,1749,1642
3405-000,2015,2,23,12,835,822,1657,1749
3405-000,2015,2,23,13,721,715,1436,1657
3405-000,2015,2,23,14,819,801,1620,1436
3405-000,2015,2,23,15,846,844,1690,1620
3405-000,2015,2,23,16,948,831,1779,1690
3405-000,2015,2,23,17,913,811,1724,1779
3405-000,2015,2,23,18,918,857,1775,1724
3405-000,2015,2,23,19,871,841,1712,1775
3405-000,2015,2,23,20,595,553,1148,1712
3405-000,2015,2,23,21,487,472,959,1148
3405-000,2015,2,23,22,359,367,726,959
3405-000,2015,2,23,23,190,209,399,726
3405-000,2015,2,23,24,113,151,264,399
3405-000,2015,2,24,1,60,104,164,264
3405-000,2015,2,24,2,36,81,117,164
3405-000,2015,2,24,3,46,60,106,117
3405-000,2015,2,24,4,39,56,95,106
3405-000,2015,2,24,5,65,103,168,95
3405-000,2015,2,24,6,116,181,297,168
3405-000,2015,2,24,7,353,324,677,297
3405-000,2015,2,24,8,849,1074,1923,677
3405-000,2015,2,24,9,1189,1158,2347,1923
3405-000,2015,2,24,10,965,838,1803,2347
3405-000,2015,2,24,11,1044,891,1935,1803
3405-000,2015,2,24,12,955,845,1800,1935
3405-000,2015,2,24,13,828,823,1651,1800
3405-000,2015,2,24,14,912,926,1838,1651
3405-000,2015,2,24,15,1033,958,1991,1838
3405-000,2015,2,24,16,1019,880,1899,1991
3405-000,2015,2,24,17,995,876,1871,1899
3405-000,2015,2,24,18,1056,903,1959,1871
3405-000,2015,2,24,19,868,851,1719,1959
3405-000,2015,2,24,20,628,612,1240,1719
3405-000,2015,2,24,21,511,521,1032,1240
3405-000,2015,2,24,22,346,380,726,1032
3405-000,2015,2,24,23,234,215,449,726
3405-000,2015,2,24,24,121,146,267,449
3405-000,2015,2,25,1,84,104,188,267
3405-000,2015,2,25,2,57,71,128,188
3405-000,2015,2,25,3,35,38,73,128
3405-000,2015,2,25,4,30,69,99,73
3405-000,2015,2,25,5,60,94,154,99
3405-000,2015,2,25,6,119,152,271,154
3405-000,2015,2,25,7,332,343,675,271
3405-000,2015,2,25,8,854,1001,1855,675
3405-000,2015,2,25,9,1101,1169,2270,1855
3405-000,2015,2,25,10,999,870,1869,2270
3405-000,2015,2,25,11,1013,840,1853,1869
3405-000,2015,2,25,12,966,847,1813,1853
3405-000,2015,2,25,13,751,804,1555,1813
3405-000,2015,2,25,14,872,948,1820,1555
3405-000,2015,2,25,15,1089,904,1993,1820
3405-000,2015,2,25,16,971,935,1906,1993
3405-000,2015,2,25,17,1020,853,1873,1906
3405-000,2015,2,25,18,1076,910,1986,1873
3405-000,2015,2,25,19,954,896,1850,1986
3405-000,2015,2,25,20,686,608,1294,1850
3405-000,2015,2,25,21,467,487,954,1294
3405-000,2015,2,25,22,371,346,717,954
3405-000,2015,2,25,23,239,234,473,717
3405-000,2015,2,25,24,155,150,305,473
3405-000,2015,2,26,1,87,126,213,305
3405-000,2015,2,26,2,60,81,141,213
3405-000,2015,2,26,3,40,60,100,141
3405-000,2015,2,26,4,53,64,117,100
3405-000,2015,2,26,5,92,92,184,117
3405-000,2015,2,26,6,174,163,337,184
3405-000,2015,2,26,7,351,330,681,337
3405-000,2015,2,26,8,865,1024,1889,681
3405-000,2015,2,26,9,1211,1182,2393,1889
3405-000,2015,2,26,10,918,849,1767,2393
3405-000,2015,2,26,11,1021,911,1932,1767
3405-000,2015,2,26,12,950,877,1827,1932
3405-000,2015,2,26,13,837,778,1615,1827
3405-000,2015,2,26,14,881,916,1797,1615
3405-000,2015,2,26,15,997,922,1919,1797
3405-000,2015,2,26,16,1039,914,1953,1919
3405-000,2015,2,26,17,1008,811,1819,1953
3405-000,2015,2,26,18,1033,911,1944,1819
3405-000,2015,2,26,19,920,862,1782,1944
3405-000,2015,2,26,20,630,547,1177,1782
3405-000,2015,2,26,21,524,521,1045,1177
3405-000,2015,2,26,22,343,338,681,1045
3405-000,2015,2,26,23,247,218,465,681
3405-000,2015,2,26,24,171,160,331,465
3405-000,2015,2,27,1,100,126,226,331
3405-000,2015,2,27,2,54,78,132,226
3405-000,2015,2,27,3,36,53,89,132
3405-000,2015,2,27,4,54,74,128,89
3405-000,2015,2,27,5,74,101,175,128
3405-000,2015,2,27,6,140,159,299,175
3405-000,2015,2,27,7,385,336,721,299
3405-000,2015,2,27,8,884,992,1876,721
3405-000,2015,2,27,9,1160,1136,2296,1876
3405-000,2015,2,27,10,1026,860,1886,2296
3405-000,2015,2,27,11,1072,828,1900,1886
3405-000,2015,2,27,12,951,893,1844,1900
3405-000,2015,2,27,13,816,811,1627,1844
3405-000,2015,2,27,14,873,867,1740,1627
3405-000,2015,2,27,15,1066,1008,2074,1740
3405-000,2015,2,27,16,1063,845,1908,2074
3405-000,2015,2,27,17,1054,837,1891,1908
3405-000,2015,2,27,18,1136,989,2125,1891
3405-000,2015,2,27,19,1178,1025,2203,2125
3405-000,2015,2,27,20,811,742,1553,2203
3405-000,2015,2,27,21,570,550,1120,1553
3405-000,2015,2,27,22,396,367,763,1120
3405-000,2015,2,27,23,274,232,506,763
3405-000,2015,2,27,24,149,153,302,506
3405-000,2015,2,28,1,115,123,238,302
3405-000,2015,2,28,2,71,72,143,238
3405-000,2015,2,28,3,54,45,99,143
3405-000,2015,2,28,4,46,83,129,99
3405-000,2015,2,28,5,98,79,177,129
3405-000,2015,2,28,6,163,120,283,177
3405-000,2015,2,28,7,299,233,532,283
3405-000,2015,2,28,8,593,535,1128,532
3405-000,2015,2,28,9,824,634,1458,1128
3405-000,2015,2,28,10,763,654,1417,1458
3405-000,2015,2,28,11,875,640,1515,1417
3405-000,2015,2,28,12,773,654,1427,1515
3405-000,2015,2,28,13,684,657,1341,1427
3405-000,2015,2,28,14,737,708,1445,1341
3405-000,2015,2,28,15,738,679,1417,1445
3405-000,2015,2,28,16,749,693,1442,1417
3405-000,2015,2,28,17,731,764,1495,1442
3405-000,2015,2,28,18,830,828,1658,1495
3405-000,2015,2,28,19,634,775,1409,1658
3405-000,2015,2,28,20,509,518,1027,1409
3405-000,2015,2,28,21,319,385,704,1027
3405-000,2015,2,28,22,328,303,631,704
3405-000,2015,2,28,23,205,181,386,631
3405-000,2015,2,28,24,110,137,247,386
3405-000,2015,3,1,1,84,79,163,247
3405-000,2015,3,1,2,62,65,127,163
3405-000,2015,3,1,3,40,25,65,127
3405-000,2015,3,1,4,27,29,56,65
3405-000,2015,3,1,5,48,34,82,56
3405-000,2015,3,1,6,68,63,131,82
3405-000,2015,3,1,7,133,111,244,131
3405-000,2015,3,1,8,230,206,436,244
3405-000,2015,3,1,9,337,290,627,436
3405-000,2015,3,1,10,378,300,678,627
3405-000,2015,3,1,11,477,336,813,678
3405-000,2015,3,1,12,463,396,859,813
3405-000,2015,3,1,13,418,449,867,859
3405-000,2015,3,1,14,469,481,950,867
3405-000,2015,3,1,15,501,566,1067,950
3405-000,2015,3,1,16,523,630,1153,1067
3405-000,2015,3,1,17,552,663,1215,1153
3405-000,2015,3,1,18,561,687,1248,1215
3405-000,2015,3,1,19,509,656,1165,1248
3405-000,2015,3,1,20,398,457,855,1165
3405-000,2015,3,1,21,323,343,666,855
3405-000,2015,3,1,22,267,351,618,666
3405-000,2015,3,1,23,181,220,401,618
3405-000,2015,3,1,24,71,159,230,401
3405-000,2015,3,2,1,60,87,147,230
3405-000,2015,3,2,2,27,58,85,147
3405-000,2015,3,2,3,30,49,79,85
3405-000,2015,3,2,4,34,56,90,79
3405-000,2015,3,2,5,74,79,153,90
3405-000,2015,3,2,6,199,217,416,153
3405-000,2015,3,2,7,446,459,905,416
3405-000,2015,3,2,8,961,1337,2298,905
3405-000,2015,3,2,9,1103,1204,2307,2298
3405-000,2015,3,2,10,949,818,1767,2307
3405-000,2015,3,2,11,903,835,1738,1767
3405-000,2015,3,2,12,946,832,1778,1738
3405-000,2015,3,2,13,736,759,1495,1778
3405-000,2015,3,2,14,834,847,1681,1495
3405-000,2015,3,2,15,1007,1088,2095,1681
3405-000,2015,3,2,16,928,1147,2075,2095
3405-000,2015,3,2,17,899,919,1818,2075
3405-000,2015,3,2,18,939,841,1780,1818
3405-000,2015,3,2,19,905,860,1765,1780
3405-000,2015,3,2,20,595,639,1234,1765
3405-000,2015,3,2,21,471,465,936,1234
3405-000,2015,3,2,22,380,330,710,936
3405-000,2015,3,2,23,228,214,442,710
3405-000,2015,3,2,24,136,142,278,442
3405-000,2015,3,3,1,81,123,204,278
3405-000,2015,3,3,2,40,65,105,204
3405-000,2015,3,3,3,34,53,87,105
3405-000,2015,3,3,4,53,75,128,87
3405-000,2015,3,3,5,78,76,154,128
3405-000,2015,3,3,6,153,183,336,154
3405-000,2015,3,3,7,412,358,770,336
3405-000,2015,3,3,8,907,1081,1988,770
3405-000,2015,3,3,9,1158,1048,2206,1988
3405-000,2015,3,3,10,1019,831,1850,2206
3405-000,2015,3,3,11,1052,891,1943,1850
3405-000,2015,3,3,12,967,867,1834,1943
3405-000,2015,3,3,13,718,753,1471,1834
3405-000,2015,3,3,14,893,862,1755,1471
3405-000,2015,3,3,15,1081,951,2032,1755
3405-000,2015,3,3,16,1007,933,1940,2032
3405-000,2015,3,3,17,958,837,1795,1940
3405-000,2015,3,3,18,940,798,1738,1795
3405-000,2015,3,3,19,883,797,1680,1738
3405-000,2015,3,3,20,582,566,1148,1680
3405-000,2015,3,3,21,456,493,949,1148
3405-000,2015,3,3,22,303,316,619,949
3405-000,2015,3,3,23,175,217,392,619
3405-000,2015,3,3,24,111,162,273,392
3405-000,2015,3,4,1,82,105,187,273
3405-000,2015,3,4,2,44,63,107,187
3405-000,2015,3,4,3,44,57,101,107
3405-000,2015,3,4,4,46,53,99,101
3405-000,2015,3,4,5,92,80,172,99
3405-000,2015,3,4,6,155,151,306,172
3405-000,2015,3,4,7,395,353,748,306
3405-000,2015,3,4,8,853,1015,1868,748
3405-000,2015,3,4,9,1153,1121,2274,1868
3405-000,2015,3,4,10,972,843,1815,2274
3405-000,2015,3,4,11,1014,882,1896,1815
3405-000,2015,3,4,12,963,827,1790,1896
3405-000,2015,3,4,13,733,746,1479,1790
3405-000,2015,3,4,14,836,898,1734,1479
3405-000,2015,3,4,15,1065,925,1990,1734
3405-000,2015,3,4,16,894,844,1738,1990
3405-000,2015,3,4,17,940,787,1727,1738
3405-000,2015,3,4,18,994,897,1891,1727
3405-000,2015,3,4,19,967,884,1851,1891
3405-000,2015,3,4,20,580,557,1137,1851
3405-000,2015,3,4,21,481,444,925,1137
3405-000,2015,3,4,22,314,361,675,925
3405-000,2015,3,4,23,244,203,447,675
3405-000,2015,3,4,24,136,155,291,447
3405-000,2015,3,5,1,102,94,196,291
3405-000,2015,3,5,2,53,68,121,196
3405-000,2015,3,5,3,48,53,101,121
3405-000,2015,3,5,4,34,62,96,101
3405-000,2015,3,5,5,71,94,165,96
3405-000,2015,3,5,6,174,158,332,165
3405-000,2015,3,5,7,392,338,730,332
3405-000,2015,3,5,8,917,1118,2035,730
3405-000,2015,3,5,9,1200,1116,2316,2035
3405-000,2015,3,5,10,945,950,1895,2316
3405-000,2015,3,5,11,1029,912,1941,1895
3405-000,2015,3,5,12,973,891,1864,1941
3405-000,2015,3,5,13,814,779,1593,1864
3405-000,2015,3,5,14,872,864,1736,1593
3405-000,2015,3,5,15,1099,904,2003,1736
3405-000,2015,3,5,16,965,839,1804,2003
3405-000,2015,3,5,17,969,831,1800,1804
3405-000,2015,3,5,18,1012,891,1903,1800
3405-000,2015,3,5,19,861,898,1759,1903
3405-000,2015,3,5,20,618,562,1180,1759
3405-000,2015,3,5,21,486,451,937,1180
3405-000,2015,3,5,22,354,351,705,937
3405-000,2015,3,5,23,220,243,463,705
3405-000,2015,3,5,24,157,165,322,463
3405-000,2015,3,6,1,95,104,199,322
3405-000,2015,3,6,2,60,84,144,199
3405-000,2015,3,6,3,43,50,93,144
3405-000,2015,3,6,4,53,64,117,93
3405-000,2015,3,6,5,90,88,178,117
3405-000,2015,3,6,6,142,184,326,178
3405-000,2015,3,6,7,395,347,742,326
3405-000,2015,3,6,8,896,1086,1982,742
3405-000,2015,3,6,9,1162,1112,2274,1982
3405-000,2015,3,6,10,1010,917,1927,2274
3405-000,2015,3,6,11,1029,908,1937,1927
3405-000,2015,3,6,12,1014,900,1914,1937
3405-000,2015,3,6,13,794,728,1522,1914
3405-000,2015,3,6,14,938,869,1807,1522
3405-000,2015,3,6,15,994,914,1908,1807
3405-000,2015,3,6,16,1071,882,1953,1908
3405-000,2015,3,6,17,1043,840,1883,1953
3405-000,2015,3,6,18,1207,982,2189,1883
3405-000,2015,3,6,19,1238,1017,2255,2189
3405-000,2015,3,6,20,761,654,1415,2255
3405-000,2015,3,6,21,551,494,1045,1415
3405-000,2015,3,6,22,424,359,783,1045
3405-000,2015,3,6,23,281,235,516,783
3405-000,2015,3,6,24,202,172,374,516
3405-000,2015,3,7,1,129,122,251,374
3405-000,2015,3,7,2,80,80,160,251
3405-000,2015,3,7,3,51,59,110,160
3405-000,2015,3,7,4,49,62,111,110
3405-000,2015,3,7,5,70,73,143,111
3405-000,2015,3,7,6,149,135,284,143
3405-000,2015,3,7,7,307,249,556,284
3405-000,2015,3,7,8,609,540,1149,556
3405-000,2015,3,7,9,874,645,1519,1149
3405-000,2015,3,7,10,780,608,1388,1519
3405-000,2015,3,7,11,858,691,1549,1388
3405-000,2015,3,7,12,821,726,1547,1549
3405-000,2015,3,7,13,713,602,1315,1547
3405-000,2015,3,7,14,680,618,1298,1315
3405-000,2015,3,7,15,725,622,1347,1298
3405-000,2015,3,7,16,699,659,1358,1347
3405-000,2015,3,7,17,808,631,1439,1358
3405-000,2015,3,7,18,776,831,1607,1439
3405-000,2015,3,7,19,682,706,1388,1607
3405-000,2015,3,7,20,461,435,896,1388
3405-000,2015,3,7,21,372,355,727,896
3405-000,2015,3,7,22,253,232,485,727
3405-000,2015,3,7,23,187,163,350,485
3405-000,2015,3,7,24,98,145,243,350
3405-000,2015,3,8,1,73,68,141,243
3405-000,2015,3,8,2,36,53,89,141
3405-000,2015,3,8,3,32,33,65,89
3405-000,2015,3,8,4,29,32,61,65
3405-000,2015,3,8,5,37,23,60,61
3405-000,2015,3,8,6,70,56,126,60
3405-000,2015,3,8,7,135,125,260,126
3405-000,2015,3,8,8,309,207,516,260
3405-000,2015,3,8,9,360,289,649,516
3405-000,2015,3,8,10,430,292,722,649
3405-000,2015,3,8,11,521,403,924,722
3405-000,2015,3,8,12,515,414,929,924
3405-000,2015,3,8,13,420,443,863,929
3405-000,2015,3,8,14,441,486,927,863
3405-000,2015,3,8,15,473,535,1008,927
3405-000,2015,3,8,16,555,570,1125,1008
3405-000,2015,3,8,17,562,584,1146,1125
3405-000,2015,3,8,18,549,580,1129,1146
3405-000,2015,3,8,19,430,530,960,1129
3405-000,2015,3,8,20,343,420,763,960
3405-000,2015,3,8,21,323,354,677,763
3405-000,2015,3,8,22,236,330,566,677
3405-000,2015,3,8,23,159,237,396,566
3405-000,2015,3,8,24,90,147,237,396
3405-000,2015,3,9,1,41,92,133,237
3405-000,2015,3,9,2,30,55,85,133
3405-000,2015,3,9,3,16,40,56,85
3405-000,2015,3,9,4,38,56,94,56
3405-000,2015,3,9,5,62,79,141,94
3405-000,2015,3,9,6,212,212,424,141
3405-000,2015,3,9,7,463,453,916,424
3405-000,2015,3,9,8,969,1376,2345,916
3405-000,2015,3,9,9,1182,1235,2417,2345
3405-000,2015,3,9,10,1016,861,1877,2417
3405-000,2015,3,9,11,962,842,1804,1877
3405-000,2015,3,9,12,922,849,1771,1804
3405-000,2015,3,9,13,762,761,1523,1771
3405-000,2015,3,9,14,802,851,1653,1523
3405-000,2015,3,9,15,1106,917,2023,1653
3405-000,2015,3,9,16,952,966,1918,2023
3405-000,2015,3,9,17,975,849,1824,1918
3405-000,2015,3,9,18,1010,901,1911,1824
3405-000,2015,3,9,19,909,868,1777,1911
3405-000,2015,3,9,20,677,616,1293,1777
3405-000,2015,3,9,21,475,486,961,1293
3405-000,2015,3,9,22,373,370,743,961
3405-000,2015,3,9,23,238,218,456,743
3405-000,2015,3,9,24,141,147,288,456
3405-000,2015,3,10,1,100,98,198,288
3405-000,2015,3,10,2,43,45,88,198
3405-000,2015,3,10,3,45,64,109,88
3405-000,2015,3,10,4,52,66,118,109
3405-000,2015,3,10,5,88,88,176,118
3405-000,2015,3,10,6,149,147,296,176
3405-000,2015,3,10,7,387,356,743,296
3405-000,2015,3,10,8,927,1112,2039,743
3405-000,2015,3,10,9,1152,1166,2318,2039
3405-000,2015,3,10,10,966,909,1875,2318
3405-000,2015,3,10,11,1008,852,1860,1875
3405-000,2015,3,10,12,972,888,1860,1860
3405-000,2015,3,10,13,816,734,1550,1860
3405-000,2015,3,10,14,918,882,1800,1550
3405-000,2015,3,10,15,1007,964,1971,1800
3405-000,2015,3,10,16,1022,927,1949,1971
3405-000,2015,3,10,17,971,841,1812,1949
3405-000,2015,3,10,18,994,846,1840,1812
3405-000,2015,3,10,19,936,865,1801,1840
3405-000,2015,3,10,20,631,598,1229,1801
3405-000,2015,3,10,21,503,484,987,1229
3405-000,2015,3,10,22,328,342,670,987
3405-000,2015,3,10,23,240,199,439,670
3405-000,2015,3,10,24,126,164,290,439
3405-000,2015,3,11,1,66,100,166,290
3405-000,2015,3,11,2,72,62,134,166
3405-000,2015,3,11,3,41,50,91,134
3405-000,2015,3,11,4,34,53,87,91
3405-000,2015,3,11,5,75,81,156,87
3405-000,2015,3,11,6,161,142,303,156
3405-000,2015,3,11,7,413,354,767,303
3405-000,2015,3,11,8,941,1114,2055,767
3405-000,2015,3,11,9,1220,1158,2378,2055
3405-000,2015,3,11,10,1020,874,1894,2378
3405-000,2015,3,11,11,1023,929,1952,1894
3405-000,2015,3,11,12,983,842,1825,1952
3405-000,2015,3,11,13,734,773,1507,1825
3405-000,2015,3,11,14,860,866,1726,1507
3405-000,2015,3,11,15,1023,968,1991,1726
3405-000,2015,3,11,16,1000,899,1899,1991
3405-000,2015,3,11,17,1008,769,1777,1899
3405-000,2015,3,11,18,985,925,1910,1777
3405-000,2015,3,11,19,973,892,1865,1910
3405-000,2015,3,11,20,606,552,1158,1865
3405-000,2015,3,11,21,455,432,887,1158
3405-000,2015,3,11,22,359,333,692,887
3405-000,2015,3,11,23,245,212,457,692
3405-000,2015,3,11,24,147,138,285,457
3405-000,2015,3,12,1,68,84,152,285
3405-000,2015,3,12,2,50,68,118,152
3405-000,2015,3,12,3,40,52,92,118
3405-000,2015,3,12,4,40,65,105,92
3405-000,2015,3,12,5,82,76,158,105
3405-000,2015,3,12,6,157,176,333,158
3405-000,2015,3,12,7,386,351,737,333
3405-000,2015,3,12,8,945,1071,2016,737
3405-000,2015,3,12,9,1187,1197,2384,2016
3405-000,2015,3,12,10,1012,944,1956,2384
3405-000,2015,3,12,11,1071,1033,2104,1956
3405-000,2015,3,12,12,925,903,1828,2104
3405-000,2015,3,12,13,858,776,1634,1828
3405-000,2015,3,12,14,820,871,1691,1634
3405-000,2015,3,12,15,1047,937,1984,1691
3405-000,2015,3,12,16,936,936,1872,1984
3405-000,2015,3,12,17,984,887,1871,1872
3405-000,2015,3,12,18,1021,915,1936,1871
3405-000,2015,3,12,19,921,938,1859,1936
3405-000,2015,3,12,20,664,591,1255,1859
3405-000,2015,3,12,21,530,511,1041,1255
3405-000,2015,3,12,22,327,364,691,1041
3405-000,2015,3,12,23,279,236,515,691
3405-000,2015,3,12,24,151,139,290,515
3405-000,2015,3,13,1,89,96,185,290
3405-000,2015,3,13,2,55,66,121,185
3405-000,2015,3,13,3,40,64,104,121
3405-000,2015,3,13,4,62,58,120,104
3405-000,2015,3,13,5,68,86,154,120
3405-000,2015,3,13,6,161,136,297,154
3405-000,2015,3,13,7,415,345,760,297
3405-000,2015,3,13,8,886,999,1885,760
3405-000,2015,3,13,9,1138,1173,2311,1885
3405-000,2015,3,13,10,936,839,1775,2311
3405-000,2015,3,13,11,970,930,1900,1775
3405-000,2015,3,13,12,990,919,1909,1900
3405-000,2015,3,13,13,851,792,1643,1909
3405-000,2015,3,13,14,912,964,1876,1643
3405-000,2015,3,13,15,1090,1070,2160,1876
3405-000,2015,3,13,16,1017,986,2003,2160
3405-000,2015,3,13,17,1035,894,1929,2003
3405-000,2015,3,13,18,1165,971,2136,1929
3405-000,2015,3,13,19,1297,1039,2336,2136
3405-000,2015,3,13,20,810,689,1499,2336
3405-000,2015,3,13,21,624,515,1139,1499
3405-000,2015,3,13,22,396,384,780,1139
3405-000,2015,3,13,23,309,212,521,780
3405-000,2015,3,13,24,155,156,311,521
3405-000,2015,3,14,1,101,102,203,311
3405-000,2015,3,14,2,66,75,141,203
3405-000,2015,3,14,3,54,68,122,141
3405-000,2015,3,14,4,38,56,94,122
3405-000,2015,3,14,5,55,81,136,94
3405-000,2015,3,14,6,99,127,226,136
3405-000,2015,3,14,7,264,267,531,226
3405-000,2015,3,14,8,549,519,1068,531
3405-000,2015,3,14,9,823,633,1456,1068
3405-000,2015,3,14,10,779,674,1453,1456
3405-000,2015,3,14,11,877,739,1616,1453
3405-000,2015,3,14,12,783,642,1425,1616
3405-000,2015,3,14,13,695,648,1343,1425
3405-000,2015,3,14,14,694,628,1322,1343
3405-000,2015,3,14,15,766,649,1415,1322
3405-000,2015,3,14,16,799,680,1479,1415
3405-000,2015,3,14,17,719,682,1401,1479
3405-000,2015,3,14,18,822,801,1623,1401
3405-000,2015,3,14,19,692,719,1411,1623
3405-000,2015,3,14,20,426,465,891,1411
3405-000,2015,3,14,21,350,350,700,891
3405-000,2015,3,14,22,288,243,531,700
3405-000,2015,3,14,23,207,172,379,531
3405-000,2015,3,14,24,116,118,234,379
3405-000,2015,3,15,1,71,69,140,234
3405-000,2015,3,15,2,46,68,114,140
3405-000,2015,3,15,3,33,24,57,114
3405-000,2015,3,15,4,24,27,51,57
3405-000,2015,3,15,5,38,39,77,51
3405-000,2015,3,15,6,67,82,149,77
3405-000,2015,3,15,7,162,131,293,149
3405-000,2015,3,15,8,306,241,547,293
3405-000,2015,3,15,9,399,286,685,547
3405-000,2015,3,15,10,428,310,738,685
3405-000,2015,3,15,11,542,414,956,738
3405-000,2015,3,15,12,459,448,907,956
3405-000,2015,3,15,13,458,447,905,907
3405-000,2015,3,15,14,477,493,970,905
3405-000,2015,3,15,15,543,546,1089,970
3405-000,2015,3,15,16,530,561,1091,1089
3405-000,2015,3,15,17,525,587,1112,1091
3405-000,2015,3,15,18,592,675,1267,1112
3405-000,2015,3,15,19,487,574,1061,1267
3405-000,2015,3,15,20,360,484,844,1061
3405-000,2015,3,15,21,341,369,710,844
3405-000,2015,3,15,22,252,323,575,710
3405-000,2015,3,15,23,162,251,413,575
3405-000,2015,3,15,24,103,167,270,413
3405-000,2015,3,16,1,71,96,167,270
3405-000,2015,3,16,2,26,63,89,167
3405-000,2015,3,16,3,32,41,73,89
3405-000,2015,3,16,4,43,61,104,73
3405-000,2015,3,16,5,63,74,137,104
3405-000,2015,3,16,6,177,186,363,137
3405-000,2015,3,16,7,433,519,952,363
3405-000,2015,3,16,8,990,1334,2324,952
3405-000,2015,3,16,9,1170,1257,2427,2324
3405-000,2015,3,16,10,959,795,1754,2427
3405-000,2015,3,16,11,981,881,1862,1754
3405-000,2015,3,16,12,896,905,1801,1862
3405-000,2015,3,16,13,737,759,1496,1801
3405-000,2015,3,16,14,840,946,1786,1496
3405-000,2015,3,16,15,1017,963,1980,1786
3405-000,2015,3,16,16,1018,888,1906,1980
3405-000,2015,3,16,17,925,919,1844,1906
3405-000,2015,3,16,18,995,882,1877,1844
3405-000,2015,3,16,19,935,906,1841,1877
3405-000,2015,3,16,20,655,616,1271,1841
3405-000,2015,3,16,21,501,501,1002,1271
3405-000,2015,3,16,22,369,329,698,1002
3405-000,2015,3,16,23,243,224,467,698
3405-000,2015,3,16,24,181,130,311,467
3405-000,2015,3,17,1,88,110,198,311
3405-000,2015,3,17,2,60,81,141,198
3405-000,2015,3,17,3,34,50,84,141
3405-000,2015,3,17,4,43,69,112,84
3405-000,2015,3,17,5,85,91,176,112
3405-000,2015,3,17,6,144,167,311,176
3405-000,2015,3,17,7,406,412,818,311
3405-000,2015,3,17,8,915,1106,2021,818
3405-000,2015,3,17,9,1215,1259,2474,2021
3405-000,2015,3,17,10,1062,892,1954,2474
3405-000,2015,3,17,11,1021,950,1971,1954
3405-000,2015,3,17,12,980,868,1848,1971
3405-000,2015,3,17,13,814,766,1580,1848
3405-000,2015,3,17,14,898,887,1785,1580
3405-000,2015,3,17,15,1019,989,2008,1785
3405-000,2015,3,17,16,1001,895,1896,2008
3405-000,2015,3,17,17,983,876,1859,1896
3405-000,2015,3,17,18,1001,906,1907,1859
3405-000,2015,3,17,19,934,904,1838,1907
3405-000,2015,3,17,20,606,584,1190,1838
3405-000,2015,3,17,21,481,536,1017,1190
3405-000,2015,3,17,22,353,374,727,1017
3405-000,2015,3,17,23,263,214,477,727
3405-000,2015,3,17,24,134,159,293,477
3405-000,2015,3,18,1,83,120,203,293
3405-000,2015,3,18,2,53,89,142,203
3405-000,2015,3,18,3,45,47,92,142
3405-000,2015,3,18,4,43,70,113,92
3405-000,2015,3,18,5,76,75,151,113
3405-000,2015,3,18,6,158,156,314,151
3405-000,2015,3,18,7,389,340,729,314
3405-000,2015,3,18,8,868,991,1859,729
3405-000,2015,3,18,9,1102,1148,2250,1859
3405-000,2015,3,18,10,986,830,1816,2250
3405-000,2015,3,18,11,959,862,1821,1816
3405-000,2015,3,18,12,877,819,1696,1821
3405-000,2015,3,18,13,719,711,1430,1696
3405-000,2015,3,18,14,863,823,1686,1430
3405-000,2015,3,18,15,935,883,1818,1686
3405-000,2015,3,18,16,919,820,1739,1818
3405-000,2015,3,18,17,907,716,1623,1739
3405-000,2015,3,18,18,987,866,1853,1623
3405-000,2015,3,18,19,866,869,1735,1853
3405-000,2015,3,18,20,585,549,1134,1735
3405-000,2015,3,18,21,441,462,903,1134
3405-000,2015,3,18,22,333,330,663,903
3405-000,2015,3,18,23,237,200,437,663
3405-000,2015,3,18,24,116,155,271,437
3405-000,2015,3,19,1,87,96,183,271
3405-000,2015,3,19,2,62,74,136,183
3405-000,2015,3,19,3,43,57,100,136
3405-000,2015,3,19,4,48,59,107,100
3405-000,2015,3,19,5,75,96,171,107
3405-000,2015,3,19,6,149,188,337,171
3405-000,2015,3,19,7,416,347,763,337
3405-000,2015,3,19,8,920,1035,1955,763
3405-000,2015,3,19,9,1197,1164,2361,1955
3405-000,2015,3,19,10,932,907,1839,2361
3405-000,2015,3,19,11,1045,924,1969,1839
3405-000,2015,3,19,12,1032,916,1948,1969
3405-000,2015,3,19,13,776,752,1528,1948
3405-000,2015,3,19,14,894,844,1738,1528
3405-000,2015,3,19,15,1077,923,2000,1738
3405-000,2015,3,19,16,970,938,1908,2000
3405-000,2015,3,19,17,981,821,1802,1908
3405-000,2015,3,19,18,989,862,1851,1802
3405-000,2015,3,19,19,935,900,1835,1851
3405-000,2015,3,19,20,663,646,1309,1835
3405-000,2015,3,19,21,536,520,1056,1309
3405-000,2015,3,19,22,354,400,754,1056
3405-000,2015,3,19,23,268,224,492,754
3405-000,2015,3,19,24,145,139,284,492
3405-000,2015,3,20,1,96,102,198,284
3405-000,2015,3,20,2,57,75,132,198
3405-000,2015,3,20,3,45,54,99,132
3405-000,2015,3,20,4,58,51,109,99
3405-000,2015,3,20,5,76,87,163,109
3405-000,2015,3,20,6,179,149,328,163
3405-000,2015,3,20,7,415,396,811,328
3405-000,2015,3,20,8,895,1061,1956,811
3405-000,2015,3,20,9,1167,1196,2363,1956
3405-000,2015,3,20,10,1047,855,1902,2363
3405-000,2015,3,20,11,1069,918,1987,1902
3405-000,2015,3,20,12,1054,904,1958,1987
3405-000,2015,3,20,13,860,760,1620,1958
3405-000,2015,3,20,14,910,957,1867,1620
3405-000,2015,3,20,15,1029,952,1981,1867
3405-000,2015,3,20,16,985,989,1974,1981
3405-000,2015,3,20,17,1114,902,2016,1974
3405-000,2015,3,20,18,1249,959,2208,2016
3405-000,2015,3,20,19,1373,1037,2410,2208
3405-000,2015,3,20,20,841,707,1548,2410
3405-000,2015,3,20,21,549,556,1105,1548
3405-000,2015,3,20,22,424,374,798,1105
3405-000,2015,3,20,23,305,267,572,798
3405-000,2015,3,20,24,168,172,340,572
3405-000,2015,3,21,1,102,94,196,340
3405-000,2015,3,21,2,71,79,150,196
3405-000,2015,3,21,3,57,75,132,150
3405-000,2015,3,21,4,47,52,99,132
3405-000,2015,3,21,5,76,91,167,99
3405-000,2015,3,21,6,140,140,280,167
3405-000,2015,3,21,7,323,282,605,280
3405-000,2015,3,21,8,662,531,1193,605
3405-000,2015,3,21,9,796,665,1461,1193
3405-000,2015,3,21,10,895,687,1582,1461
3405-000,2015,3,21,11,903,734,1637,1582
3405-000,2015,3,21,12,821,801,1622,1637
3405-000,2015,3,21,13,722,698,1420,1622
3405-000,2015,3,21,14,725,661,1386,1420
3405-000,2015,3,21,15,743,671,1414,1386
3405-000,2015,3,21,16,768,722,1490,1414
3405-000,2015,3,21,17,797,681,1478,1490
3405-000,2015,3,21,18,842,776,1618,1478
3405-000,2015,3,21,19,729,684,1413,1618
3405-000,2015,3,21,20,506,469,975,1413
3405-000,2015,3,21,21,375,316,691,975
3405-000,2015,3,21,22,276,305,581,691
3405-000,2015,3,21,23,191,176,367,581
3405-000,2015,3,21,24,99,137,236,367
3405-000,2015,3,22,1,72,74,146,236
3405-000,2015,3,22,2,44,43,87,146
3405-000,2015,3,22,3,29,33,62,87
3405-000,2015,3,22,4,28,34,62,62
3405-000,2015,3,22,5,48,36,84,62
3405-000,2015,3,22,6,99,71,170,84
3405-000,2015,3,22,7,156,117,273,170
3405-000,2015,3,22,8,275,240,515,273
3405-000,2015,3,22,9,420,291,711,515
3405-000,2015,3,22,10,453,300,753,711
3405-000,2015,3,22,11,546,421,967,753
3405-000,2015,3,22,12,481,464,945,967
3405-000,2015,3,22,13,469,451,920,945
3405-000,2015,3,22,14,515,495,1010,920
3405-000,2015,3,22,15,536,516,1052,1010
3405-000,2015,3,22,16,569,580,1149,1052
3405-000,2015,3,22,17,597,629,1226,1149
3405-000,2015,3,22,18,552,642,1194,1226
3405-000,2015,3,22,19,546,528,1074,1194
3405-000,2015,3,22,20,359,418,777,1074
3405-000,2015,3,22,21,309,360,669,777
3405-000,2015,3,22,22,207,313,520,669
3405-000,2015,3,22,23,153,249,402,520
3405-000,2015,3,22,24,95,163,258,402
3405-000,2015,3,23,1,53,84,137,258
3405-000,2015,3,23,2,37,38,75,137
3405-000,2015,3,23,3,21,45,66,75
3405-000,2015,3,23,4,47,64,111,66
3405-000,2015,3,23,5,76,88,164,111
3405-000,2015,3,23,6,200,233,433,164
3405-000,2015,3,23,7,546,559,1105,433
3405-000,2015,3,23,8,1007,1418,2425,1105
3405-000,2015,3,23,9,1154,1206,2360,2425
3405-000,2015,3,23,10,967,851,1818,2360
3405-000,2015,3,23,11,983,940,1923,1818
3405-000,2015,3,23,12,908,815,1723,1923
3405-000,2015,3,23,13,739,833,1572,1723
3405-000,2015,3,23,14,898,934,1832,1572
3405-000,2015,3,23,15,998,947,1945,1832
3405-000,2015,3,23,16,969,903,1872,1945
3405-000,2015,3,23,17,1036,824,1860,1872
3405-000,2015,3,23,18,1062,868,1930,1860
3405-000,2015,3,23,19,915,914,1829,1930
3405-000,2015,3,23,20,667,577,1244,1829
3405-000,2015,3,23,21,500,481,981,1244
3405-000,2015,3,23,22,330,358,688,981
3405-000,2015,3,23,23,224,191,415,688
3405-000,2015,3,23,24,133,159,292,415
3405-000,2015,3,24,1,79,93,172,292
3405-000,2015,3,24,2,46,70,116,172
3405-000,2015,3,24,3,29,64,93,116
3405-000,2015,3,24,4,54,78,132,93
3405-000,2015,3,24,5,81,92,173,132
3405-000,2015,3,24,6,177,185,362,173
3405-000,2015,3,24,7,457,398,855,362
3405-000,2015,3,24,8,952,1124,2076,855
3405-000,2015,3,24,9,1180,1182,2362,2076
3405-000,2015,3,24,10,1014,907,1921,2362
3405-000,2015,3,24,11,1042,936,1978,1921
3405-000,2015,3,24,12,957,833,1790,1978
3405-000,2015,3,24,13,806,749,1555,1790
3405-000,2015,3,24,14,927,921,1848,1555
3405-000,2015,3,24,15,1050,954,2004,1848
3405-000,2015,3,24,16,1061,921,1982,2004
3405-000,2015,3,24,17,985,904,1889,1982
3405-000,2015,3,24,18,1068,947,2015,1889
3405-000,2015,3,24,19,945,888,1833,2015
3405-000,2015,3,24,20,662,641,1303,1833
3405-000,2015,3,24,21,513,509,1022,1303
3405-000,2015,3,24,22,360,355,715,1022
3405-000,2015,3,24,23,237,227,464,715
3405-000,2015,3,24,24,129,155,284,464
3405-000,2015,3,25,1,75,115,190,284
3405-000,2015,3,25,2,53,64,117,190
3405-000,2015,3,25,3,42,56,98,117
3405-000,2015,3,25,4,51,53,104,98
3405-000,2015,3,25,5,94,76,170,104
3405-000,2015,3,25,6,160,187,347,170
3405-000,2015,3,25,7,472,404,876,347
3405-000,2015,3,25,8,1015,1164,2179,876
3405-000,2015,3,25,9,1162,1114,2276,2179
3405-000,2015,3,25,10,1056,866,1922,2276
3405-000,2015,3,25,11,1035,929,1964,1922
3405-000,2015,3,25,12,975,862,1837,1964
3405-000,2015,3,25,13,769,804,1573,1837
3405-000,2015,3,25,14,890,957,1847,1573
3405-000,2015,3,25,15,1080,995,2075,1847
3405-000,2015,3,25,16,1002,933,1935,2075
3405-000,2015,3,25,17,958,834,1792,1935
3405-000,2015,3,25,18,1052,1000,2052,1792
3405-000,2015,3,25,19,1018,894,1912,2052
3405-000,2015,3,25,20,611,557,1168,1912
3405-000,2015,3,25,21,470,474,944,1168
3405-000,2015,3,25,22,320,334,654,944
3405-000,2015,3,25,23,256,191,447,654
3405-000,2015,3,25,24,145,174,319,447
3405-000,2015,3,26,1,74,112,186,319
3405-000,2015,3,26,2,60,61,121,186
3405-000,2015,3,26,3,46,54,100,121
3405-000,2015,3,26,4,45,75,120,100
3405-000,2015,3,26,5,87,110,197,120
3405-000,2015,3,26,6,204,197,401,197
3405-000,2015,3,26,7,484,430,914,401
3405-000,2015,3,26,8,1009,1173,2182,914
3405-000,2015,3,26,9,1187,1246,2433,2182
3405-000,2015,3,26,10,1042,917,1959,2433
3405-000,2015,3,26,11,1104,973,2077,1959
3405-000,2015,3,26,12,986,888,1874,2077
3405-000,2015,3,26,13,844,790,1634,1874
3405-000,2015,3,26,14,883,928,1811,1634
3405-000,2015,3,26,15,1033,938,1971,1811
3405-000,2015,3,26,16,1017,956,1973,1971
3405-000,2015,3,26,17,1024,892,1916,1973
3405-000,2015,3,26,18,1121,974,2095,1916
3405-000,2015,3,26,19,924,873,1797,2095
3405-000,2015,3,26,20,637,643,1280,1797
3405-000,2015,3,26,21,540,516,1056,1280
3405-000,2015,3,26,22,392,392,784,1056
3405-000,2015,3,26,23,246,234,480,784
3405-000,2015,3,26,24,147,172,319,480
3405-000,2015,3,27,1,92,116,208,319
3405-000,2015,3,27,2,61,87,148,208
3405-000,2015,3,27,3,50,70,120,148
3405-000,2015,3,27,4,54,63,117,120
3405-000,2015,3,27,5,94,104,198,117
3405-000,2015,3,27,6,198,158,356,198
3405-000,2015,3,27,7,472,427,899,356
3405-000,2015,3,27,8,947,1078,2025,899
3405-000,2015,3,27,9,1177,1143,2320,2025
3405-000,2015,3,27,10,1009,905,1914,2320
3405-000,2015,3,27,11,1121,879,2000,1914
3405-000,2015,3,27,12,1058,902,1960,2000
3405-000,2015,3,27,13,844,808,1652,1960
3405-000,2015,3,27,14,937,835,1772,1652
3405-000,2015,3,27,15,1046,967,2013,1772
3405-000,2015,3,27,16,1045,943,1988,2013
3405-000,2015,3,27,17,1080,896,1976,1988
3405-000,2015,3,27,18,1234,971,2205,1976
3405-000,2015,3,27,19,1280,1021,2301,2205
3405-000,2015,3,27,20,846,729,1575,2301
3405-000,2015,3,27,21,588,540,1128,1575
3405-000,2015,3,27,22,410,349,759,1128
3405-000,2015,3,27,23,282,196,478,759
3405-000,2015,3,27,24,163,156,319,478
3405-000,2015,3,28,1,109,127,236,319
3405-000,2015,3,28,2,73,89,162,236
3405-000,2015,3,28,3,66,70,136,162
3405-000,2015,3,28,4,53,67,120,136
3405-000,2015,3,28,5,84,91,175,120
3405-000,2015,3,28,6,175,149,324,175
3405-000,2015,3,28,7,371,286,657,324
3405-000,2015,3,28,8,686,562,1248,657
3405-000,2015,3,28,9,853,662,1515,1248
3405-000,2015,3,28,10,866,736,1602,1515
3405-000,2015,3,28,11,868,745,1613,1602
3405-000,2015,3,28,12,1065,759,1824,1613
3405-000,2015,3,28,13,843,641,1484,1824
3405-000,2015,3,28,14,771,731,1502,1484
3405-000,2015,3,28,15,760,645,1405,1502
3405-000,2015,3,28,16,745,693,1438,1405
3405-000,2015,3,28,17,751,667,1418,1438
3405-000,2015,3,28,18,806,847,1653,1418
3405-000,2015,3,28,19,728,690,1418,1653
3405-000,2015,3,28,20,471,490,961,1418
3405-000,2015,3,28,21,333,382,715,961
3405-000,2015,3,28,22,260,253,513,715
3405-000,2015,3,28,23,196,173,369,513
3405-000,2015,3,28,24,112,146,258,369
3405-000,2015,3,29,1,61,58,119,258
3405-000,2015,3,29,2,54,56,110,119
3405-000,2015,3,29,3,45,28,73,110
3405-000,2015,3,29,4,30,30,60,73
3405-000,2015,3,29,5,53,44,97,60
3405-000,2015,3,29,6,93,64,157,97
3405-000,2015,3,29,7,161,148,309,157
3405-000,2015,3,29,8,354,237,591,309
3405-000,2015,3,29,9,365,313,678,591
3405-000,2015,3,29,10,464,352,816,678
3405-000,2015,3,29,11,537,470,1007,816
3405-000,2015,3,29,12,495,449,944,1007
3405-000,2015,3,29,13,458,485,943,944
3405-000,2015,3,29,14,440,480,920,943
3405-000,2015,3,29,15,518,565,1083,920
3405-000,2015,3,29,16,525,573,1098,1083
3405-000,2015,3,29,17,564,623,1187,1098
3405-000,2015,3,29,18,599,627,1226,1187
3405-000,2015,3,29,19,524,569,1093,1226
3405-000,2015,3,29,20,410,477,887,1093
3405-000,2015,3,29,21,364,442,806,887
3405-000,2015,3,29,22,258,338,596,806
3405-000,2015,3,29,23,194,266,460,596
3405-000,2015,3,29,24,95,160,255,460
3405-000,2015,3,30,1,52,77,129,255
3405-000,2015,3,30,2,40,74,114,129
3405-000,2015,3,30,3,24,43,67,114
3405-000,2015,3,30,4,46,66,112,67
3405-000,2015,3,30,5,102,95,197,112
3405-000,2015,3,30,6,231,244,475,197
3405-000,2015,3,30,7,577,545,1122,475
3405-000,2015,3,30,8,1061,1488,2549,1122
3405-000,2015,3,30,9,1184,1260,2444,2549
3405-000,2015,3,30,10,977,883,1860,2444
3405-000,2015,3,30,11,926,874,1800,1860
3405-000,2015,3,30,12,926,884,1810,1800
3405-000,2015,3,30,13,789,795,1584,1810
3405-000,2015,3,30,14,780,911,1691,1584
3405-000,2015,3,30,15,999,950,1949,1691
3405-000,2015,3,30,16,1003,908,1911,1949
3405-000,2015,3,30,17,1037,846,1883,1911
3405-000,2015,3,30,18,1009,923,1932,1883
3405-000,2015,3,30,19,967,891,1858,1932
3405-000,2015,3,30,20,668,616,1284,1858
3405-000,2015,3,30,21,491,467,958,1284
3405-000,2015,3,30,22,377,384,761,958
3405-000,2015,3,30,23,254,222,476,761
3405-000,2015,3,30,24,140,143,283,476
3405-000,2015,3,31,1,76,102,178,283
3405-000,2015,3,31,2,65,67,132,178
3405-000,2015,3,31,3,39,63,102,132
3405-000,2015,3,31,4,49,74,123,102
3405-000,2015,3,31,5,99,93,192,123
3405-000,2015,3,31,6,197,189,386,192
3405-000,2015,3,31,7,472,445,917,386
3405-000,2015,3,31,8,968,1106,2074,917
3405-000,2015,3,31,9,1193,1123,2316,2074
3405-000,2015,3,31,10,1009,853,1862,2316
3405-000,2015,3,31,11,1037,893,1930,1862
3405-000,2015,3,31,12,941,836,1777,1930
3405-000,2015,3,31,13,772,767,1539,1777
3405-000,2015,3,31,14,937,890,1827,1539
3405-000,2015,3,31,15,978,910,1888,1827
3405-000,2015,3,31,16,937,897,1834,1888
3405-000,2015,3,31,17,940,859,1799,1834
3405-000,2015,3,31,18,986,863,1849,1799
3405-000,2015,3,31,19,861,848,1709,1849
3405-000,2015,3,31,20,557,549,1106,1709
3405-000,2015,3,31,21,457,458,915,1106
3405-000,2015,3,31,22,355,329,684,915
3405-000,2015,3,31,23,225,205,430,684
3405-000,2015,3,31,24,143,153,296,430
3405-000,2015,4,1,1,82,104,186,296
3405-000,2015,4,1,2,63,73,136,186
3405-000,2015,4,1,3,46,57,103,136
3405-000,2015,4,1,4,55,60,115,103
3405-000,2015,4,1,5,83,110,193,115
3405-000,2015,4,1,6,186,173,359,193
3405-000,2015,4,1,7,427,440,867,359
3405-000,2015,4,1,8,908,1024,1932,867
3405-000,2015,4,1,9,1152,1171,2323,1932
3405-000,2015,4,1,10,975,895,1870,2323
3405-000,2015,4,1,11,1020,946,1966,1870
3405-000,2015,4,1,12,1005,839,1844,1966
3405-000,2015,4,1,13,794,784,1578,1844
3405-000,2015,4,1,14,928,856,1784,1578
3405-000,2015,4,1,15,1003,924,1927,1784
3405-000,2015,4,1,16,1004,899,1903,1927
3405-000,2015,4,1,17,974,877,1851,1903
3405-000,2015,4,1,18,1102,909,2011,1851
3405-000,2015,4,1,19,1031,859,1890,2011
3405-000,2015,4,1,20,628,587,1215,1890
3405-000,2015,4,1,21,424,471,895,1215
3405-000,2015,4,1,22,329,370,699,895
3405-000,2015,4,1,23,240,211,451,699
3405-000,2015,4,1,24,130,125,255,451
3405-000,2015,4,2,1,84,96,180,255
3405-000,2015,4,2,2,66,75,141,180
3405-000,2015,4,2,3,40,60,100,141
3405-000,2015,4,2,4,61,64,125,100
3405-000,2015,4,2,5,98,112,210,125
3405-000,2015,4,2,6,200,182,382,210
3405-000,2015,4,2,7,480,425,905,382
3405-000,2015,4,2,8,975,1156,2131,905
3405-000,2015,4,2,9,1185,1159,2344,2131
3405-000,2015,4,2,10,966,870,1836,2344
3405-000,2015,4,2,11,1072,904,1976,1836
3405-000,2015,4,2,12,995,859,1854,1976
3405-000,2015,4,2,13,814,753,1567,1854
3405-000,2015,4,2,14,832,892,1724,1567
3405-000,2015,4,2,15,1025,924,1949,1724
3405-000,2015,4,2,16,988,952,1940,1949
3405-000,2015,4,2,17,1040,852,1892,1940
3405-000,2015,4,2,18,1068,896,1964,1892
3405-000,2015,4,2,19,951,845,1796,1964
3405-000,2015,4,2,20,582,576,1158,1796
3405-000,2015,4,2,21,510,487,997,1158
3405-000,2015,4,2,22,345,326,671,997
3405-000,2015,4,2,23,217,191,408,671
3405-000,2015,4,2,24,119,146,265,408
3405-000,2015,4,3,1,73,95,168,265
3405-000,2015,4,3,2,52,71,123,168
3405-000,2015,4,3,3,45,59,104,123
3405-000,2015,4,3,4,41,58,99,104
3405-000,2015,4,3,5,88,97,185,99
3405-000,2015,4,3,6,163,191,354,185
3405-000,2015,4,3,7,400,371,771,354
3405-000,2015,4,3,8,842,1024,1866,771
3405-000,2015,4,3,9,1132,1106,2238,1866
3405-000,2015,4,3,10,921,915,1836,2238
3405-000,2015,4,3,11,1041,851,1892,1836
3405-000,2015,4,3,12,999,816,1815,1892
3405-000,2015,4,3,13,809,782,1591,1815
3405-000,2015,4,3,14,898,919,1817,1591
3405-000,2015,4,3,15,1075,1004,2079,1817
3405-000,2015,4,3,16,1069,953,2022,2079
3405-000,2015,4,3,17,1041,815,1856,2022
3405-000,2015,4,3,18,1191,959,2150,1856
3405-000,2015,4,3,19,1241,1011,2252,2150
3405-000,2015,4,3,20,794,688,1482,2252
3405-000,2015,4,3,21,564,518,1082,1482
3405-000,2015,4,3,22,410,360,770,1082
3405-000,2015,4,3,23,303,260,563,770
3405-000,2015,4,3,24,178,158,336,563
3405-000,2015,4,4,1,108,126,234,336
3405-000,2015,4,4,2,72,80,152,234
3405-000,2015,4,4,3,59,46,105,152
3405-000,2015,4,4,4,36,62,98,105
3405-000,2015,4,4,5,97,77,174,98
3405-000,2015,4,4,6,186,143,329,174
3405-000,2015,4,4,7,414,292,706,329
3405-000,2015,4,4,8,674,532,1206,706
3405-000,2015,4,4,9,854,675,1529,1206
3405-000,2015,4,4,10,883,704,1587,1529
3405-000,2015,4,4,11,963,872,1835,1587
3405-000,2015,4,4,12,924,829,1753,1835
3405-000,2015,4,4,13,711,780,1491,1753
3405-000,2015,4,4,14,729,714,1443,1491
3405-000,2015,4,4,15,723,742,1465,1443
3405-000,2015,4,4,16,771,735,1506,1465
3405-000,2015,4,4,17,732,736,1468,1506
3405-000,2015,4,4,18,758,756,1514,1468
3405-000,2015,4,4,19,596,684,1280,1514
3405-000,2015,4,4,20,400,480,880,1280
3405-000,2015,4,4,21,379,381,760,880
3405-000,2015,4,4,22,246,259,505,760
3405-000,2015,4,4,23,182,175,357,505
3405-000,2015,4,4,24,86,116,202,357
3405-000,2015,4,5,1,81,79,160,202
3405-000,2015,4,5,2,28,44,72,160
3405-000,2015,4,5,3,33,24,57,72
3405-000,2015,4,5,4,22,22,44,57
3405-000,2015,4,5,5,32,35,67,44
3405-000,2015,4,5,6,96,59,155,67
3405-000,2015,4,5,7,181,131,312,155
3405-000,2015,4,5,8,308,252,560,312
3405-000,2015,4,5,9,403,301,704,560
3405-000,2015,4,5,10,496,336,832,704
3405-000,2015,4,5,11,483,415,898,832
3405-000,2015,4,5,12,421,448,869,898
3405-000,2015,4,5,13,454,464,918,869
3405-000,2015,4,5,14,447,492,939,918
3405-000,2015,4,5,15,490,627,1117,939
3405-000,2015,4,5,16,518,626,1144,1117
3405-000,2015,4,5,17,511,718,1229,1144
3405-000,2015,4,5,18,539,745,1284,1229
3405-000,2015,4,5,19,434,895,1329,1284
3405-000,2015,4,5,20,398,625,1023,1329
3405-000,2015,4,5,21,329,494,823,1023
3405-000,2015,4,5,22,305,410,715,823
3405-000,2015,4,5,23,181,321,502,715
3405-000,2015,4,5,24,97,167,264,502
3405-000,2015,4,6,1,60,106,166,264
3405-000,2015,4,6,2,45,63,108,166
3405-000,2015,4,6,3,25,39,64,108
3405-000,2015,4,6,4,36,53,89,64
3405-000,2015,4,6,5,84,82,166,89
3405-000,2015,4,6,6,207,235,442,166
3405-000,2015,4,6,7,502,592,1094,442
3405-000,2015,4,6,8,1034,1344,2378,1094
3405-000,2015,4,6,9,1083,1238,2321,2378
3405-000,2015,4,6,10,954,858,1812,2321
3405-000,2015,4,6,11,978,897,1875,1812
3405-000,2015,4,6,12,962,825,1787,1875
3405-000,2015,4,6,13,816,752,1568,1787
3405-000,2015,4,6,14,838,872,1710,1568
3405-000,2015,4,6,15,1019,1005,2024,1710
3405-000,2015,4,6,16,1018,899,1917,2024
3405-000,2015,4,6,17,1047,855,1902,1917
3405-000,2015,4,6,18,972,897,1869,1902
3405-000,2015,4,6,19,949,920,1869,1869
3405-000,2015,4,6,20,609,585,1194,1869
3405-000,2015,4,6,21,525,502,1027,1194
3405-000,2015,4,6,22,365,356,721,1027
3405-000,2015,4,6,23,226,220,446,721
3405-000,2015,4,6,24,127,143,270,446
3405-000,2015,4,7,1,84,90,174,270
3405-000,2015,4,7,2,49,67,116,174
3405-000,2015,4,7,3,37,54,91,116
3405-000,2015,4,7,4,48,67,115,91
3405-000,2015,4,7,5,85,94,179,115
3405-000,2015,4,7,6,172,175,347,179
3405-000,2015,4,7,7,458,429,887,347
3405-000,2015,4,7,8,1011,1167,2178,887
3405-000,2015,4,7,9,1144,1098,2242,2178
3405-000,2015,4,7,10,1010,889,1899,2242
3405-000,2015,4,7,11,1060,886,1946,1899
3405-000,2015,4,7,12,978,825,1803,1946
3405-000,2015,4,7,13,858,761,1619,1803
3405-000,2015,4,7,14,922,883,1805,1619
3405-000,2015,4,7,15,1076,928,2004,1805
3405-000,2015,4,7,16,975,876,1851,2004
3405-000,2015,4,7,17,990,863,1853,1851
3405-000,2015,4,7,18,1020,934,1954,1853
3405-000,2015,4,7,19,932,1021,1953,1954
3405-000,2015,4,7,20,597,580,1177,1953
3405-000,2015,4,7,21,518,512,1030,1177
3405-000,2015,4,7,22,391,377,768,1030
3405-000,2015,4,7,23,262,212,474,768
3405-000,2015,4,7,24,132,154,286,474
3405-000,2015,4,8,1,97,111,208,286
3405-000,2015,4,8,2,50,71,121,208
3405-000,2015,4,8,3,38,51,89,121
3405-000,2015,4,8,4,44,65,109,89
3405-000,2015,4,8,5,84,91,175,109
3405-000,2015,4,8,6,199,175,374,175
3405-000,2015,4,8,7,505,418,923,374
3405-000,2015,4,8,8,936,1121,2057,923
3405-000,2015,4,8,9,1143,1149,2292,2057
3405-000,2015,4,8,10,1068,901,1969,2292
3405-000,2015,4,8,11,1012,931,1943,1969
3405-000,2015,4,8,12,968,840,1808,1943
3405-000,2015,4,8,13,828,841,1669,1808
3405-000,2015,4,8,14,907,886,1793,1669
3405-000,2015,4,8,15,1014,928,1942,1793
3405-000,2015,4,8,16,1009,893,1902,1942
3405-000,2015,4,8,17,968,786,1754,1902
3405-000,2015,4,8,18,1036,963,1999,1754
3405-000,2015,4,8,19,1073,899,1972,1999
3405-000,2015,4,8,20,607,609,1216,1972
3405-000,2015,4,8,21,492,489,981,1216
3405-000,2015,4,8,22,333,320,653,981
3405-000,2015,4,8,23,238,234,472,653
3405-000,2015,4,8,24,131,146,277,472
3405-000,2015,4,9,1,91,107,198,277
3405-000,2015,4,9,2,69,74,143,198
3405-000,2015,4,9,3,57,70,127,143
3405-000,2015,4,9,4,46,78,124,127
3405-000,2015,4,9,5,99,78,177,124
3405-000,2015,4,9,6,191,189,380,177
3405-000,2015,4,9,7,496,429,925,380
3405-000,2015,4,9,8,970,1158,2128,925
3405-000,2015,4,9,9,1202,1123,2325,2128
3405-000,2015,4,9,10,1052,889,1941,2325
3405-000,2015,4,9,11,1050,916,1966,1941
3405-000,2015,4,9,12,938,881,1819,1966
3405-000,2015,4,9,13,815,802,1617,1819
3405-000,2015,4,9,14,919,883,1802,1617
3405-000,2015,4,9,15,1081,936,2017,1802
3405-000,2015,4,9,16,1069,900,1969,2017
3405-000,2015,4,9,17,1001,876,1877,1969
3405-000,2015,4,9,18,1026,902,1928,1877
3405-000,2015,4,9,19,944,941,1885,1928
3405-000,2015,4,9,20,605,621,1226,1885
3405-000,2015,4,9,21,507,502,1009,1226
3405-000,2015,4,9,22,385,394,779,1009
3405-000,2015,4,9,23,230,218,448,779
3405-000,2015,4,9,24,138,152,290,448
3405-000,2015,4,10,1,88,115,203,290
3405-000,2015,4,10,2,51,72,123,203
3405-000,2015,4,10,3,40,57,97,123
3405-000,2015,4,10,4,44,62,106,97
3405-000,2015,4,10,5,101,85,186,106
3405-000,2015,4,10,6,188,216,404,186
3405-000,2015,4,10,7,478,448,926,404
3405-000,2015,4,10,8,948,1155,2103,926
3405-000,2015,4,10,9,1117,1130,2247,2103
3405-000,2015,4,10,10,1052,862,1914,2247
3405-000,2015,4,10,11,1066,943,2009,1914
3405-000,2015,4,10,12,1028,866,1894,2009
3405-000,2015,4,10,13,877,857,1734,1894
3405-000,2015,4,10,14,910,914,1824,1734
3405-000,2015,4,10,15,1071,1009,2080,1824
3405-000,2015,4,10,16,1076,947,2023,2080
3405-000,2015,4,10,17,1110,878,1988,2023
3405-000,2015,4,10,18,1206,992,2198,1988
3405-000,2015,4,10,19,1416,1066,2482,2198
3405-000,2015,4,10,20,795,707,1502,2482
3405-000,2015,4,10,21,634,610,1244,1502
3405-000,2015,4,10,22,407,391,798,1244
3405-000,2015,4,10,23,313,239,552,798
3405-000,2015,4,10,24,176,149,325,552
3405-000,2015,4,11,1,104,126,230,325
3405-000,2015,4,11,2,83,79,162,230
3405-000,2015,4,11,3,61,72,133,162
3405-000,2015,4,11,4,47,67,114,133
3405-000,2015,4,11,5,80,80,160,114
3405-000,2015,4,11,6,181,178,359,160
3405-000,2015,4,11,7,409,306,715,359
3405-000,2015,4,11,8,715,568,1283,715
3405-000,2015,4,11,9,900,667,1567,1283
3405-000,2015,4,11,10,871,709,1580,1567
3405-000,2015,4,11,11,858,787,1645,1580
3405-000,2015,4,11,12,963,964,1927,1645
3405-000,2015,4,11,13,787,750,1537,1927
3405-000,2015,4,11,14,737,883,1620,1537
3405-000,2015,4,11,15,738,723,1461,1620
3405-000,2015,4,11,16,847,735,1582,1461
3405-000,2015,4,11,17,822,725,1547,1582
3405-000,2015,4,11,18,879,894,1773,1547
3405-000,2015,4,11,19,753,741,1494,1773
3405-000,2015,4,11,20,562,528,1090,1494
3405-000,2015,4,11,21,391,432,823,1090
3405-000,2015,4,11,22,312,282,594,823
3405-000,2015,4,11,23,217,210,427,594
3405-000,2015,4,11,24,120,130,250,427
3405-000,2015,4,12,1,91,91,182,250
3405-000,2015,4,12,2,39,66,105,182
3405-000,2015,4,12,3,39,38,77,105
3405-000,2015,4,12,4,19,28,47,77
3405-000,2015,4,12,5,67,28,95,47
3405-000,2015,4,12,6,108,94,202,95
3405-000,2015,4,12,7,202,137,339,202
3405-000,2015,4,12,8,356,261,617,339
3405-000,2015,4,12,9,466,330,796,617
3405-000,2015,4,12,10,522,367,889,796
3405-000,2015,4,12,11,549,438,987,889
3405-000,2015,4,12,12,527,432,959,987
3405-000,2015,4,12,13,455,481,936,959
3405-000,2015,4,12,14,497,519,1016,936
3405-000,2015,4,12,15,573,540,1113,1016
3405-000,2015,4,12,16,582,603,1185,1113
3405-000,2015,4,12,17,586,620,1206,1185
3405-000,2015,4,12,18,607,673,1280,1206
3405-000,2015,4,12,19,439,679,1118,1280
3405-000,2015,4,12,20,369,583,952,1118
3405-000,2015,4,12,21,388,454,842,952
3405-000,2015,4,12,22,270,385,655,842
3405-000,2015,4,12,23,175,282,457,655
3405-000,2015,4,12,24,115,147,262,457
3405-000,2015,4,13,1,66,109,175,262
3405-000,2015,4,13,2,32,61,93,175
3405-000,2015,4,13,3,40,50,90,93
3405-000,2015,4,13,4,45,68,113,90
3405-000,2015,4,13,5,86,104,190,113
3405-000,2015,4,13,6,217,250,467,190
3405-000,2015,4,13,7,554,587,1141,467
3405-000,2015,4,13,8,1027,1402,2429,1141
3405-000,2015,4,13,9,1118,1262,2380,2429
3405-000,2015,4,13,10,985,908,1893,2380
3405-000,2015,4,13,11,998,909,1907,1893
3405-000,2015,4,13,12,988,874,1862,1907
3405-000,2015,4,13,13,806,812,1618,1862
3405-000,2015,4,13,14,884,908,1792,1618
3405-000,2015,4,13,15,1091,965,2056,1792
3405-000,2015,4,13,16,998,959,1957,2056
3405-000,2015,4,13,17,981,867,1848,1957
3405-000,2015,4,13,18,976,855,1831,1848
3405-000,2015,4,13,19,909,925,1834,1831
3405-000,2015,4,13,20,639,590,1229,1834
3405-000,2015,4,13,21,491,474,965,1229
3405-000,2015,4,13,22,370,363,733,965
3405-000,2015,4,13,23,218,199,417,733
3405-000,2015,4,13,24,117,145,262,417
3405-000,2015,4,14,1,69,88,157,262
3405-000,2015,4,14,2,47,70,117,157
3405-000,2015,4,14,3,35,62,97,117
3405-000,2015,4,14,4,41,64,105,97
3405-000,2015,4,14,5,80,81,161,105
3405-000,2015,4,14,6,167,177,344,161
3405-000,2015,4,14,7,422,390,812,344
3405-000,2015,4,14,8,895,987,1882,812
3405-000,2015,4,14,9,1108,1157,2265,1882
3405-000,2015,4,14,10,903,838,1741,2265
3405-000,2015,4,14,11,919,907,1826,1741
3405-000,2015,4,14,12,1002,802,1804,1826
3405-000,2015,4,14,13,811,725,1536,1804
3405-000,2015,4,14,14,835,906,1741,1536
3405-000,2015,4,14,15,1034,874,1908,1741
3405-000,2015,4,14,16,991,909,1900,1908
3405-000,2015,4,14,17,946,809,1755,1900
3405-000,2015,4,14,18,934,815,1749,1755
3405-000,2015,4,14,19,919,862,1781,1749
3405-000,2015,4,14,20,583,524,1107,1781
3405-000,2015,4,14,21,518,452,970,1107
3405-000,2015,4,14,22,364,402,766,970
3405-000,2015,4,14,23,236,230,466,766
3405-000,2015,4,14,24,135,169,304,466
3405-000,2015,4,15,1,81,105,186,304
3405-000,2015,4,15,2,59,58,117,186
3405-000,2015,4,15,3,30,56,86,117
3405-000,2015,4,15,4,47,60,107,86
3405-000,2015,4,15,5,89,85,174,107
3405-000,2015,4,15,6,218,203,421,174
3405-000,2015,4,15,7,488,441,929,421
3405-000,2015,4,15,8,957,1096,2053,929
3405-000,2015,4,15,9,1146,1177,2323,2053
3405-000,2015,4,15,10,990,929,1919,2323
3405-000,2015,4,15,11,1075,951,2026,1919
3405-000,2015,4,15,12,980,916,1896,2026
3405-000,2015,4,15,13,842,810,1652,1896
3405-000,2015,4,15,14,929,909,1838,1652
3405-000,2015,4,15,15,1082,1006,2088,1838
3405-000,2015,4,15,16,1034,944,1978,2088
3405-000,2015,4,15,17,1022,858,1880,1978
3405-000,2015,4,15,18,1086,1026,2112,1880
3405-000,2015,4,15,19,1082,945,2027,2112
3405-000,2015,4,15,20,658,633,1291,2027
3405-000,2015,4,15,21,485,500,985,1291
3405-000,2015,4,15,22,379,371,750,985
3405-000,2015,4,15,23,255,244,499,750
3405-000,2015,4,15,24,153,153,306,499
3405-000,2015,4,16,1,92,97,189,306
3405-000,2015,4,16,2,51,78,129,189
3405-000,2015,4,16,3,42,64,106,129
3405-000,2015,4,16,4,51,82,133,106
3405-000,2015,4,16,5,85,78,163,133
3405-000,2015,4,16,6,210,212,422,163
3405-000,2015,4,16,7,523,463,986,422
3405-000,2015,4,16,8,979,1217,2196,986
3405-000,2015,4,16,9,1231,1164,2395,2196
3405-000,2015,4,16,10,1048,963,2011,2395
3405-000,2015,4,16,11,1024,885,1909,2011
3405-000,2015,4,16,12,954,806,1760,1909
3405-000,2015,4,16,13,821,779,1600,1760
3405-000,2015,4,16,14,933,924,1857,1600
3405-000,2015,4,16,15,978,920,1898,1857
3405-000,2015,4,16,16,1044,935,1979,1898
3405-000,2015,4,16,17,971,826,1797,1979
3405-000,2015,4,16,18,935,836,1771,1797
3405-000,2015,4,16,19,851,833,1684,1771
3405-000,2015,4,16,20,599,621,1220,1684
3405-000,2015,4,16,21,483,516,999,1220
3405-000,2015,4,16,22,378,365,743,999
3405-000,2015,4,16,23,234,212,446,743
3405-000,2015,4,16,24,168,144,312,446
3405-000,2015,4,17,1,93,103,196,312
3405-000,2015,4,17,2,43,73,116,196
3405-000,2015,4,17,3,51,70,121,116
3405-000,2015,4,17,4,45,63,108,121
3405-000,2015,4,17,5,104,95,199,108
3405-000,2015,4,17,6,196,181,377,199
3405-000,2015,4,17,7,513,464,977,377
3405-000,2015,4,17,8,957,1186,2143,977
3405-000,2015,4,17,9,1160,1107,2267,2143
3405-000,2015,4,17,10,1024,911,1935,2267
3405-000,2015,4,17,11,1045,941,1986,1935
3405-000,2015,4,17,12,990,898,1888,1986
3405-000,2015,4,17,13,822,818,1640,1888
3405-000,2015,4,17,14,967,977,1944,1640
3405-000,2015,4,17,15,1066,986,2052,1944
3405-000,2015,4,17,16,1127,897,2024,2052
3405-000,2015,4,17,17,1091,860,1951,2024
3405-000,2015,4,17,18,1262,1025,2287,1951
3405-000,2015,4,17,19,1357,1038,2395,2287
3405-000,2015,4,17,20,928,732,1660,2395
3405-000,2015,4,17,21,633,587,1220,1660
3405-000,2015,4,17,22,447,356,803,1220
3405-000,2015,4,17,23,266,278,544,803
3405-000,2015,4,17,24,171,154,325,544
3405-000,2015,4,18,1,108,123,231,325
3405-000,2015,4,18,2,66,78,144,231
3405-000,2015,4,18,3,63,61,124,144
3405-000,2015,4,18,4,55,48,103,124
3405-000,2015,4,18,5,87,85,172,103
3405-000,2015,4,18,6,188,154,342,172
3405-000,2015,4,18,7,378,381,759,342
3405-000,2015,4,18,8,792,590,1382,759
3405-000,2015,4,18,9,868,762,1630,1382
3405-000,2015,4,18,10,853,691,1544,1630
3405-000,2015,4,18,11,916,751,1667,1544
3405-000,2015,4,18,12,850,862,1712,1667
3405-000,2015,4,18,13,736,742,1478,1712
3405-000,2015,4,18,14,699,725,1424,1478
3405-000,2015,4,18,15,740,728,1468,1424
3405-000,2015,4,18,16,736,710,1446,1468
3405-000,2015,4,18,17,817,743,1560,1446
3405-000,2015,4,18,18,909,868,1777,1560
3405-000,2015,4,18,19,756,672,1428,1777
3405-000,2015,4,18,20,514,532,1046,1428
3405-000,2015,4,18,21,352,394,746,1046
3405-000,2015,4,18,22,286,277,563,746
3405-000,2015,4,18,23,189,187,376,563
3405-000,2015,4,18,24,129,137,266,376
3405-000,2015,4,19,1,87,77,164,266
3405-000,2015,4,19,2,47,53,100,164
3405-000,2015,4,19,3,32,32,64,100
3405-000,2015,4,19,4,36,28,64,64
3405-000,2015,4,19,5,32,35,67,64
3405-000,2015,4,19,6,82,72,154,67
3405-000,2015,4,19,7,166,95,261,154
3405-000,2015,4,19,8,255,197,452,261
3405-000,2015,4,19,9,320,293,613,452
3405-000,2015,4,19,10,355,289,644,613
3405-000,2015,4,19,11,392,343,735,644
3405-000,2015,4,19,12,367,399,766,735
3405-000,2015,4,19,13,386,421,807,766
3405-000,2015,4,19,14,404,442,846,807
3405-000,2015,4,19,15,475,483,958,846
3405-000,2015,4,19,16,539,486,1025,958
3405-000,2015,4,19,17,508,555,1063,1025
3405-000,2015,4,19,18,486,598,1084,1063
3405-000,2015,4,19,19,417,679,1096,1084
3405-000,2015,4,19,20,360,438,798,1096
3405-000,2015,4,19,21,293,334,627,798
3405-000,2015,4,19,22,244,306,550,627
3405-000,2015,4,19,23,147,211,358,550
3405-000,2015,4,19,24,84,136,220,358
3405-000,2015,4,20,1,60,93,153,220
3405-000,2015,4,20,2,38,52,90,153
3405-000,2015,4,20,3,23,47,70,90
3405-000,2015,4,20,4,33,53,86,70
3405-000,2015,4,20,5,74,92,166,86
3405-000,2015,4,20,6,209,212,421,166
3405-000,2015,4,20,7,435,513,948,421
3405-000,2015,4,20,8,961,1325,2286,948
3405-000,2015,4,20,9,1030,1158,2188,2286
3405-000,2015,4,20,10,868,809,1677,2188
3405-000,2015,4,20,11,884,752,1636,1677
3405-000,2015,4,20,12,846,793,1639,1636
3405-000,2015,4,20,13,672,739,1411,1639
3405-000,2015,4,20,14,828,953,1781,1411
3405-000,2015,4,20,15,965,962,1927,1781
3405-000,2015,4,20,16,964,931,1895,1927
3405-000,2015,4,20,17,950,836,1786,1895
3405-000,2015,4,20,18,957,812,1769,1786
3405-000,2015,4,20,19,848,854,1702,1769
3405-000,2015,4,20,20,621,619,1240,1702
3405-000,2015,4,20,21,539,514,1053,1240
3405-000,2015,4,20,22,366,383,749,1053
3405-000,2015,4,20,23,238,250,488,749
3405-000,2015,4,20,24,141,148,289,488
3405-000,2015,4,21,1,82,95,177,289
3405-000,2015,4,21,2,57,74,131,177
3405-000,2015,4,21,3,28,67,95,131
3405-000,2015,4,21,4,49,61,110,95
3405-000,2015,4,21,5,94,97,191,110
3405-000,2015,4,21,6,209,209,418,191
3405-000,2015,4,21,7,481,464,945,418
3405-000,2015,4,21,8,997,1172,2169,945
3405-000,2015,4,21,9,1182,1176,2358,2169
3405-000,2015,4,21,10,1097,947,2044,2358
3405-000,2015,4,21,11,1075,1002,2077,2044
3405-000,2015,4,21,12,992,887,1879,2077
3405-000,2015,4,21,13,803,735,1538,1879
3405-000,2015,4,21,14,956,887,1843,1538
3405-000,2015,4,21,15,1050,940,1990,1843
3405-000,2015,4,21,16,1037,1005,2042,1990
3405-000,2015,4,21,17,1009,872,1881,2042
3405-000,2015,4,21,18,1044,923,1967,1881
3405-000,2015,4,21,19,1040,974,2014,1967
3405-000,2015,4,21,20,685,686,1371,2014
3405-000,2015,4,21,21,506,505,1011,1371
3405-000,2015,4,21,22,371,395,766,1011
3405-000,2015,4,21,23,247,217,464,766
3405-000,2015,4,21,24,154,155,309,464
3405-000,2015,4,22,1,90,115,205,309
3405-000,2015,4,22,2,54,67,121,205
3405-000,2015,4,22,3,55,45,100,121
3405-000,2015,4,22,4,44,66,110,100
3405-000,2015,4,22,5,82,84,166,110
3405-000,2015,4,22,6,220,188,408,166
3405-000,2015,4,22,7,486,421,907,408
3405-000,2015,4,22,8,972,1192,2164,907
3405-000,2015,4,22,9,1170,1163,2333,2164
3405-000,2015,4,22,10,1048,935,1983,2333
3405-000,2015,4,22,11,1020,902,1922,1983
3405-000,2015,4,22,12,1002,868,1870,1922
3405-000,2015,4,22,13,790,711,1501,1870
3405-000,2015,4,22,14,871,982,1853,1501
3405-000,2015,4,22,15,1027,953,1980,1853
3405-000,2015,4,22,16,1027,859,1886,1980
3405-000,2015,4,22,17,1084,900,1984,1886
3405-000,2015,4,22,18,1113,996,2109,1984
3405-000,2015,4,22,19,985,926,1911,2109
3405-000,2015,4,22,20,689,621,1310,1911
3405-000,2015,4,22,21,457,482,939,1310
3405-000,2015,4,22,22,331,383,714,939
3405-000,2015,4,22,23,277,246,523,714
3405-000,2015,4,22,24,158,171,329,523
3405-000,2015,4,23,1,97,108,205,329
3405-000,2015,4,23,2,63,87,150,205
3405-000,2015,4,23,3,60,71,131,150
3405-000,2015,4,23,4,54,59,113,131
3405-000,2015,4,23,5,91,87,178,113
3405-000,2015,4,23,6,202,187,389,178
3405-000,2015,4,23,7,504,463,967,389
3405-000,2015,4,23,8,1011,1234,2245,967
3405-000,2015,4,23,9,1201,1157,2358,2245
3405-000,2015,4,23,10,1039,915,1954,2358
3405-000,2015,4,23,11,1010,878,1888,1954
3405-000,2015,4,23,12,977,928,1905,1888
3405-000,2015,4,23,13,799,776,1575,1905
3405-000,2015,4,23,14,915,902,1817,1575
3405-000,2015,4,23,15,1084,985,2069,1817
3405-000,2015,4,23,16,1043,948,1991,2069
3405-000,2015,4,23,17,992,919,1911,1991
3405-000,2015,4,23,18,1054,970,2024,1911
3405-000,2015,4,23,19,991,897,1888,2024
3405-000,2015,4,23,20,641,678,1319,1888
3405-000,2015,4,23,21,581,551,1132,1319
3405-000,2015,4,23,22,389,397,786,1132
3405-000,2015,4,23,23,229,222,451,786
3405-000,2015,4,23,24,170,158,328,451
3405-000,2015,4,24,1,99,107,206,328
3405-000,2015,4,24,2,69,93,162,206
3405-000,2015,4,24,3,46,65,111,162
3405-000,2015,4,24,4,52,77,129,111
3405-000,2015,4,24,5,102,86,188,129
3405-000,2015,4,24,6,194,212,406,188
3405-000,2015,4,24,7,481,404,885,406
3405-000,2015,4,24,8,970,1137,2107,885
3405-000,2015,4,24,9,1147,1150,2297,2107
3405-000,2015,4,24,10,1052,890,1942,2297
3405-000,2015,4,24,11,1064,938,2002,1942
3405-000,2015,4,24,12,1028,925,1953,2002
3405-000,2015,4,24,13,868,825,1693,1953
3405-000,2015,4,24,14,963,942,1905,1693
3405-000,2015,4,24,15,1075,1016,2091,1905
3405-000,2015,4,24,16,1094,983,2077,2091
3405-000,2015,4,24,17,1002,903,1905,2077
3405-000,2015,4,24,18,1273,1151,2424,1905
3405-000,2015,4,24,19,1491,1345,2836,2424
3405-000,2015,4,24,20,1164,943,2107,2836
3405-000,2015,4,24,21,662,574,1236,2107
3405-000,2015,4,24,22,429,388,817,1236
3405-000,2015,4,24,23,316,273,589,817
3405-000,2015,4,24,24,192,162,354,589
3405-000,2015,4,25,1,117,137,254,354
3405-000,2015,4,25,2,59,87,146,254
3405-000,2015,4,25,3,47,63,110,146
3405-000,2015,4,25,4,72,65,137,110
3405-000,2015,4,25,5,83,78,161,137
3405-000,2015,4,25,6,190,148,338,161
3405-000,2015,4,25,7,409,353,762,338
3405-000,2015,4,25,8,753,581,1334,762
3405-000,2015,4,25,9,813,695,1508,1334
3405-000,2015,4,25,10,915,700,1615,1508
3405-000,2015,4,25,11,915,784,1699,1615
3405-000,2015,4,25,12,869,852,1721,1699
3405-000,2015,4,25,13,784,734,1518,1721
3405-000,2015,4,25,14,717,665,1382,1518
3405-000,2015,4,25,15,757,680,1437,1382
3405-000,2015,4,25,16,748,693,1441,1437
3405-000,2015,4,25,17,754,656,1410,1441
3405-000,2015,4,25,18,842,871,1713,1410
3405-000,2015,4,25,19,688,697,1385,1713
3405-000,2015,4,25,20,466,485,951,1385
3405-000,2015,4,25,21,366,380,746,951
3405-000,2015,4,25,22,291,283,574,746
3405-000,2015,4,25,23,210,226,436,574
3405-000,2015,4,25,24,135,150,285,436
3405-000,2015,4,26,1,76,84,160,285
3405-000,2015,4,26,2,46,52,98,160
3405-000,2015,4,26,3,46,35,81,98
3405-000,2015,4,26,4,28,39,67,81
3405-000,2015,4,26,5,55,34,89,67
3405-000,2015,4,26,6,108,73,181,89
3405-000,2015,4,26,7,249,158,407,181
3405-000,2015,4,26,8,349,274,623,407
3405-000,2015,4,26,9,418,322,740,623
3405-000,2015,4,26,10,496,353,849,740
3405-000,2015,4,26,11,519,459,978,849
3405-000,2015,4,26,12,523,460,983,978
3405-000,2015,4,26,13,429,422,851,983
3405-000,2015,4,26,14,489,456,945,851
3405-000,2015,4,26,15,500,528,1028,945
3405-000,2015,4,26,16,571,576,1147,1028
3405-000,2015,4,26,17,545,667,1212,1147
3405-000,2015,4,26,18,595,673,1268,1212
3405-000,2015,4,26,19,542,682,1224,1268
3405-000,2015,4,26,20,458,578,1036,1224
3405-000,2015,4,26,21,365,508,873,1036
3405-000,2015,4,26,22,288,424,712,873
3405-000,2015,4,26,23,173,299,472,712
3405-000,2015,4,26,24,109,158,267,472
3405-000,2015,4,27,1,75,113,188,267
3405-000,2015,4,27,2,43,78,121,188
3405-000,2015,4,27,3,35,62,97,121
3405-000,2015,4,27,4,37,72,109,97
3405-000,2015,4,27,5,100,93,193,109
3405-000,2015,4,27,6,225,242,467,193
3405-000,2015,4,27,7,541,618,1159,467
3405-000,2015,4,27,8,1094,1492,2586,1159
3405-000,2015,4,27,9,1162,1302,2464,2586
3405-000,2015,4,27,10,984,933,1917,2464
3405-000,2015,4,27,11,984,947,1931,1917
3405-000,2015,4,27,12,991,881,1872,1931
3405-000,2015,4,27,13,761,805,1566,1872
3405-000,2015,4,27,14,894,900,1794,1566
3405-000,2015,4,27,15,1059,940,1999,1794
3405-000,2015,4,27,16,998,1014,2012,1999
3405-000,2015,4,27,17,1032,913,1945,2012
3405-000,2015,4,27,18,1021,957,1978,1945
3405-000,2015,4,27,19,930,951,1881,1978
3405-000,2015,4,27,20,692,678,1370,1881
3405-000,2015,4,27,21,554,539,1093,1370
3405-000,2015,4,27,22,404,356,760,1093
3405-000,2015,4,27,23,270,216,486,760
3405-000,2015,4,27,24,157,182,339,486
3405-000,2015,4,28,1,109,120,229,339
3405-000,2015,4,28,2,58,90,148,229
3405-000,2015,4,28,3,60,59,119,148
3405-000,2015,4,28,4,38,73,111,119
3405-000,2015,4,28,5,89,87,176,111
3405-000,2015,4,28,6,239,215,454,176
3405-000,2015,4,28,7,498,470,968,454
3405-000,2015,4,28,8,948,1159,2107,968
3405-000,2015,4,28,9,1205,1222,2427,2107
3405-000,2015,4,28,10,1085,930,2015,2427
3405-000,2015,4,28,11,1053,947,2000,2015
3405-000,2015,4,28,12,1037,923,1960,2000
3405-000,2015,4,28,13,874,765,1639,1960
3405-000,2015,4,28,14,954,997,1951,1639
3405-000,2015,4,28,15,1123,1036,2159,1951
3405-000,2015,4,28,16,1009,986,1995,2159
3405-000,2015,4,28,17,1075,914,1989,1995
3405-000,2015,4,28,18,1105,911,2016,1989
3405-000,2015,4,28,19,1004,999,2003,2016
3405-000,2015,4,28,20,663,633,1296,2003
3405-000,2015,4,28,21,535,476,1011,1296
3405-000,2015,4,28,22,376,397,773,1011
3405-000,2015,4,28,23,270,247,517,773
3405-000,2015,4,28,24,161,165,326,517
3405-000,2015,4,29,1,94,104,198,326
3405-000,2015,4,29,2,65,90,155,198
3405-000,2015,4,29,3,41,52,93,155
3405-000,2015,4,29,4,44,62,106,93
3405-000,2015,4,29,5,101,75,176,106
3405-000,2015,4,29,6,177,192,369,176
3405-000,2015,4,29,7,445,412,857,369
3405-000,2015,4,29,8,876,1133,2009,857
3405-000,2015,4,29,9,1132,1189,2321,2009
3405-000,2015,4,29,10,979,874,1853,2321
3405-000,2015,4,29,11,947,870,1817,1853
3405-000,2015,4,29,12,904,848,1752,1817
3405-000,2015,4,29,13,753,731,1484,1752
3405-000,2015,4,29,14,869,884,1753,1484
3405-000,2015,4,29,15,1010,958,1968,1753
3405-000,2015,4,29,16,980,891,1871,1968
3405-000,2015,4,29,17,957,860,1817,1871
3405-000,2015,4,29,18,1027,897,1924,1817
3405-000,2015,4,29,19,981,916,1897,1924
3405-000,2015,4,29,20,574,574,1148,1897
3405-000,2015,4,29,21,502,485,987,1148
3405-000,2015,4,29,22,382,353,735,987
3405-000,2015,4,29,23,272,254,526,735
3405-000,2015,4,29,24,185,168,353,526
3405-000,2015,4,30,1,112,90,202,353
3405-000,2015,4,30,2,58,75,133,202
3405-000,2015,4,30,3,53,58,111,133
3405-000,2015,4,30,4,51,63,114,111
3405-000,2015,4,30,5,101,89,190,114
3405-000,2015,4,30,6,182,213,395,190
3405-000,2015,4,30,7,515,448,963,395
3405-000,2015,4,30,8,959,1153,2112,963
3405-000,2015,4,30,9,1188,1134,2322,2112
3405-000,2015,4,30,10,1044,915,1959,2322
3405-000,2015,4,30,11,1078,1055,2133,1959
3405-000,2015,4,30,12,1019,856,1875,2133
3405-000,2015,4,30,13,846,806,1652,1875
3405-000,2015,4,30,14,1001,920,1921,1652
3405-000,2015,4,30,15,1102,929,2031,1921
3405-000,2015,4,30,16,1079,1036,2115,2031
3405-000,2015,4,30,17,1136,951,2087,2115
3405-000,2015,4,30,18,1260,1008,2268,2087
3405-000,2015,4,30,19,1390,1094,2484,2268
3405-000,2015,4,30,20,927,815,1742,2484
3405-000,2015,4,30,21,646,620,1266,1742
3405-000,2015,4,30,22,489,416,905,1266
3405-000,2015,4,30,23,311,251,562,905
3405-000,2015,4,30,24,190,185,375,562
3405-000,2015,5,1,1,126,120,246,375
3405-000,2015,5,1,2,87,67,154,246
3405-000,2015,5,1,3,77,61,138,154
3405-000,2015,5,1,4,64,69,133,138
3405-000,2015,5,1,5,79,71,150,133
3405-000,2015,5,1,6,208,137,345,150
3405-000,2015,5,1,7,475,311,786,345
3405-000,2015,5,1,8,755,573,1328,786
3405-000,2015,5,1,9,914,769,1683,1328
3405-000,2015,5,1,10,920,690,1610,1683
3405-000,2015,5,1,11,946,764,1710,1610
3405-000,2015,5,1,12,972,811,1783,1710
3405-000,2015,5,1,13,1060,663,1723,1783
3405-000,2015,5,1,14,934,749,1683,1723
3405-000,2015,5,1,15,823,733,1556,1683
3405-000,2015,5,1,16,852,756,1608,1556
3405-000,2015,5,1,17,888,694,1582,1608
3405-000,2015,5,1,18,880,876,1756,1582
3405-000,2015,5,1,19,771,828,1599,1756
3405-000,2015,5,1,20,546,583,1129,1599
3405-000,2015,5,1,21,388,459,847,1129
3405-000,2015,5,1,22,312,313,625,847
3405-000,2015,5,1,23,240,213,453,625
3405-000,2015,5,1,24,136,128,264,453
3405-000,2015,5,2,1,85,90,175,264
3405-000,2015,5,2,2,57,71,128,175
3405-000,2015,5,2,3,52,46,98,128
3405-000,2015,5,2,4,53,53,106,98
3405-000,2015,5,2,5,76,70,146,106
3405-000,2015,5,2,6,191,164,355,146
3405-000,2015,5,2,7,442,329,771,355
3405-000,2015,5,2,8,581,469,1050,771
3405-000,2015,5,2,9,718,594,1312,1050
3405-000,2015,5,2,10,770,663,1433,1312
3405-000,2015,5,2,11,959,739,1698,1433
3405-000,2015,5,2,12,976,833,1809,1698
3405-000,2015,5,2,13,901,755,1656,1809
3405-000,2015,5,2,14,668,728,1396,1656
3405-000,2015,5,2,15,685,896,1581,1396
3405-000,2015,5,2,16,684,758,1442,1581
3405-000,2015,5,2,17,703,714,1417,1442
3405-000,2015,5,2,18,792,797,1589,1417
3405-000,2015,5,2,19,652,666,1318,1589
3405-000,2015,5,2,20,504,652,1156,1318
3405-000,2015,5,2,21,403,454,857,1156
3405-000,2015,5,2,22,343,335,678,857
3405-000,2015,5,2,23,217,260,477,678
3405-000,2015,5,2,24,110,182,292,477
3405-000,2015,5,3,1,69,87,156,292
3405-000,2015,5,3,2,55,55,110,156
3405-000,2015,5,3,3,27,29,56,110
3405-000,2015,5,3,4,34,32,66,56
3405-000,2015,5,3,5,50,26,76,66
3405-000,2015,5,3,6,72,77,149,76
3405-000,2015,5,3,7,167,133,300,149
3405-000,2015,5,3,8,278,185,463,300
3405-000,2015,5,3,9,330,286,616,463
3405-000,2015,5,3,10,415,303,718,616
3405-000,2015,5,3,11,517,414,931,718
3405-000,2015,5,3,12,466,452,918,931
3405-000,2015,5,3,13,457,472,929,918
3405-000,2015,5,3,14,448,448,896,929
3405-000,2015,5,3,15,585,602,1187,896
3405-000,2015,5,3,16,559,718,1277,1187
3405-000,2015,5,3,17,562,664,1226,1277
3405-000,2015,5,3,18,615,741,1356,1226
3405-000,2015,5,3,19,510,692,1202,1356
3405-000,2015,5,3,20,432,807,1239,1202
3405-000,2015,5,3,21,360,577,937,1239
3405-000,2015,5,3,22,284,814,1098,937
3405-000,2015,5,3,23,232,480,712,1098
3405-000,2015,5,3,24,139,242,381,712
3405-000,2015,5,4,1,66,127,193,381
3405-000,2015,5,4,2,38,72,110,193
3405-000,2015,5,4,3,33,48,81,110
3405-000,2015,5,4,4,54,48,102,81
3405-000,2015,5,4,5,76,79,155,102
3405-000,2015,5,4,6,224,237,461,155
3405-000,2015,5,4,7,495,500,995,461
3405-000,2015,5,4,8,912,1082,1994,995
3405-000,2015,5,4,9,930,916,1846,1994
3405-000,2015,5,4,10,907,752,1659,1846
3405-000,2015,5,4,11,936,892,1828,1659
3405-000,2015,5,4,12,960,875,1835,1828
3405-000,2015,5,4,13,819,806,1625,1835
3405-000,2015,5,4,14,869,814,1683,1625
3405-000,2015,5,4,15,914,851,1765,1683
3405-000,2015,5,4,16,874,867,1741,1765
3405-000,2015,5,4,17,965,789,1754,1741
3405-000,2015,5,4,18,1035,929,1964,1754
3405-000,2015,5,4,19,958,930,1888,1964
3405-000,2015,5,4,20,729,697,1426,1888
3405-000,2015,5,4,21,555,591,1146,1426
3405-000,2015,5,4,22,392,385,777,1146
3405-000,2015,5,4,23,286,274,560,777
3405-000,2015,5,4,24,164,174,338,560
3405-000,2015,5,5,1,94,97,191,338
3405-000,2015,5,5,2,62,57,119,191
3405-000,2015,5,5,3,41,53,94,119
3405-000,2015,5,5,4,49,55,104,94
3405-000,2015,5,5,5,74,69,143,104
3405-000,2015,5,5,6,153,166,319,143
3405-000,2015,5,5,7,345,261,606,319
3405-000,2015,5,5,8,527,418,945,606
3405-000,2015,5,5,9,649,499,1148,945
3405-000,2015,5,5,10,675,508,1183,1148
3405-000,2015,5,5,11,677,548,1225,1183
3405-000,2015,5,5,12,642,578,1220,1225
3405-000,2015,5,5,13,536,539,1075,1220
3405-000,2015,5,5,14,534,556,1090,1075
3405-000,2015,5,5,15,588,603,1191,1090
3405-000,2015,5,5,16,581,689,1270,1191
3405-000,2015,5,5,17,629,647,1276,1270
3405-000,2015,5,5,18,693,725,1418,1276
3405-000,2015,5,5,19,575,621,1196,1418
3405-000,2015,5,5,20,421,532,953,1196
3405-000,2015,5,5,21,336,413,749,953
3405-000,2015,5,5,22,294,302,596,749
3405-000,2015,5,5,23,197,249,446,596
3405-000,2015,5,5,24,99,159,258,446
3405-000,2015,5,6,1,69,102,171,258
3405-000,2015,5,6,2,50,62,112,171
3405-000,2015,5,6,3,29,43,72,112
3405-000,2015,5,6,4,46,60,106,72
3405-000,2015,5,6,5,79,103,182,106
3405-000,2015,5,6,6,212,257,469,182
3405-000,2015,5,6,7,541,567,1108,469
3405-000,2015,5,6,8,1014,1371,2385,1108
3405-000,2015,5,6,9,1198,1278,2476,2385
3405-000,2015,5,6,10,1021,883,1904,2476
3405-000,2015,5,6,11,1104,944,2048,1904
3405-000,2015,5,6,12,948,896,1844,2048
3405-000,2015,5,6,13,883,845,1728,1844
3405-000,2015,5,6,14,871,918,1789,1728
3405-000,2015,5,6,15,1092,1062,2154,1789
3405-000,2015,5,6,16,1050,901,1951,2154
3405-000,2015,5,6,17,1012,868,1880,1951
3405-000,2015,5,6,18,1098,972,2070,1880
3405-000,2015,5,6,19,1067,1020,2087,2070
3405-000,2015,5,6,20,710,649,1359,2087
3405-000,2015,5,6,21,509,453,962,1359
3405-000,2015,5,6,22,367,371,738,962
3405-000,2015,5,6,23,270,275,545,738
3405-000,2015,5,6,24,162,193,355,545
3405-000,2015,5,7,1,96,98,194,355
3405-000,2015,5,7,2,43,58,101,194
3405-000,2015,5,7,3,39,61,100,101
3405-000,2015,5,7,4,55,65,120,100
3405-000,2015,5,7,5,72,88,160,120
3405-000,2015,5,7,6,199,208,407,160
3405-000,2015,5,7,7,527,456,983,407
3405-000,2015,5,7,8,1009,1214,2223,983
3405-000,2015,5,7,9,1193,1127,2320,2223
3405-000,2015,5,7,10,1090,926,2016,2320
3405-000,2015,5,7,11,1085,985,2070,2016
3405-000,2015,5,7,12,1046,959,2005,2070
3405-000,2015,5,7,13,885,847,1732,2005
3405-000,2015,5,7,14,881,891,1772,1732
3405-000,2015,5,7,15,1046,950,1996,1772
3405-000,2015,5,7,16,1076,960,2036,1996
3405-000,2015,5,7,17,1050,891,1941,2036
3405-000,2015,5,7,18,1128,981,2109,1941
3405-000,2015,5,7,19,1038,936,1974,2109
3405-000,2015,5,7,20,725,672,1397,1974
3405-000,2015,5,7,21,593,603,1196,1397
3405-000,2015,5,7,22,415,417,832,1196
3405-000,2015,5,7,23,288,264,552,832
3405-000,2015,5,7,24,155,182,337,552
3405-000,2015,5,8,1,99,130,229,337
3405-000,2015,5,8,2,54,74,128,229
3405-000,2015,5,8,3,44,52,96,128
3405-000,2015,5,8,4,47,75,122,96
3405-000,2015,5,8,5,100,91,191,122
3405-000,2015,5,8,6,188,216,404,191
3405-000,2015,5,8,7,508,481,989,404
3405-000,2015,5,8,8,987,1158,2145,989
3405-000,2015,5,8,9,1215,1201,2416,2145
3405-000,2015,5,8,10,1045,986,2031,2416
3405-000,2015,5,8,11,1092,947,2039,2031
3405-000,2015,5,8,12,1102,915,2017,2039
3405-000,2015,5,8,13,918,898,1816,2017
3405-000,2015,5,8,14,953,969,1922,1816
3405-000,2015,5,8,15,1126,1029,2155,1922
3405-000,2015,5,8,16,1136,1018,2154,2155
3405-000,2015,5,8,17,1151,971,2122,2154
3405-000,2015,5,8,18,1320,1119,2439,2122
3405-000,2015,5,8,19,1594,1126,2720,2439
3405-000,2015,5,8,20,973,756,1729,2720
3405-000,2015,5,8,21,700,580,1280,1729
3405-000,2015,5,8,22,492,461,953,1280
3405-000,2015,5,8,23,305,296,601,953
3405-000,2015,5,8,24,189,207,396,601
3405-000,2015,5,9,1,106,106,212,396
3405-000,2015,5,9,2,60,69,129,212
3405-000,2015,5,9,3,60,54,114,129
3405-000,2015,5,9,4,62,59,121,114
3405-000,2015,5,9,5,96,74,170,121
3405-000,2015,5,9,6,189,177,366,170
3405-000,2015,5,9,7,414,337,751,366
3405-000,2015,5,9,8,771,595,1366,751
3405-000,2015,5,9,9,883,731,1614,1366
3405-000,2015,5,9,10,889,711,1600,1614
3405-000,2015,5,9,11,952,757,1709,1600
3405-000,2015,5,9,12,1178,851,2029,1709
3405-000,2015,5,9,13,1037,754,1791,2029
3405-000,2015,5,9,14,794,695,1489,1791
3405-000,2015,5,9,15,790,754,1544,1489
3405-000,2015,5,9,16,809,738,1547,1544
3405-000,2015,5,9,17,834,684,1518,1547
3405-000,2015,5,9,18,955,776,1731,1518
3405-000,2015,5,9,19,746,726,1472,1731
3405-000,2015,5,9,20,522,587,1109,1472
3405-000,2015,5,9,21,389,438,827,1109
3405-000,2015,5,9,22,290,320,610,827
3405-000,2015,5,9,23,219,212,431,610
3405-000,2015,5,9,24,113,162,275,431
3405-000,2015,5,10,1,71,91,162,275
3405-000,2015,5,10,2,50,56,106,162
3405-000,2015,5,10,3,29,23,52,106
3405-000,2015,5,10,4,29,32,61,52
3405-000,2015,5,10,5,42,37,79,61
3405-000,2015,5,10,6,122,96,218,79
3405-000,2015,5,10,7,221,174,395,218
3405-000,2015,5,10,8,412,292,704,395
3405-000,2015,5,10,9,403,316,719,704
3405-000,2015,5,10,10,494,356,850,719
3405-000,2015,5,10,11,566,421,987,850
3405-000,2015,5,10,12,567,434,1001,987
3405-000,2015,5,10,13,468,429,897,1001
3405-000,2015,5,10,14,478,460,938,897
3405-000,2015,5,10,15,531,525,1056,938
3405-000,2015,5,10,16,589,622,1211,1056
3405-000,2015,5,10,17,559,699,1258,1211
3405-000,2015,5,10,18,552,835,1387,1258
3405-000,2015,5,10,19,491,826,1317,1387
3405-000,2015,5,10,20,444,735,1179,1317
3405-000,2015,5,10,21,347,613,960,1179
3405-000,2015,5,10,22,311,506,817,960
3405-000,2015,5,10,23,226,353,579,817
3405-000,2015,5,10,24,125,182,307,579
3405-000,2015,5,11,1,62,110,172,307
3405-000,2015,5,11,2,59,85,144,172
3405-000,2015,5,11,3,25,45,70,144
3405-000,2015,5,11,4,34,58,92,70
3405-000,2015,5,11,5,76,95,171,92
3405-000,2015,5,11,6,251,245,496,171
3405-000,2015,5,11,7,590,576,1166,496
3405-000,2015,5,11,8,1045,1444,2489,1166
3405-000,2015,5,11,9,1227,1266,2493,2489
3405-000,2015,5,11,10,953,878,1831,2493
3405-000,2015,5,11,11,1056,935,1991,1831
3405-000,2015,5,11,12,994,918,1912,1991
3405-000,2015,5,11,13,836,788,1624,1912
3405-000,2015,5,11,14,882,877,1759,1624
3405-000,2015,5,11,15,1020,961,1981,1759
3405-000,2015,5,11,16,1023,946,1969,1981
3405-000,2015,5,11,17,996,857,1853,1969
3405-000,2015,5,11,18,1150,912,2062,1853
3405-000,2015,5,11,19,1070,949,2019,2062
3405-000,2015,5,11,20,652,659,1311,2019
3405-000,2015,5,11,21,526,527,1053,1311
3405-000,2015,5,11,22,337,342,679,1053
3405-000,2015,5,11,23,189,220,409,679
3405-000,2015,5,11,24,130,147,277,409
3405-000,2015,5,12,1,92,93,185,277
3405-000,2015,5,12,2,53,70,123,185
3405-000,2015,5,12,3,43,51,94,123
3405-000,2015,5,12,4,40,63,103,94
3405-000,2015,5,12,5,69,97,166,103
3405-000,2015,5,12,6,158,174,332,166
3405-000,2015,5,12,7,470,384,854,332
3405-000,2015,5,12,8,950,1091,2041,854
3405-000,2015,5,12,9,1176,1209,2385,2041
3405-000,2015,5,12,10,1018,880,1898,2385
3405-000,2015,5,12,11,985,943,1928,1898
3405-000,2015,5,12,12,1002,880,1882,1928
3405-000,2015,5,12,13,756,738,1494,1882
3405-000,2015,5,12,14,892,942,1834,1494
3405-000,2015,5,12,15,1017,921,1938,1834
3405-000,2015,5,12,16,1059,842,1901,1938
3405-000,2015,5,12,17,993,860,1853,1901
3405-000,2015,5,12,18,1027,893,1920,1853
3405-000,2015,5,12,19,1010,964,1974,1920
3405-000,2015,5,12,20,624,607,1231,1974
3405-000,2015,5,12,21,477,514,991,1231
3405-000,2015,5,12,22,357,392,749,991
3405-000,2015,5,12,23,251,227,478,749
3405-000,2015,5,12,24,162,158,320,478
3405-000,2015,5,13,1,92,107,199,320
3405-000,2015,5,13,2,52,76,128,199
3405-000,2015,5,13,3,37,67,104,128
3405-000,2015,5,13,4,57,69,126,104
3405-000,2015,5,13,5,90,76,166,126
3405-000,2015,5,13,6,214,209,423,166
3405-000,2015,5,13,7,509,510,1019,423
3405-000,2015,5,13,8,993,1145,2138,1019
3405-000,2015,5,13,9,1204,1181,2385,2138
3405-000,2015,5,13,10,1022,918,1940,2385
3405-000,2015,5,13,11,990,919,1909,1940
3405-000,2015,5,13,12,1028,841,1869,1909
3405-000,2015,5,13,13,830,741,1571,1869
3405-000,2015,5,13,14,893,943,1836,1571
3405-000,2015,5,13,15,1029,1007,2036,1836
3405-000,2015,5,13,16,996,967,1963,2036
3405-000,2015,5,13,17,1077,899,1976,1963
3405-000,2015,5,13,18,1142,903,2045,1976
3405-000,2015,5,13,19,1123,939,2062,2045
3405-000,2015,5,13,20,631,660,1291,2062
3405-000,2015,5,13,21,492,522,1014,1291
3405-000,2015,5,13,22,351,365,716,1014
3405-000,2015,5,13,23,278,212,490,716
3405-000,2015,5,13,24,176,177,353,490
3405-000,2015,5,14,1,106,116,222,353
3405-000,2015,5,14,2,51,61,112,222
3405-000,2015,5,14,3,41,61,102,112
3405-000,2015,5,14,4,51,66,117,102
3405-000,2015,5,14,5,88,94,182,117
3405-000,2015,5,14,6,233,219,452,182
3405-000,2015,5,14,7,549,492,1041,452
3405-000,2015,5,14,8,1047,1100,2147,1041
3405-000,2015,5,14,9,1201,1229,2430,2147
3405-000,2015,5,14,10,1002,950,1952,2430
3405-000,2015,5,14,11,1015,969,1984,1952
3405-000,2015,5,14,12,974,845,1819,1984
3405-000,2015,5,14,13,807,731,1538,1819
3405-000,2015,5,14,14,870,868,1738,1538
3405-000,2015,5,14,15,996,924,1920,1738
3405-000,2015,5,14,16,977,958,1935,1920
3405-000,2015,5,14,17,1031,902,1933,1935
3405-000,2015,5,14,18,1114,1016,2130,1933
3405-000,2015,5,14,19,1065,909,1974,2130
3405-000,2015,5,14,20,677,674,1351,1974
3405-000,2015,5,14,21,552,552,1104,1351
3405-000,2015,5,14,22,417,400,817,1104
3405-000,2015,5,14,23,282,220,502,817
3405-000,2015,5,14,24,152,146,298,502
3405-000,2015,5,15,1,101,106,207,298
3405-000,2015,5,15,2,65,88,153,207
3405-000,2015,5,15,3,57,69,126,153
3405-000,2015,5,15,4,66,67,133,126
3405-000,2015,5,15,5,90,103,193,133
3405-000,2015,5,15,6,209,205,414,193
3405-000,2015,5,15,7,496,503,999,414
3405-000,2015,5,15,8,1004,1121,2125,999
3405-000,2015,5,15,9,1221,1210,2431,2125
3405-000,2015,5,15,10,1081,931,2012,2431
3405-000,2015,5,15,11,1051,893,1944,2012
3405-000,2015,5,15,12,1037,904,1941,1944
3405-000,2015,5,15,13,895,769,1664,1941
3405-000,2015,5,15,14,921,921,1842,1664
3405-000,2015,5,15,15,1075,983,2058,1842
3405-000,2015,5,15,16,1089,933,2022,2058
3405-000,2015,5,15,17,1088,903,1991,2022
3405-000,2015,5,15,18,1229,1010,2239,1991
3405-000,2015,5,15,19,1274,1079,2353,2239
3405-000,2015,5,15,20,841,736,1577,2353
3405-000,2015,5,15,21,623,568,1191,1577
3405-000,2015,5,15,22,465,375,840,1191
3405-000,2015,5,15,23,321,232,553,840
3405-000,2015,5,15,24,184,182,366,553
3405-000,2015,5,16,1,110,106,216,366
3405-000,2015,5,16,2,92,104,196,216
3405-000,2015,5,16,3,62,57,119,196
3405-000,2015,5,16,4,63,58,121,119
3405-000,2015,5,16,5,111,94,205,121
3405-000,2015,5,16,6,215,189,404,205
3405-000,2015,5,16,7,405,359,764,404
3405-000,2015,5,16,8,762,579,1341,764
3405-000,2015,5,16,9,900,736,1636,1341
3405-000,2015,5,16,10,872,664,1536,1636
3405-000,2015,5,16,11,861,768,1629,1536
3405-000,2015,5,16,12,821,768,1589,1629
3405-000,2015,5,16,13,696,658,1354,1589
3405-000,2015,5,16,14,703,642,1345,1354
3405-000,2015,5,16,15,817,669,1486,1345
3405-000,2015,5,16,16,745,701,1446,1486
3405-000,2015,5,16,17,781,693,1474,1446
3405-000,2015,5,16,18,809,831,1640,1474
3405-000,2015,5,16,19,687,682,1369,1640
3405-000,2015,5,16,20,515,513,1028,1369
3405-000,2015,5,16,21,392,387,779,1028
3405-000,2015,5,16,22,292,302,594,779
3405-000,2015,5,16,23,229,243,472,594
3405-000,2015,5,16,24,168,146,314,472
3405-000,2015,5,17,1,94,91,185,314
3405-000,2015,5,17,2,59,59,118,185
3405-000,2015,5,17,3,54,39,93,118
3405-000,2015,5,17,4,43,37,80,93
3405-000,2015,5,17,5,46,44,90,80
3405-000,2015,5,17,6,121,100,221,90
3405-000,2015,5,17,7,229,190,419,221
3405-000,2015,5,17,8,392,257,649,419
3405-000,2015,5,17,9,429,352,781,649
3405-000,2015,5,17,10,470,393,863,781
3405-000,2015,5,17,11,532,420,952,863
3405-000,2015,5,17,12,500,432,932,952
3405-000,2015,5,17,13,503,483,986,932
3405-000,2015,5,17,14,504,467,971,986
3405-000,2015,5,17,15,538,542,1080,971
3405-000,2015,5,17,16,539,598,1137,1080
3405-000,2015,5,17,17,585,642,1227,1137
3405-000,2015,5,17,18,596,668,1264,1227
3405-000,2015,5,17,19,528,605,1133,1264
3405-000,2015,5,17,20,398,512,910,1133
3405-000,2015,5,17,21,345,432,777,910
3405-000,2015,5,17,22,281,390,671,777
3405-000,2015,5,17,23,239,268,507,671
3405-000,2015,5,17,24,111,206,317,507
3405-000,2015,5,18,1,72,103,175,317
3405-000,2015,5,18,2,50,66,116,175
3405-000,2015,5,18,3,36,60,96,116
3405-000,2015,5,18,4,37,64,101,96
3405-000,2015,5,18,5,76,84,160,101
3405-000,2015,5,18,6,223,256,479,160
3405-000,2015,5,18,7,546,568,1114,479
3405-000,2015,5,18,8,1043,1466,2509,1114
3405-000,2015,5,18,9,1171,1283,2454,2509
3405-000,2015,5,18,10,1029,925,1954,2454
3405-000,2015,5,18,11,1013,1007,2020,1954
3405-000,2015,5,18,12,975,851,1826,2020
3405-000,2015,5,18,13,787,788,1575,1826
3405-000,2015,5,18,14,963,913,1876,1575
3405-000,2015,5,18,15,1025,912,1937,1876
3405-000,2015,5,18,16,988,893,1881,1937
3405-000,2015,5,18,17,1002,923,1925,1881
3405-000,2015,5,18,18,1070,927,1997,1925
3405-000,2015,5,18,19,995,975,1970,1997
3405-000,2015,5,18,20,651,660,1311,1970
3405-000,2015,5,18,21,543,536,1079,1311
3405-000,2015,5,18,22,399,380,779,1079
3405-000,2015,5,18,23,251,253,504,779
3405-000,2015,5,18,24,149,178,327,504
3405-000,2015,5,19,1,90,109,199,327
3405-000,2015,5,19,2,71,73,144,199
3405-000,2015,5,19,3,44,59,103,144
3405-000,2015,5,19,4,50,74,124,103
3405-000,2015,5,19,5,104,91,195,124
3405-000,2015,5,19,6,213,207,420,195
3405-000,2015,5,19,7,479,477,956,420
3405-000,2015,5,19,8,978,1163,2141,956
3405-000,2015,5,19,9,1181,1165,2346,2141
3405-000,2015,5,19,10,1074,907,1981,2346
3405-000,2015,5,19,11,1052,908,1960,1981
3405-000,2015,5,19,12,1038,850,1888,1960
3405-000,2015,5,19,13,792,753,1545,1888
3405-000,2015,5,19,14,888,924,1812,1545
3405-000,2015,5,19,15,1045,943,1988,1812
3405-000,2015,5,19,16,1086,865,1951,1988
3405-000,2015,5,19,17,1013,847,1860,1951
3405-000,2015,5,19,18,1121,963,2084,1860
3405-000,2015,5,19,19,990,960,1950,2084
3405-000,2015,5,19,20,639,601,1240,1950
3405-000,2015,5,19,21,529,508,1037,1240
3405-000,2015,5,19,22,372,426,798,1037
3405-000,2015,5,19,23,265,216,481,798
3405-000,2015,5,19,24,155,165,320,481
3405-000,2015,5,20,1,86,99,185,320
3405-000,2015,5,20,2,56,76,132,185
3405-000,2015,5,20,3,55,57,112,132
3405-000,2015,5,20,4,62,65,127,112
3405-000,2015,5,20,5,89,93,182,127
3405-000,2015,5,20,6,268,196,464,182
3405-000,2015,5,20,7,486,455,941,464
3405-000,2015,5,20,8,1002,1141,2143,941
3405-000,2015,5,20,9,1206,1186,2392,2143
3405-000,2015,5,20,10,1059,906,1965,2392
3405-000,2015,5,20,11,1057,899,1956,1965
3405-000,2015,5,20,12,1059,892,1951,1956
3405-000,2015,5,20,13,818,780,1598,1951
3405-000,2015,5,20,14,919,908,1827,1598
3405-000,2015,5,20,15,1051,1000,2051,1827
3405-000,2015,5,20,16,936,928,1864,2051
3405-000,2015,5,20,17,1054,866,1920,1864
3405-000,2015,5,20,18,1133,1010,2143,1920
3405-000,2015,5,20,19,1147,1024,2171,2143
3405-000,2015,5,20,20,666,625,1291,2171
3405-000,2015,5,20,21,529,484,1013,1291
3405-000,2015,5,20,22,395,392,787,1013
3405-000,2015,5,20,23,261,234,495,787
3405-000,2015,5,20,24,170,166,336,495
3405-000,2015,5,21,1,98,134,232,336
3405-000,2015,5,21,2,75,60,135,232
3405-000,2015,5,21,3,56,76,132,135
3405-000,2015,5,21,4,74,63,137,132
3405-000,2015,5,21,5,79,80,159,137
3405-000,2015,5,21,6,225,235,460,159
3405-000,2015,5,21,7,457,460,917,460
3405-000,2015,5,21,8,1009,1161,2170,917
3405-000,2015,5,21,9,1207,1260,2467,2170
3405-000,2015,5,21,10,1037,917,1954,2467
3405-000,2015,5,21,11,1140,930,2070,1954
3405-000,2015,5,21,12,1006,879,1885,2070
3405-000,2015,5,21,13,831,787,1618,1885
3405-000,2015,5,21,14,936,950,1886,1618
3405-000,2015,5,21,15,1052,936,1988,1886
3405-000,2015,5,21,16,1090,920,2010,1988
3405-000,2015,5,21,17,996,926,1922,2010
3405-000,2015,5,21,18,1224,929,2153,1922
3405-000,2015,5,21,19,1060,979,2039,2153
3405-000,2015,5,21,20,728,642,1370,2039
3405-000,2015,5,21,21,541,529,1070,1370
3405-000,2015,5,21,22,435,426,861,1070
3405-000,2015,5,21,23,292,256,548,861
3405-000,2015,5,21,24,162,188,350,548
3405-000,2015,5,22,1,104,112,216,350
3405-000,2015,5,22,2,94,78,172,216
3405-000,2015,5,22,3,42,78,120,172
3405-000,2015,5,22,4,64,77,141,120
3405-000,2015,5,22,5,119,118,237,141
3405-000,2015,5,22,6,247,232,479,237
3405-000,2015,5,22,7,515,505,1020,479
3405-000,2015,5,22,8,1026,1196,2222,1020
3405-000,2015,5,22,9,1154,1078,2232,2222
3405-000,2015,5,22,10,1050,898,1948,2232
3405-000,2015,5,22,11,1051,940,1991,1948
3405-000,2015,5,22,12,998,856,1854,1991
3405-000,2015,5,22,13,862,758,1620,1854
3405-000,2015,5,22,14,979,915,1894,1620
3405-000,2015,5,22,15,1181,965,2146,1894
3405-000,2015,5,22,16,1119,1015,2134,2146
3405-000,2015,5,22,17,1078,917,1995,2134
3405-000,2015,5,22,18,1321,993,2314,1995
3405-000,2015,5,22,19,1362,1128,2490,2314
3405-000,2015,5,22,20,891,831,1722,2490
3405-000,2015,5,22,21,665,634,1299,1722
3405-000,2015,5,22,22,504,488,992,1299
3405-000,2015,5,22,23,312,257,569,992
3405-000,2015,5,22,24,208,195,403,569
3405-000,2015,5,23,1,135,99,234,403
3405-000,2015,5,23,2,76,93,169,234
3405-000,2015,5,23,3,70,55,125,169
3405-000,2015,5,23,4,85,65,150,125
3405-000,2015,5,23,5,109,94,203,150
3405-000,2015,5,23,6,269,201,470,203
3405-000,2015,5,23,7,476,386,862,470
3405-000,2015,5,23,8,783,646,1429,862
3405-000,2015,5,23,9,946,728,1674,1429
3405-000,2015,5,23,10,936,801,1737,1674
3405-000,2015,5,23,11,1199,857,2056,1737
3405-000,2015,5,23,12,1255,835,2090,2056
3405-000,2015,5,23,13,1066,892,1958,2090
3405-000,2015,5,23,14,995,777,1772,1958
3405-000,2015,5,23,15,852,805,1657,1772
3405-000,2015,5,23,16,886,805,1691,1657
3405-000,2015,5,23,17,917,769,1686,1691
3405-000,2015,5,23,18,1031,936,1967,1686
3405-000,2015,5,23,19,923,768,1691,1967
3405-000,2015,5,23,20,574,619,1193,1691
3405-000,2015,5,23,21,379,483,862,1193
3405-000,2015,5,23,22,319,333,652,862
3405-000,2015,5,23,23,206,193,399,652
3405-000,2015,5,23,24,143,160,303,399
3405-000,2015,5,24,1,94,81,175,303
3405-000,2015,5,24,2,51,55,106,175
3405-000,2015,5,24,3,49,29,78,106
3405-000,2015,5,24,4,35,37,72,78
3405-000,2015,5,24,5,54,44,98,72
3405-000,2015,5,24,6,161,109,270,98
3405-000,2015,5,24,7,279,184,463,270
3405-000,2015,5,24,8,395,286,681,463
3405-000,2015,5,24,9,435,354,789,681
3405-000,2015,5,24,10,484,397,881,789
3405-000,2015,5,24,11,555,581,1136,881
3405-000,2015,5,24,12,623,544,1167,1136
3405-000,2015,5,24,13,501,478,979,1167
3405-000,2015,5,24,14,483,422,905,979
3405-000,2015,5,24,15,512,490,1002,905
3405-000,2015,5,24,16,667,539,1206,1002
3405-000,2015,5,24,17,657,546,1203,1206
3405-000,2015,5,24,18,615,615,1230,1203
3405-000,2015,5,24,19,558,629,1187,1230
3405-000,2015,5,24,20,459,667,1126,1187
3405-000,2015,5,24,21,443,469,912,1126
3405-000,2015,5,24,22,324,413,737,912
3405-000,2015,5,24,23,233,300,533,737
3405-000,2015,5,24,24,147,199,346,533
3405-000,2015,5,25,1,70,116,186,346
3405-000,2015,5,25,2,43,51,94,186
3405-000,2015,5,25,3,39,48,87,94
3405-000,2015,5,25,4,38,45,83,87
3405-000,2015,5,25,5,62,75,137,83
3405-000,2015,5,25,6,181,194,375,137
3405-000,2015,5,25,7,352,338,690,375
3405-000,2015,5,25,8,602,498,1100,690
3405-000,2015,5,25,9,629,502,1131,1100
3405-000,2015,5,25,10,694,538,1232,1131
3405-000,2015,5,25,11,721,588,1309,1232
3405-000,2015,5,25,12,730,619,1349,1309
3405-000,2015,5,25,13,631,628,1259,1349
3405-000,2015,5,25,14,680,751,1431,1259
3405-000,2015,5,25,15,657,755,1412,1431
3405-000,2015,5,25,16,653,838,1491,1412
3405-000,2015,5,25,17,732,973,1705,1491
3405-000,2015,5,25,18,788,870,1658,1705
3405-000,2015,5,25,19,634,846,1480,1658
3405-000,2015,5,25,20,494,698,1192,1480
3405-000,2015,5,25,21,392,520,912,1192
3405-000,2015,5,25,22,271,406,677,912
3405-000,2015,5,25,23,179,347,526,677
3405-000,2015,5,25,24,107,184,291,526
3405-000,2015,5,26,1,66,108,174,291
3405-000,2015,5,26,2,47,66,113,174
3405-000,2015,5,26,3,29,47,76,113
3405-000,2015,5,26,4,43,65,108,76
3405-000,2015,5,26,5,101,111,212,108
3405-000,2015,5,26,6,256,295,551,212
3405-000,2015,5,26,7,616,663,1279,551
3405-000,2015,5,26,8,1083,1473,2556,1279
3405-000,2015,5,26,9,1199,1234,2433,2556
3405-000,2015,5,26,10,1026,891,1917,2433
3405-000,2015,5,26,11,1041,962,2003,1917
3405-000,2015,5,26,12,933,1059,1992,2003
3405-000,2015,5,26,13,827,795,1622,1992
3405-000,2015,5,26,14,933,973,1906,1622
3405-000,2015,5,26,15,1071,1005,2076,1906
3405-000,2015,5,26,16,1039,913,1952,2076
3405-000,2015,5,26,17,1019,896,1915,1952
3405-000,2015,5,26,18,1251,1428,2679,1915
3405-000,2015,5,26,19,1285,1131,2416,2679
3405-000,2015,5,26,20,748,670,1418,2416
3405-000,2015,5,26,21,570,512,1082,1418
3405-000,2015,5,26,22,449,432,881,1082
3405-000,2015,5,26,23,257,260,517,881
3405-000,2015,5,26,24,142,168,310,517
3405-000,2015,5,27,1,91,114,205,310
3405-000,2015,5,27,2,63,74,137,205
3405-000,2015,5,27,3,57,55,112,137
3405-000,2015,5,27,4,62,69,131,112
3405-000,2015,5,27,5,122,114,236,131
3405-000,2015,5,27,6,252,225,477,236
3405-000,2015,5,27,7,539,532,1071,477
3405-000,2015,5,27,8,1026,1206,2232,1071
3405-000,2015,5,27,9,1199,1162,2361,2232
3405-000,2015,5,27,10,1035,883,1918,2361
3405-000,2015,5,27,11,1091,979,2070,1918
3405-000,2015,5,27,12,974,888,1862,2070
3405-000,2015,5,27,13,830,757,1587,1862
3405-000,2015,5,27,14,957,895,1852,1587
3405-000,2015,5,27,15,1077,1045,2122,1852
3405-000,2015,5,27,16,1137,938,2075,2122
3405-000,2015,5,27,17,1021,899,1920,2075
3405-000,2015,5,27,18,1159,1043,2202,1920
3405-000,2015,5,27,19,1072,947,2019,2202
3405-000,2015,5,27,20,720,646,1366,2019
3405-000,2015,5,27,21,524,571,1095,1366
3405-000,2015,5,27,22,367,403,770,1095
3405-000,2015,5,27,23,272,253,525,770
3405-000,2015,5,27,24,174,160,334,525
3405-000,2015,5,28,1,126,115,241,334
3405-000,2015,5,28,2,67,61,128,241
3405-000,2015,5,28,3,58,64,122,128
3405-000,2015,5,28,4,63,59,122,122
3405-000,2015,5,28,5,103,98,201,122
3405-000,2015,5,28,6,245,230,475,201
3405-000,2015,5,28,7,550,502,1052,475
3405-000,2015,5,28,8,1022,1169,2191,1052
3405-000,2015,5,28,9,1204,1195,2399,2191
3405-000,2015,5,28,10,1039,895,1934,2399
3405-000,2015,5,28,11,1020,971,1991,1934
3405-000,2015,5,28,12,974,919,1893,1991
3405-000,2015,5,28,13,838,813,1651,1893
3405-000,2015,5,28,14,943,915,1858,1651
3405-000,2015,5,28,15,1064,999,2063,1858
3405-000,2015,5,28,16,1050,928,1978,2063
3405-000,2015,5,28,17,1101,926,2027,1978
3405-000,2015,5,28,18,1090,929,2019,2027
3405-000,2015,5,28,19,965,948,1913,2019
3405-000,2015,5,28,20,732,627,1359,1913
3405-000,2015,5,28,21,543,572,1115,1359
3405-000,2015,5,28,22,381,425,806,1115
3405-000,2015,5,28,23,266,238,504,806
3405-000,2015,5,28,24,178,170,348,504
3405-000,2015,5,29,1,110,84,194,348
3405-000,2015,5,29,2,69,88,157,194
3405-000,2015,5,29,3,59,53,112,157
3405-000,2015,5,29,4,67,70,137,112
3405-000,2015,5,29,5,114,109,223,137
3405-000,2015,5,29,6,215,239,454,223
3405-000,2015,5,29,7,518,549,1067,454
3405-000,2015,5,29,8,1076,1221,2297,1067
3405-000,2015,5,29,9,1160,1153,2313,2297
3405-000,2015,5,29,10,1099,889,1988,2313
3405-000,2015,5,29,11,1063,988,2051,1988
3405-000,2015,5,29,12,993,889,1882,2051
3405-000,2015,5,29,13,828,766,1594,1882
3405-000,2015,5,29,14,935,877,1812,1594
3405-000,2015,5,29,15,1099,954,2053,1812
3405-000,2015,5,29,16,1051,967,2018,2053
3405-000,2015,5,29,17,1046,874,1920,2018
3405-000,2015,5,29,18,1289,962,2251,1920
3405-000,2015,5,29,19,1274,1034,2308,2251
3405-000,2015,5,29,20,829,702,1531,2308
3405-000,2015,5,29,21,599,543,1142,1531
3405-000,2015,5,29,22,436,415,851,1142
3405-000,2015,5,29,23,297,275,572,851
3405-000,2015,5,29,24,158,170,328,572
3405-000,2015,5,30,1,143,110,253,328
3405-000,2015,5,30,2,80,83,163,253
3405-000,2015,5,30,3,67,64,131,163
3405-000,2015,5,30,4,72,65,137,131
3405-000,2015,5,30,5,102,101,203,137
3405-000,2015,5,30,6,217,186,403,203
3405-000,2015,5,30,7,382,334,716,403
3405-000,2015,5,30,8,707,570,1277,716
3405-000,2015,5,30,9,864,705,1569,1277
3405-000,2015,5,30,10,877,628,1505,1569
3405-000,2015,5,30,11,852,710,1562,1505
3405-000,2015,5,30,12,844,676,1520,1562
3405-000,2015,5,30,13,712,597,1309,1520
3405-000,2015,5,30,14,738,583,1321,1309
3405-000,2015,5,30,15,750,659,1409,1321
3405-000,2015,5,30,16,750,636,1386,1409
3405-000,2015,5,30,17,797,726,1523,1386
3405-000,2015,5,30,18,841,807,1648,1523
3405-000,2015,5,30,19,621,669,1290,1648
3405-000,2015,5,30,20,441,499,940,1290
3405-000,2015,5,30,21,355,364,719,940
3405-000,2015,5,30,22,286,260,546,719
3405-000,2015,5,30,23,207,210,417,546
3405-000,2015,5,30,24,128,137,265,417
3405-000,2015,5,31,1,108,91,199,265
3405-000,2015,5,31,2,49,56,105,199
3405-000,2015,5,31,3,49,24,73,105
3405-000,2015,5,31,4,45,40,85,73
3405-000,2015,5,31,5,59,36,95,85
3405-000,2015,5,31,6,173,96,269,95
3405-000,2015,5,31,7,247,207,454,269
3405-000,2015,5,31,8,391,332,723,454
3405-000,2015,5,31,9,426,341,767,723
3405-000,2015,5,31,10,494,343,837,767
3405-000,2015,5,31,11,467,377,844,837
3405-000,2015,5,31,12,500,470,970,844
3405-000,2015,5,31,13,456,447,903,970
3405-000,2015,5,31,14,505,524,1029,903
3405-000,2015,5,31,15,517,559,1076,1029
3405-000,2015,5,31,16,546,613,1159,1076
3405-000,2015,5,31,17,560,617,1177,1159
3405-000,2015,5,31,18,567,653,1220,1177
3405-000,2015,5,31,19,445,548,993,1220
3405-000,2015,5,31,20,368,444,812,993
3405-000,2015,5,31,21,321,414,735,812
3405-000,2015,5,31,22,295,346,641,735
3405-000,2015,5,31,23,199,230,429,641
3405-000,2015,5,31,24,117,168,285,429
3405-000,2015,6,1,1,68,102,170,285
3405-000,2015,6,1,2,47,61,108,170
3405-000,2015,6,1,3,44,54,98,108
3405-000,2015,6,1,4,47,60,107,98
3405-000,2015,6,1,5,105,101,206,107
3405-000,2015,6,1,6,275,309,584,206
3405-000,2015,6,1,7,611,665,1276,584
3405-000,2015,6,1,8,1147,1472,2619,1276
3405-000,2015,6,1,9,1098,1189,2287,2619
3405-000,2015,6,1,10,949,855,1804,2287
3405-000,2015,6,1,11,947,862,1809,1804
3405-000,2015,6,1,12,950,834,1784,1809
3405-000,2015,6,1,13,762,759,1521,1784
3405-000,2015,6,1,14,882,906,1788,1521
3405-000,2015,6,1,15,974,915,1889,1788
3405-000,2015,6,1,16,978,840,1818,1889
3405-000,2015,6,1,17,949,865,1814,1818
3405-000,2015,6,1,18,1041,946,1987,1814
3405-000,2015,6,1,19,954,913,1867,1987
3405-000,2015,6,1,20,672,621,1293,1867
3405-000,2015,6,1,21,521,545,1066,1293
3405-000,2015,6,1,22,376,429,805,1066
3405-000,2015,6,1,23,258,252,510,805
3405-000,2015,6,1,24,147,148,295,510
3405-000,2015,6,2,1,96,91,187,295
3405-000,2015,6,2,2,60,77,137,187
3405-000,2015,6,2,3,48,45,93,137
3405-000,2015,6,2,4,69,75,144,93
3405-000,2015,6,2,5,103,99,202,144
3405-000,2015,6,2,6,240,248,488,202
3405-000,2015,6,2,7,530,478,1008,488
3405-000,2015,6,2,8,1011,1188,2199,1008
3405-000,2015,6,2,9,1229,1143,2372,2199
3405-000,2015,6,2,10,1039,868,1907,2372
3405-000,2015,6,2,11,1029,886,1915,1907
3405-000,2015,6,2,12,891,879,1770,1915
3405-000,2015,6,2,13,855,786,1641,1770
3405-000,2015,6,2,14,904,917,1821,1641
3405-000,2015,6,2,15,1036,963,1999,1821
3405-000,2015,6,2,16,951,937,1888,1999
3405-000,2015,6,2,17,1040,830,1870,1888
3405-000,2015,6,2,18,1034,921,1955,1870
3405-000,2015,6,2,19,979,896,1875,1955
3405-000,2015,6,2,20,684,606,1290,1875
3405-000,2015,6,2,21,554,550,1104,1290
3405-000,2015,6,2,22,349,357,706,1104
3405-000,2015,6,2,23,237,224,461,706
3405-000,2015,6,2,24,160,151,311,461
3405-000,2015,6,3,1,87,98,185,311
3405-000,2015,6,3,2,52,59,111,185
3405-000,2015,6,3,3,58,69,127,111
3405-000,2015,6,3,4,65,60,125,127
3405-000,2015,6,3,5,95,102,197,125
3405-000,2015,6,3,6,251,237,488,197
3405-000,2015,6,3,7,526,487,1013,488
3405-000,2015,6,3,8,976,1169,2145,1013
3405-000,2015,6,3,9,1190,1172,2362,2145
3405-000,2015,6,3,10,988,905,1893,2362
3405-000,2015,6,3,11,1073,924,1997,1893
3405-000,2015,6,3,12,1040,857,1897,1997
3405-000,2015,6,3,13,863,831,1694,1897
3405-000,2015,6,3,14,910,920,1830,1694
3405-000,2015,6,3,15,1013,1026,2039,1830
3405-000,2015,6,3,16,1036,924,1960,2039
3405-000,2015,6,3,17,1014,836,1850,1960
3405-000,2015,6,3,18,1093,981,2074,1850
3405-000,2015,6,3,19,1117,959,2076,2074
3405-000,2015,6,3,20,696,647,1343,2076
3405-000,2015,6,3,21,500,530,1030,1343
3405-000,2015,6,3,22,363,370,733,1030
3405-000,2015,6,3,23,243,216,459,733
3405-000,2015,6,3,24,141,133,274,459
3405-000,2015,6,4,1,95,98,193,274
3405-000,2015,6,4,2,61,98,159,193
3405-000,2015,6,4,3,58,52,110,159
3405-000,2015,6,4,4,65,89,154,110
3405-000,2015,6,4,5,89,103,192,154
3405-000,2015,6,4,6,260,229,489,192
3405-000,2015,6,4,7,519,462,981,489
3405-000,2015,6,4,8,1003,1230,2233,981
3405-000,2015,6,4,9,1231,1176,2407,2233
3405-000,2015,6,4,10,1063,865,1928,2407
3405-000,2015,6,4,11,978,952,1930,1928
3405-000,2015,6,4,12,1002,862,1864,1930
3405-000,2015,6,4,13,815,786,1601,1864
3405-000,2015,6,4,14,886,877,1763,1601
3405-000,2015,6,4,15,985,901,1886,1763
3405-000,2015,6,4,16,948,851,1799,1886
3405-000,2015,6,4,17,1051,927,1978,1799
3405-000,2015,6,4,18,1109,919,2028,1978
3405-000,2015,6,4,19,969,946,1915,2028
3405-000,2015,6,4,20,684,618,1302,1915
3405-000,2015,6,4,21,509,559,1068,1302
3405-000,2015,6,4,22,350,388,738,1068
3405-000,2015,6,4,23,235,251,486,738
3405-000,2015,6,4,24,141,168,309,486
3405-000,2015,6,5,1,90,116,206,309
3405-000,2015,6,5,2,74,61,135,206
3405-000,2015,6,5,3,50,50,100,135
3405-000,2015,6,5,4,69,73,142,100
3405-000,2015,6,5,5,114,94,208,142
3405-000,2015,6,5,6,231,227,458,208
3405-000,2015,6,5,7,492,456,948,458
3405-000,2015,6,5,8,915,1142,2057,948
3405-000,2015,6,5,9,1169,1137,2306,2057
3405-000,2015,6,5,10,989,832,1821,2306
3405-000,2015,6,5,11,1062,882,1944,1821
3405-000,2015,6,5,12,1011,870,1881,1944
3405-000,2015,6,5,13,846,827,1673,1881
3405-000,2015,6,5,14,989,873,1862,1673
3405-000,2015,6,5,15,1123,973,2096,1862
3405-000,2015,6,5,16,1041,940,1981,2096
3405-000,2015,6,5,17,1074,918,1992,1981
3405-000,2015,6,5,18,1247,1012,2259,1992
3405-000,2015,6,5,19,1293,1009,2302,2259
3405-000,2015,6,5,20,835,704,1539,2302
3405-000,2015,6,5,21,650,549,1199,1539
3405-000,2015,6,5,22,380,352,732,1199
3405-000,2015,6,5,23,260,255,515,732
3405-000,2015,6,5,24,167,152,319,515
3405-000,2015,6,6,1,80,86,166,319
3405-000,2015,6,6,2,80,65,145,166
3405-000,2015,6,6,3,53,52,105,145
3405-000,2015,6,6,4,55,51,106,105
3405-000,2015,6,6,5,96,97,193,106
3405-000,2015,6,6,6,224,206,430,193
3405-000,2015,6,6,7,432,334,766,430
3405-000,2015,6,6,8,683,552,1235,766
3405-000,2015,6,6,9,732,648,1380,1235
3405-000,2015,6,6,10,726,618,1344,1380
3405-000,2015,6,6,11,791,663,1454,1344
3405-000,2015,6,6,12,728,654,1382,1454
3405-000,2015,6,6,13,625,639,1264,1382
3405-000,2015,6,6,14,614,607,1221,1264
3405-000,2015,6,6,15,652,577,1229,1221
3405-000,2015,6,6,16,649,551,1200,1229
3405-000,2015,6,6,17,655,549,1204,1200
3405-000,2015,6,6,18,716,694,1410,1204
3405-000,2015,6,6,19,592,544,1136,1410
3405-000,2015,6,6,20,403,422,825,1136
3405-000,2015,6,6,21,288,318,606,825
3405-000,2015,6,6,22,224,269,493,606
3405-000,2015,6,6,23,189,156,345,493
3405-000,2015,6,6,24,92,128,220,345
3405-000,2015,6,7,1,75,56,131,220
3405-000,2015,6,7,2,42,50,92,131
3405-000,2015,6,7,3,31,31,62,92
3405-000,2015,6,7,4,30,32,62,62
3405-000,2015,6,7,5,44,35,79,62
3405-000,2015,6,7,6,148,102,250,79
3405-000,2015,6,7,7,241,150,391,250
3405-000,2015,6,7,8,331,230,561,391
3405-000,2015,6,7,9,350,285,635,561
3405-000,2015,6,7,10,396,303,699,635
3405-000,2015,6,7,11,427,344,771,699
3405-000,2015,6,7,12,407,347,754,771
3405-000,2015,6,7,13,389,363,752,754
3405-000,2015,6,7,14,395,401,796,752
3405-000,2015,6,7,15,474,499,973,796
3405-000,2015,6,7,16,432,586,1018,973
3405-000,2015,6,7,17,530,639,1169,1018
3405-000,2015,6,7,18,505,536,1041,1169
3405-000,2015,6,7,19,455,544,999,1041
3405-000,2015,6,7,20,358,552,910,999
3405-000,2015,6,7,21,290,423,713,910
3405-000,2015,6,7,22,240,330,570,713
3405-000,2015,6,7,23,154,237,391,570
3405-000,2015,6,7,24,119,174,293,391
3405-000,2015,6,8,1,66,105,171,293
3405-000,2015,6,8,2,49,62,111,171
3405-000,2015,6,8,3,34,48,82,111
3405-000,2015,6,8,4,38,64,102,82
3405-000,2015,6,8,5,92,105,197,102
3405-000,2015,6,8,6,267,287,554,197
3405-000,2015,6,8,7,633,666,1299,554
3405-000,2015,6,8,8,1035,1482,2517,1299
3405-000,2015,6,8,9,1142,1209,2351,2517
3405-000,2015,6,8,10,976,843,1819,2351
3405-000,2015,6,8,11,1016,924,1940,1819
3405-000,2015,6,8,12,937,811,1748,1940
3405-000,2015,6,8,13,790,785,1575,1748
3405-000,2015,6,8,14,893,891,1784,1575
3405-000,2015,6,8,15,1059,982,2041,1784
3405-000,2015,6,8,16,944,875,1819,2041
3405-000,2015,6,8,17,947,877,1824,1819
3405-000,2015,6,8,18,979,904,1883,1824
3405-000,2015,6,8,19,1032,940,1972,1883
3405-000,2015,6,8,20,681,601,1282,1972
3405-000,2015,6,8,21,556,522,1078,1282
3405-000,2015,6,8,22,387,419,806,1078
3405-000,2015,6,8,23,235,234,469,806
3405-000,2015,6,8,24,137,116,253,469
3405-000,2015,6,9,1,98,108,206,253
3405-000,2015,6,9,2,45,64,109,206
3405-000,2015,6,9,3,55,56,111,109
3405-000,2015,6,9,4,57,73,130,111
3405-000,2015,6,9,5,118,104,222,130
3405-000,2015,6,9,6,237,222,459,222
3405-000,2015,6,9,7,541,533,1074,459
3405-000,2015,6,9,8,990,1192,2182,1074
3405-000,2015,6,9,9,1149,1094,2243,2182
3405-000,2015,6,9,10,1031,883,1914,2243
3405-000,2015,6,9,11,1053,959,2012,1914
3405-000,2015,6,9,12,984,888,1872,2012
3405-000,2015,6,9,13,826,766,1592,1872
3405-000,2015,6,9,14,844,853,1697,1592
3405-000,2015,6,9,15,990,927,1917,1697
3405-000,2015,6,9,16,991,863,1854,1917
3405-000,2015,6,9,17,972,873,1845,1854
3405-000,2015,6,9,18,1006,855,1861,1845
3405-000,2015,6,9,19,990,927,1917,1861
3405-000,2015,6,9,20,675,613,1288,1917
3405-000,2015,6,9,21,566,581,1147,1288
3405-000,2015,6,9,22,407,411,818,1147
3405-000,2015,6,9,23,242,276,518,818
3405-000,2015,6,9,24,153,143,296,518
3405-000,2015,6,10,1,84,100,184,296
3405-000,2015,6,10,2,59,65,124,184
3405-000,2015,6,10,3,48,50,98,124
3405-000,2015,6,10,4,54,71,125,98
3405-000,2015,6,10,5,107,112,219,125
3405-000,2015,6,10,6,233,234,467,219
3405-000,2015,6,10,7,539,521,1060,467
3405-000,2015,6,10,8,990,1206,2196,1060
3405-000,2015,6,10,9,1375,1216,2591,2196
3405-000,2015,6,10,10,1105,886,1991,2591
3405-000,2015,6,10,11,1048,871,1919,1991
3405-000,2015,6,10,12,954,922,1876,1919
3405-000,2015,6,10,13,794,790,1584,1876
3405-000,2015,6,10,14,935,823,1758,1584
3405-000,2015,6,10,15,1018,1010,2028,1758
3405-000,2015,6,10,16,1010,899,1909,2028
3405-000,2015,6,10,17,1043,860,1903,1909
3405-000,2015,6,10,18,1150,991,2141,1903
3405-000,2015,6,10,19,1061,951,2012,2141
3405-000,2015,6,10,20,686,660,1346,2012
3405-000,2015,6,10,21,498,517,1015,1346
3405-000,2015,6,10,22,342,378,720,1015
3405-000,2015,6,10,23,260,215,475,720
3405-000,2015,6,10,24,137,166,303,475
3405-000,2015,6,11,1,97,111,208,303
3405-000,2015,6,11,2,68,71,139,208
3405-000,2015,6,11,3,56,55,111,139
3405-000,2015,6,11,4,59,74,133,111
3405-000,2015,6,11,5,121,106,227,133
3405-000,2015,6,11,6,245,247,492,227
3405-000,2015,6,11,7,546,521,1067,492
3405-000,2015,6,11,8,1066,1168,2234,1067
3405-000,2015,6,11,9,1211,1179,2390,2234
3405-000,2015,6,11,10,1021,832,1853,2390
3405-000,2015,6,11,11,1062,919,1981,1853
3405-000,2015,6,11,12,1015,907,1922,1981
3405-000,2015,6,11,13,824,778,1602,1922
3405-000,2015,6,11,14,906,853,1759,1602
3405-000,2015,6,11,15,1061,1002,2063,1759
3405-000,2015,6,11,16,969,930,1899,2063
3405-000,2015,6,11,17,986,856,1842,1899
3405-000,2015,6,11,18,1047,946,1993,1842
3405-000,2015,6,11,19,1023,932,1955,1993
3405-000,2015,6,11,20,665,643,1308,1955
3405-000,2015,6,11,21,513,520,1033,1308
3405-000,2015,6,11,22,371,372,743,1033
3405-000,2015,6,11,23,238,226,464,743
3405-000,2015,6,11,24,145,148,293,464
3405-000,2015,6,12,1,83,110,193,293
3405-000,2015,6,12,2,48,67,115,193
3405-000,2015,6,12,3,57,57,114,115
3405-000,2015,6,12,4,61,75,136,114
3405-000,2015,6,12,5,100,101,201,136
3405-000,2015,6,12,6,231,248,479,201
3405-000,2015,6,12,7,476,492,968,479
3405-000,2015,6,12,8,978,1185,2163,968
3405-000,2015,6,12,9,1211,1228,2439,2163
3405-000,2015,6,12,10,1033,907,1940,2439
3405-000,2015,6,12,11,1057,910,1967,1940
3405-000,2015,6,12,12,1017,838,1855,1967
3405-000,2015,6,12,13,894,776,1670,1855
3405-000,2015,6,12,14,903,874,1777,1670
3405-000,2015,6,12,15,1094,946,2040,1777
3405-000,2015,6,12,16,1015,959,1974,2040
3405-000,2015,6,12,17,1000,831,1831,1974
3405-000,2015,6,12,18,1249,1008,2257,1831
3405-000,2015,6,12,19,1328,1034,2362,2257
3405-000,2015,6,12,20,845,722,1567,2362
3405-000,2015,6,12,21,667,615,1282,1567
3405-000,2015,6,12,22,434,419,853,1282
3405-000,2015,6,12,23,317,237,554,853
3405-000,2015,6,12,24,185,166,351,554
3405-000,2015,6,13,1,131,129,260,351
3405-000,2015,6,13,2,70,80,150,260
3405-000,2015,6,13,3,60,67,127,150
3405-000,2015,6,13,4,68,63,131,127
3405-000,2015,6,13,5,103,118,221,131
3405-000,2015,6,13,6,255,195,450,221
3405-000,2015,6,13,7,417,362,779,450
3405-000,2015,6,13,8,724,588,1312,779
3405-000,2015,6,13,9,812,703,1515,1312
3405-000,2015,6,13,10,874,640,1514,1515
3405-000,2015,6,13,11,827,657,1484,1514
3405-000,2015,6,13,12,844,659,1503,1484
3405-000,2015,6,13,13,703,657,1360,1503
3405-000,2015,6,13,14,623,626,1249,1360
3405-000,2015,6,13,15,785,655,1440,1249
3405-000,2015,6,13,16,669,631,1300,1440
3405-000,2015,6,13,17,756,599,1355,1300
3405-000,2015,6,13,18,817,769,1586,1355
3405-000,2015,6,13,19,705,647,1352,1586
3405-000,2015,6,13,20,400,416,816,1352
3405-000,2015,6,13,21,300,340,640,816
3405-000,2015,6,13,22,288,270,558,640
3405-000,2015,6,13,23,181,195,376,558
3405-000,2015,6,13,24,124,136,260,376
3405-000,2015,6,14,1,75,67,142,260
3405-000,2015,6,14,2,55,47,102,142
3405-000,2015,6,14,3,32,30,62,102
3405-000,2015,6,14,4,38,35,73,62
3405-000,2015,6,14,5,53,36,89,73
3405-000,2015,6,14,6,115,78,193,89
3405-000,2015,6,14,7,195,138,333,193
3405-000,2015,6,14,8,252,221,473,333
3405-000,2015,6,14,9,334,315,649,473
3405-000,2015,6,14,10,413,355,768,649
3405-000,2015,6,14,11,505,379,884,768
3405-000,2015,6,14,12,448,398,846,884
3405-000,2015,6,14,13,446,394,840,846
3405-000,2015,6,14,14,481,451,932,840
3405-000,2015,6,14,15,506,499,1005,932
3405-000,2015,6,14,16,540,555,1095,1005
3405-000,2015,6,14,17,457,634,1091,1095
3405-000,2015,6,14,18,480,678,1158,1091
3405-000,2015,6,14,19,372,552,924,1158
3405-000,2015,6,14,20,359,501,860,924
3405-000,2015,6,14,21,306,396,702,860
3405-000,2015,6,14,22,217,338,555,702
3405-000,2015,6,14,23,169,264,433,555
3405-000,2015,6,14,24,103,158,261,433
3405-000,2015,6,15,1,57,93,150,261
3405-000,2015,6,15,2,37,74,111,150
3405-000,2015,6,15,3,42,44,86,111
3405-000,2015,6,15,4,33,49,82,86
3405-000,2015,6,15,5,103,109,212,82
3405-000,2015,6,15,6,249,294,543,212
3405-000,2015,6,15,7,604,641,1245,543
3405-000,2015,6,15,8,1099,1495,2594,1245
3405-000,2015,6,15,9,1157,1258,2415,2594
3405-000,2015,6,15,10,988,915,1903,2415
3405-000,2015,6,15,11,997,893,1890,1903
3405-000,2015,6,15,12,927,808,1735,1890
3405-000,2015,6,15,13,734,822,1556,1735
3405-000,2015,6,15,14,868,865,1733,1556
3405-000,2015,6,15,15,1079,928,2007,1733
3405-000,2015,6,15,16,1024,924,1948,2007
3405-000,2015,6,15,17,1010,954,1964,1948
3405-000,2015,6,15,18,1013,901,1914,1964
3405-000,2015,6,15,19,976,900,1876,1914
3405-000,2015,6,15,20,708,666,1374,1876
3405-000,2015,6,15,21,516,565,1081,1374
3405-000,2015,6,15,22,389,395,784,1081
3405-000,2015,6,15,23,227,242,469,784
3405-000,2015,6,15,24,153,151,304,469
3405-000,2015,6,16,1,84,103,187,304
3405-000,2015,6,16,2,71,75,146,187
3405-000,2015,6,16,3,57,46,103,146
3405-000,2015,6,16,4,50,72,122,103
3405-000,2015,6,16,5,116,106,222,122
3405-000,2015,6,16,6,218,257,475,222
3405-000,2015,6,16,7,532,520,1052,475
3405-000,2015,6,16,8,1026,1137,2163,1052
3405-000,2015,6,16,9,1181,1157,2338,2163
3405-000,2015,6,16,10,1050,910,1960,2338
3405-000,2015,6,16,11,1024,924,1948,1960
3405-000,2015,6,16,12,948,999,1947,1948
3405-000,2015,6,16,13,825,798,1623,1947
3405-000,2015,6,16,14,936,939,1875,1623
3405-000,2015,6,16,15,1031,949,1980,1875
3405-000,2015,6,16,16,979,973,1952,1980
3405-000,2015,6,16,17,1037,855,1892,1952
3405-000,2015,6,16,18,1093,935,2028,1892
3405-000,2015,6,16,19,1002,1005,2007,2028
3405-000,2015,6,16,20,668,642,1310,2007
3405-000,2015,6,16,21,576,526,1102,1310
3405-000,2015,6,16,22,384,391,775,1102
3405-000,2015,6,16,23,233,251,484,775
3405-000,2015,6,16,24,141,130,271,484
3405-000,2015,6,17,1,97,92,189,271
3405-000,2015,6,17,2,67,89,156,189
3405-000,2015,6,17,3,48,45,93,156
3405-000,2015,6,17,4,53,69,122,93
3405-000,2015,6,17,5,101,112,213,122
3405-000,2015,6,17,6,249,254,503,213
3405-000,2015,6,17,7,520,476,996,503
3405-000,2015,6,17,8,999,1166,2165,996
3405-000,2015,6,17,9,1184,1180,2364,2165
3405-000,2015,6,17,10,997,898,1895,2364
3405-000,2015,6,17,11,991,883,1874,1895
3405-000,2015,6,17,12,986,882,1868,1874
3405-000,2015,6,17,13,785,812,1597,1868
3405-000,2015,6,17,14,887,858,1745,1597
3405-000,2015,6,17,15,1003,957,1960,1745
3405-000,2015,6,17,16,1036,914,1950,1960
3405-000,2015,6,17,17,1007,901,1908,1950
3405-000,2015,6,17,18,1092,1035,2127,1908
3405-000,2015,6,17,19,1403,1101,2504,2127
3405-000,2015,6,17,20,751,635,1386,2504
3405-000,2015,6,17,21,443,464,907,1386
3405-000,2015,6,17,22,386,369,755,907
3405-000,2015,6,17,23,211,239,450,755
3405-000,2015,6,17,24,142,122,264,450
3405-000,2015,6,18,1,82,111,193,264
3405-000,2015,6,18,2,55,71,126,193
3405-000,2015,6,18,3,49,60,109,126
3405-000,2015,6,18,4,54,67,121,109
3405-000,2015,6,18,5,106,103,209,121
3405-000,2015,6,18,6,235,253,488,209
3405-000,2015,6,18,7,540,460,1000,488
3405-000,2015,6,18,8,1008,1220,2228,1000
3405-000,2015,6,18,9,1130,1199,2329,2228
3405-000,2015,6,18,10,1092,823,1915,2329
3405-000,2015,6,18,11,1018,949,1967,1915
3405-000,2015,6,18,12,954,880,1834,1967
3405-000,2015,6,18,13,800,747,1547,1834
3405-000,2015,6,18,14,904,850,1754,1547
3405-000,2015,6,18,15,1071,951,2022,1754
3405-000,2015,6,18,16,991,921,1912,2022
3405-000,2015,6,18,17,1025,822,1847,1912
3405-000,2015,6,18,18,1048,958,2006,1847
3405-000,2015,6,18,19,1007,921,1928,2006
3405-000,2015,6,18,20,714,636,1350,1928
3405-000,2015,6,18,21,564,551,1115,1350
3405-000,2015,6,18,22,384,409,793,1115
3405-000,2015,6,18,23,271,232,503,793
3405-000,2015,6,18,24,142,158,300,503
3405-000,2015,6,19,1,95,99,194,300
3405-000,2015,6,19,2,70,73,143,194
3405-000,2015,6,19,3,48,64,112,143
3405-000,2015,6,19,4,60,67,127,112
3405-000,2015,6,19,5,131,123,254,127
3405-000,2015,6,19,6,277,253,530,254
3405-000,2015,6,19,7,516,529,1045,530
3405-000,2015,6,19,8,993,1144,2137,1045
3405-000,2015,6,19,9,1221,1113,2334,2137
3405-000,2015,6,19,10,1105,923,2028,2334
3405-000,2015,6,19,11,1038,954,1992,2028
3405-000,2015,6,19,12,1042,859,1901,1992
3405-000,2015,6,19,13,847,807,1654,1901
3405-000,2015,6,19,14,955,895,1850,1654
3405-000,2015,6,19,15,1063,918,1981,1850
3405-000,2015,6,19,16,1135,929,2064,1981
3405-000,2015,6,19,17,1062,946,2008,2064
3405-000,2015,6,19,18,1203,953,2156,2008
3405-000,2015,6,19,19,1390,1007,2397,2156
3405-000,2015,6,19,20,911,799,1710,2397
3405-000,2015,6,19,21,663,606,1269,1710
3405-000,2015,6,19,22,406,452,858,1269
3405-000,2015,6,19,23,299,252,551,858
3405-000,2015,6,19,24,179,192,371,551
3405-000,2015,6,20,1,131,118,249,371
3405-000,2015,6,20,2,62,81,143,249
3405-000,2015,6,20,3,75,66,141,143
3405-000,2015,6,20,4,71,60,131,141
3405-000,2015,6,20,5,112,124,236,131
3405-000,2015,6,20,6,265,250,515,236
3405-000,2015,6,20,7,438,343,781,515
3405-000,2015,6,20,8,660,541,1201,781
3405-000,2015,6,20,9,877,713,1590,1201
3405-000,2015,6,20,10,850,695,1545,1590
3405-000,2015,6,20,11,845,687,1532,1545
3405-000,2015,6,20,12,829,785,1614,1532
3405-000,2015,6,20,13,620,662,1282,1614
3405-000,2015,6,20,14,756,689,1445,1282
3405-000,2015,6,20,15,749,601,1350,1445
3405-000,2015,6,20,16,695,665,1360,1350
3405-000,2015,6,20,17,708,638,1346,1360
3405-000,2015,6,20,18,718,658,1376,1346
3405-000,2015,6,20,19,590,602,1192,1376
3405-000,2015,6,20,20,406,405,811,1192
3405-000,2015,6,20,21,297,341,638,811
3405-000,2015,6,20,22,243,269,512,638
3405-000,2015,6,20,23,201,152,353,512
3405-000,2015,6,20,24,109,144,253,353
3405-000,2015,6,21,1,73,72,145,253
3405-000,2015,6,21,2,54,60,114,145
3405-000,2015,6,21,3,47,29,76,114
3405-000,2015,6,21,4,38,33,71,76
3405-000,2015,6,21,5,59,45,104,71
3405-000,2015,6,21,6,131,114,245,104
3405-000,2015,6,21,7,272,199,471,245
3405-000,2015,6,21,8,303,283,586,471
3405-000,2015,6,21,9,386,301,687,586
3405-000,2015,6,21,10,442,332,774,687
3405-000,2015,6,21,11,513,345,858,774
3405-000,2015,6,21,12,422,394,816,858
3405-000,2015,6,21,13,436,410,846,816
3405-000,2015,6,21,14,439,464,903,846
3405-000,2015,6,21,15,460,513,973,903
3405-000,2015,6,21,16,497,595,1092,973
3405-000,2015,6,21,17,488,577,1065,1092
3405-000,2015,6,21,18,561,615,1176,1065
3405-000,2015,6,21,19,471,525,996,1176
3405-000,2015,6,21,20,385,538,923,996
3405-000,2015,6,21,21,343,487,830,923
3405-000,2015,6,21,22,289,373,662,830
3405-000,2015,6,21,23,234,287,521,662
3405-000,2015,6,21,24,115,207,322,521
3405-000,2015,6,22,1,69,103,172,322
3405-000,2015,6,22,2,43,80,123,172
3405-000,2015,6,22,3,39,51,90,123
3405-000,2015,6,22,4,45,72,117,90
3405-000,2015,6,22,5,108,85,193,117
3405-000,2015,6,22,6,311,291,602,193
3405-000,2015,6,22,7,579,663,1242,602
3405-000,2015,6,22,8,1072,1456,2528,1242
3405-000,2015,6,22,9,1133,1235,2368,2528
3405-000,2015,6,22,10,932,876,1808,2368
3405-000,2015,6,22,11,896,930,1826,1808
3405-000,2015,6,22,12,880,781,1661,1826
3405-000,2015,6,22,13,744,735,1479,1661
3405-000,2015,6,22,14,854,857,1711,1479
3405-000,2015,6,22,15,1047,935,1982,1711
3405-000,2015,6,22,16,988,902,1890,1982
3405-000,2015,6,22,17,1002,867,1869,1890
3405-000,2015,6,22,18,1015,925,1940,1869
3405-000,2015,6,22,19,985,914,1899,1940
3405-000,2015,6,22,20,706,643,1349,1899
3405-000,2015,6,22,21,524,584,1108,1349
3405-000,2015,6,22,22,385,400,785,1108
3405-000,2015,6,22,23,236,213,449,785
3405-000,2015,6,22,24,135,152,287,449
3405-000,2015,6,23,1,86,104,190,287
3405-000,2015,6,23,2,78,74,152,190
3405-000,2015,6,23,3,45,41,86,152
3405-000,2015,6,23,4,56,80,136,86
3405-000,2015,6,23,5,99,113,212,136
3405-000,2015,6,23,6,275,267,542,212
3405-000,2015,6,23,7,537,529,1066,542
3405-000,2015,6,23,8,999,1223,2222,1066
3405-000,2015,6,23,9,1204,1133,2337,2222
3405-000,2015,6,23,10,1103,921,2024,2337
3405-000,2015,6,23,11,1027,964,1991,2024
3405-000,2015,6,23,12,992,867,1859,1991
3405-000,2015,6,23,13,790,760,1550,1859
3405-000,2015,6,23,14,857,914,1771,1550
3405-000,2015,6,23,15,1028,942,1970,1771
3405-000,2015,6,23,16,1059,873,1932,1970
3405-000,2015,6,23,17,981,904,1885,1932
3405-000,2015,6,23,18,1018,869,1887,1885
3405-000,2015,6,23,19,1024,930,1954,1887
3405-000,2015,6,23,20,707,652,1359,1954
3405-000,2015,6,23,21,536,576,1112,1359
3405-000,2015,6,23,22,386,429,815,1112
3405-000,2015,6,23,23,286,232,518,815
3405-000,2015,6,23,24,148,154,302,518
3405-000,2015,6,24,1,112,106,218,302
3405-000,2015,6,24,2,72,74,146,218
3405-000,2015,6,24,3,44,53,97,146
3405-000,2015,6,24,4,58,63,121,97
3405-000,2015,6,24,5,106,121,227,121
3405-000,2015,6,24,6,269,223,492,227
3405-000,2015,6,24,7,528,473,1001,492
3405-000,2015,6,24,8,1006,1204,2210,1001
3405-000,2015,6,24,9,1163,1223,2386,2210
3405-000,2015,6,24,10,1054,894,1948,2386
3405-000,2015,6,24,11,1065,960,2025,1948
3405-000,2015,6,24,12,977,938,1915,2025
3405-000,2015,6,24,13,793,790,1583,1915
3405-000,2015,6,24,14,942,955,1897,1583
3405-000,2015,6,24,15,1099,1031,2130,1897
3405-000,2015,6,24,16,992,908,1900,2130
3405-000,2015,6,24,17,1085,874,1959,1900
3405-000,2015,6,24,18,1143,939,2082,1959
3405-000,2015,6,24,19,1071,988,2059,2082
3405-000,2015,6,24,20,713,681,1394,2059
3405-000,2015,6,24,21,448,492,940,1394
3405-000,2015,6,24,22,360,371,731,940
3405-000,2015,6,24,23,265,228,493,731
3405-000,2015,6,24,24,147,149,296,493
3405-000,2015,6,25,1,100,103,203,296
3405-000,2015,6,25,2,51,69,120,203
3405-000,2015,6,25,3,57,54,111,120
3405-000,2015,6,25,4,52,71,123,111
3405-000,2015,6,25,5,84,107,191,123
3405-000,2015,6,25,6,263,220,483,191
3405-000,2015,6,25,7,524,492,1016,483
3405-000,2015,6,25,8,970,1199,2169,1016
3405-000,2015,6,25,9,1184,1128,2312,2169
3405-000,2015,6,25,10,1006,924,1930,2312
3405-000,2015,6,25,11,1045,957,2002,1930
3405-000,2015,6,25,12,996,875,1871,2002
3405-000,2015,6,25,13,866,764,1630,1871
3405-000,2015,6,25,14,857,952,1809,1630
3405-000,2015,6,25,15,1053,920,1973,1809
3405-000,2015,6,25,16,1048,988,2036,1973
3405-000,2015,6,25,17,1073,899,1972,2036
3405-000,2015,6,25,18,1001,946,1947,1972
3405-000,2015,6,25,19,957,956,1913,1947
3405-000,2015,6,25,20,635,615,1250,1913
3405-000,2015,6,25,21,479,530,1009,1250
3405-000,2015,6,25,22,342,395,737,1009
3405-000,2015,6,25,23,246,253,499,737
3405-000,2015,6,25,24,138,117,255,499
3405-000,2015,6,26,1,108,118,226,255
3405-000,2015,6,26,2,66,68,134,226
3405-000,2015,6,26,3,45,58,103,134
3405-000,2015,6,26,4,34,57,91,103
3405-000,2015,6,26,5,75,93,168,91
3405-000,2015,6,26,6,136,156,292,168
3405-000,2015,6,26,7,361,372,733,292
3405-000,2015,6,26,8,897,1081,1978,733
3405-000,2015,6,26,9,1121,1142,2263,1978
3405-000,2015,6,26,10,884,841,1725,2263
3405-000,2015,6,26,11,942,874,1816,1725
3405-000,2015,6,26,12,960,912,1872,1816
3405-000,2015,6,26,13,847,751,1598,1872
3405-000,2015,6,26,14,832,839,1671,1598
3405-000,2015,6,26,15,949,966,1915,1671
3405-000,2015,6,26,16,954,908,1862,1915
3405-000,2015,6,26,17,935,896,1831,1862
3405-000,2015,6,26,18,1152,1005,2157,1831
3405-000,2015,6,26,19,1280,961,2241,2157
3405-000,2015,6,26,20,859,700,1559,2241
3405-000,2015,6,26,21,626,544,1170,1559
3405-000,2015,6,26,22,402,385,787,1170
3405-000,2015,6,26,23,315,236,551,787
3405-000,2015,6,26,24,200,189,389,551
3405-000,2015,6,27,1,90,114,204,389
3405-000,2015,6,27,2,69,66,135,204
3405-000,2015,6,27,3,66,51,117,135
3405-000,2015,6,27,4,61,54,115,117
3405-000,2015,6,27,5,92,97,189,115
3405-000,2015,6,27,6,223,220,443,189
3405-000,2015,6,27,7,452,367,819,443
3405-000,2015,6,27,8,724,602,1326,819
3405-000,2015,6,27,9,855,722,1577,1326
3405-000,2015,6,27,10,858,708,1566,1577
3405-000,2015,6,27,11,890,713,1603,1566
3405-000,2015,6,27,12,929,679,1608,1603
3405-000,2015,6,27,13,808,697,1505,1608
3405-000,2015,6,27,14,734,651,1385,1505
3405-000,2015,6,27,15,720,678,1398,1385
3405-000,2015,6,27,16,763,668,1431,1398
3405-000,2015,6,27,17,737,733,1470,1431
3405-000,2015,6,27,18,885,826,1711,1470
3405-000,2015,6,27,19,719,631,1350,1711
3405-000,2015,6,27,20,462,520,982,1350
3405-000,2015,6,27,21,382,420,802,982
3405-000,2015,6,27,22,316,306,622,802
3405-000,2015,6,27,23,231,199,430,622
3405-000,2015,6,27,24,135,141,276,430
3405-000,2015,6,28,1,75,76,151,276
3405-000,2015,6,28,2,44,46,90,151
3405-000,2015,6,28,3,52,33,85,90
3405-000,2015,6,28,4,25,41,66,85
3405-000,2015,6,28,5,63,48,111,66
3405-000,2015,6,28,6,128,101,229,111
3405-000,2015,6,28,7,248,172,420,229
3405-000,2015,6,28,8,339,257,596,420
3405-000,2015,6,28,9,407,316,723,596
3405-000,2015,6,28,10,485,349,834,723
3405-000,2015,6,28,11,556,435,991,834
3405-000,2015,6,28,12,486,445,931,991
3405-000,2015,6,28,13,440,444,884,931
3405-000,2015,6,28,14,482,426,908,884
3405-000,2015,6,28,15,481,515,996,908
3405-000,2015,6,28,16,530,600,1130,996
3405-000,2015,6,28,17,546,625,1171,1130
3405-000,2015,6,28,18,553,688,1241,1171
3405-000,2015,6,28,19,487,625,1112,1241
3405-000,2015,6,28,20,399,549,948,1112
3405-000,2015,6,28,21,345,458,803,948
3405-000,2015,6,28,22,268,401,669,803
3405-000,2015,6,28,23,177,322,499,669
3405-000,2015,6,28,24,106,176,282,499
3405-000,2015,6,29,1,71,128,199,282
3405-000,2015,6,29,2,48,61,109,199
3405-000,2015,6,29,3,48,47,95,109
3405-000,2015,6,29,4,49,58,107,95
3405-000,2015,6,29,5,99,104,203,107
3405-000,2015,6,29,6,294,291,585,203
3405-000,2015,6,29,7,597,645,1242,585
3405-000,2015,6,29,8,1108,1491,2599,1242
3405-000,2015,6,29,9,1193,1228,2421,2599
3405-000,2015,6,29,10,1014,898,1912,2421
3405-000,2015,6,29,11,1046,1008,2054,1912
3405-000,2015,6,29,12,955,929,1884,2054
3405-000,2015,6,29,13,860,787,1647,1884
3405-000,2015,6,29,14,897,964,1861,1647
3405-000,2015,6,29,15,1127,1030,2157,1861
3405-000,2015,6,29,16,1064,933,1997,2157
3405-000,2015,6,29,17,1032,891,1923,1997
3405-000,2015,6,29,18,1083,1019,2102,1923
3405-000,2015,6,29,19,1034,948,1982,2102
3405-000,2015,6,29,20,740,673,1413,1982
3405-000,2015,6,29,21,582,532,1114,1413
3405-000,2015,6,29,22,418,454,872,1114
3405-000,2015,6,29,23,290,248,538,872
3405-000,2015,6,29,24,141,151,292,538
3405-000,2015,6,30,1,94,111,205,292
3405-000,2015,6,30,2,61,72,133,205
3405-000,2015,6,30,3,61,64,125,133
3405-000,2015,6,30,4,69,72,141,125
3405-000,2015,6,30,5,109,122,231,141
3405-000,2015,6,30,6,238,221,459,231
3405-000,2015,6,30,7,500,471,971,459
3405-000,2015,6,30,8,1006,1215,2221,971
3405-000,2015,6,30,9,1199,1139,2338,2221
3405-000,2015,6,30,10,1070,913,1983,2338
3405-000,2015,6,30,11,1041,925,1966,1983
3405-000,2015,6,30,12,950,903,1853,1966
3405-000,2015,6,30,13,820,735,1555,1853
3405-000,2015,6,30,14,926,895,1821,1555
3405-000,2015,6,30,15,1023,964,1987,1821
3405-000,2015,6,30,16,1017,913,1930,1987
3405-000,2015,6,30,17,1045,849,1894,1930
3405-000,2015,6,30,18,1035,910,1945,1894
3405-000,2015,6,30,19,977,904,1881,1945
3405-000,2015,6,30,20,707,637,1344,1881
3405-000,2015,6,30,21,492,517,1009,1344
3405-000,2015,6,30,22,353,385,738,1009
3405-000,2015,6,30,23,232,242,474,738
3405-000,2015,6,30,24,145,141,286,474
3405-000,2015,7,1,1,102,87,189,286
3405-000,2015,7,1,2,75,82,157,189
3405-000,2015,7,1,3,57,44,101,157
3405-000,2015,7,1,4,66,60,126,101
3405-000,2015,7,1,5,101,102,203,126
3405-000,2015,7,1,6,270,253,523,203
3405-000,2015,7,1,7,516,502,1018,523
3405-000,2015,7,1,8,1000,1196,2196,1018
3405-000,2015,7,1,9,1191,1169,2360,2196
3405-000,2015,7,1,10,1047,949,1996,2360
3405-000,2015,7,1,11,1020,951,1971,1996
3405-000,2015,7,1,12,1101,949,2050,1971
3405-000,2015,7,1,13,809,803,1612,2050
3405-000,2015,7,1,14,893,948,1841,1612
3405-000,2015,7,1,15,1135,977,2112,1841
3405-000,2015,7,1,16,1053,994,2047,2112
3405-000,2015,7,1,17,990,906,1896,2047
3405-000,2015,7,1,18,1126,934,2060,1896
3405-000,2015,7,1,19,1035,946,1981,2060
3405-000,2015,7,1,20,731,640,1371,1981
3405-000,2015,7,1,21,507,532,1039,1371
3405-000,2015,7,1,22,383,377,760,1039
3405-000,2015,7,1,23,271,249,520,760
3405-000,2015,7,1,24,114,157,271,520
3405-000,2015,7,2,1,100,107,207,271
3405-000,2015,7,2,2,58,65,123,207
3405-000,2015,7,2,3,55,54,109,123
3405-000,2015,7,2,4,52,67,119,109
3405-000,2015,7,2,5,98,107,205,119
3405-000,2015,7,2,6,239,220,459,205
3405-000,2015,7,2,7,520,553,1073,459
3405-000,2015,7,2,8,1014,1243,2257,1073
3405-000,2015,7,2,9,1200,1220,2420,2257
3405-000,2015,7,2,10,1067,946,2013,2420
3405-000,2015,7,2,11,1012,1005,2017,2013
3405-000,2015,7,2,12,989,978,1967,2017
3405-000,2015,7,2,13,819,796,1615,1967
3405-000,2015,7,2,14,975,962,1937,1615
3405-000,2015,7,2,15,1070,982,2052,1937
3405-000,2015,7,2,16,1114,955,2069,2052
3405-000,2015,7,2,17,997,943,1940,2069
3405-000,2015,7,2,18,1123,978,2101,1940
3405-000,2015,7,2,19,973,907,1880,2101
3405-000,2015,7,2,20,710,598,1308,1880
3405-000,2015,7,2,21,575,571,1146,1308
3405-000,2015,7,2,22,384,415,799,1146
3405-000,2015,7,2,23,270,236,506,799
3405-000,2015,7,2,24,168,159,327,506
3405-000,2015,7,3,1,82,111,193,327
3405-000,2015,7,3,2,57,65,122,193
3405-000,2015,7,3,3,50,50,100,122
3405-000,2015,7,3,4,44,67,111,100
3405-000,2015,7,3,5,98,107,205,111
3405-000,2015,7,3,6,236,231,467,205
3405-000,2015,7,3,7,497,468,965,467
3405-000,2015,7,3,8,1035,1170,2205,965
3405-000,2015,7,3,9,1192,1168,2360,2205
3405-000,2015,7,3,10,1053,943,1996,2360
3405-000,2015,7,3,11,1110,984,2094,1996
3405-000,2015,7,3,12,998,989,1987,2094
3405-000,2015,7,3,13,838,789,1627,1987
3405-000,2015,7,3,14,938,929,1867,1627
3405-000,2015,7,3,15,1104,1040,2144,1867
3405-000,2015,7,3,16,1102,987,2089,2144
3405-000,2015,7,3,17,1110,914,2024,2089
3405-000,2015,7,3,18,1257,992,2249,2024
3405-000,2015,7,3,19,1324,1094,2418,2249
3405-000,2015,7,3,20,926,797,1723,2418
3405-000,2015,7,3,21,672,580,1252,1723
3405-000,2015,7,3,22,464,447,911,1252
3405-000,2015,7,3,23,315,290,605,911
3405-000,2015,7,3,24,176,160,336,605
3405-000,2015,7,4,1,113,120,233,336
3405-000,2015,7,4,2,81,87,168,233
3405-000,2015,7,4,3,51,53,104,168
3405-000,2015,7,4,4,58,71,129,104
3405-000,2015,7,4,5,116,99,215,129
3405-000,2015,7,4,6,252,180,432,215
3405-000,2015,7,4,7,462,392,854,432
3405-000,2015,7,4,8,699,550,1249,854
3405-000,2015,7,4,9,1032,720,1752,1249
3405-000,2015,7,4,10,1005,700,1705,1752
3405-000,2015,7,4,11,973,754,1727,1705
3405-000,2015,7,4,12,915,713,1628,1727
3405-000,2015,7,4,13,804,667,1471,1628
3405-000,2015,7,4,14,754,670,1424,1471
3405-000,2015,7,4,15,743,758,1501,1424
3405-000,2015,7,4,16,765,745,1510,1501
3405-000,2015,7,4,17,819,703,1522,1510
3405-000,2015,7,4,18,885,824,1709,1522
3405-000,2015,7,4,19,746,714,1460,1709
3405-000,2015,7,4,20,491,531,1022,1460
3405-000,2015,7,4,21,392,411,803,1022
3405-000,2015,7,4,22,320,293,613,803
3405-000,2015,7,4,23,208,225,433,613
3405-000,2015,7,4,24,123,178,301,433
3405-000,2015,7,5,1,83,82,165,301
3405-000,2015,7,5,2,56,68,124,165
3405-000,2015,7,5,3,42,41,83,124
3405-000,2015,7,5,4,39,36,75,83
3405-000,2015,7,5,5,69,57,126,75
3405-000,2015,7,5,6,138,99,237,126
3405-000,2015,7,5,7,231,192,423,237
3405-000,2015,7,5,8,343,249,592,423
3405-000,2015,7,5,9,404,305,709,592
3405-000,2015,7,5,10,457,359,816,709
3405-000,2015,7,5,11,503,427,930,816
3405-000,2015,7,5,12,507,579,1086,930
3405-000,2015,7,5,13,450,438,888,1086
3405-000,2015,7,5,14,497,537,1034,888
3405-000,2015,7,5,15,530,563,1093,1034
3405-000,2015,7,5,16,532,624,1156,1093
3405-000,2015,7,5,17,575,631,1206,1156
3405-000,2015,7,5,18,590,587,1177,1206
3405-000,2015,7,5,19,522,592,1114,1177
3405-000,2015,7,5,20,412,559,971,1114
3405-000,2015,7,5,21,381,464,845,971
3405-000,2015,7,5,22,270,376,646,845
3405-000,2015,7,5,23,199,292,491,646
3405-000,2015,7,5,24,114,175,289,491
3405-000,2015,7,6,1,75,127,202,289
3405-000,2015,7,6,2,51,66,117,202
3405-000,2015,7,6,3,35,47,82,117
3405-000,2015,7,6,4,48,66,114,82
3405-000,2015,7,6,5,91,102,193,114
3405-000,2015,7,6,6,265,277,542,193
3405-000,2015,7,6,7,576,666,1242,542
3405-000,2015,7,6,8,1056,1498,2554,1242
3405-000,2015,7,6,9,1192,1250,2442,2554
3405-000,2015,7,6,10,1055,910,1965,2442
3405-000,2015,7,6,11,1011,1031,2042,1965
3405-000,2015,7,6,12,974,896,1870,2042
3405-000,2015,7,6,13,891,782,1673,1870
3405-000,2015,7,6,14,877,892,1769,1673
3405-000,2015,7,6,15,1022,1014,2036,1769
3405-000,2015,7,6,16,1035,956,1991,2036
3405-000,2015,7,6,17,1049,948,1997,1991
3405-000,2015,7,6,18,1023,972,1995,1997
3405-000,2015,7,6,19,988,872,1860,1995
3405-000,2015,7,6,20,712,665,1377,1860
3405-000,2015,7,6,21,549,550,1099,1377
3405-000,2015,7,6,22,401,442,843,1099
3405-000,2015,7,6,23,242,234,476,843
3405-000,2015,7,6,24,135,180,315,476
3405-000,2015,7,7,1,77,104,181,315
3405-000,2015,7,7,2,51,64,115,181
3405-000,2015,7,7,3,43,52,95,115
3405-000,2015,7,7,4,59,76,135,95
3405-000,2015,7,7,5,94,110,204,135
3405-000,2015,7,7,6,248,228,476,204
3405-000,2015,7,7,7,501,513,1014,476
3405-000,2015,7,7,8,1004,1181,2185,1014
3405-000,2015,7,7,9,1228,1185,2413,2185
3405-000,2015,7,7,10,1061,967,2028,2413
3405-000,2015,7,7,11,1065,1010,2075,2028
3405-000,2015,7,7,12,973,929,1902,2075
3405-000,2015,7,7,13,890,791,1681,1902
3405-000,2015,7,7,14,915,936,1851,1681
3405-000,2015,7,7,15,1105,1070,2175,1851
3405-000,2015,7,7,16,1009,919,1928,2175
3405-000,2015,7,7,17,994,846,1840,1928
3405-000,2015,7,7,18,1023,899,1922,1840
3405-000,2015,7,7,19,1040,955,1995,1922
3405-000,2015,7,7,20,647,595,1242,1995
3405-000,2015,7,7,21,515,538,1053,1242
3405-000,2015,7,7,22,380,397,777,1053
3405-000,2015,7,7,23,226,213,439,777
3405-000,2015,7,7,24,135,167,302,439
3405-000,2015,7,8,1,80,107,187,302
3405-000,2015,7,8,2,47,81,128,187
3405-000,2015,7,8,3,52,58,110,128
3405-000,2015,7,8,4,54,68,122,110
3405-000,2015,7,8,5,93,93,186,122
3405-000,2015,7,8,6,201,211,412,186
3405-000,2015,7,8,7,481,455,936,412
3405-000,2015,7,8,8,953,1136,2089,936
3405-000,2015,7,8,9,1194,1171,2365,2089
3405-000,2015,7,8,10,949,881,1830,2365
3405-000,2015,7,8,11,1019,951,1970,1830
3405-000,2015,7,8,12,975,883,1858,1970
3405-000,2015,7,8,13,759,750,1509,1858
3405-000,2015,7,8,14,829,908,1737,1509
3405-000,2015,7,8,15,969,959,1928,1737
3405-000,2015,7,8,16,993,869,1862,1928
3405-000,2015,7,8,17,978,851,1829,1862
3405-000,2015,7,8,18,1040,977,2017,1829
3405-000,2015,7,8,19,1127,915,2042,2017
3405-000,2015,7,8,20,580,573,1153,2042
3405-000,2015,7,8,21,464,436,900,1153
3405-000,2015,7,8,22,336,369,705,900
3405-000,2015,7,8,23,240,184,424,705
3405-000,2015,7,8,24,153,154,307,424
3405-000,2015,7,9,1,81,86,167,307
3405-000,2015,7,9,2,72,78,150,167
3405-000,2015,7,9,3,48,49,97,150
3405-000,2015,7,9,4,37,73,110,97
3405-000,2015,7,9,5,101,91,192,110
3405-000,2015,7,9,6,203,219,422,192
3405-000,2015,7,9,7,483,516,999,422
3405-000,2015,7,9,8,1004,1174,2178,999
3405-000,2015,7,9,9,1169,1179,2348,2178
3405-000,2015,7,9,10,996,949,1945,2348
3405-000,2015,7,9,11,993,901,1894,1945
3405-000,2015,7,9,12,932,830,1762,1894
3405-000,2015,7,9,13,818,737,1555,1762
3405-000,2015,7,9,14,884,905,1789,1555
3405-000,2015,7,9,15,1017,1008,2025,1789
3405-000,2015,7,9,16,1038,949,1987,2025
3405-000,2015,7,9,17,944,866,1810,1987
3405-000,2015,7,9,18,1050,904,1954,1810
3405-000,2015,7,9,19,961,911,1872,1954
3405-000,2015,7,9,20,635,594,1229,1872
3405-000,2015,7,9,21,531,519,1050,1229
3405-000,2015,7,9,22,345,370,715,1050
3405-000,2015,7,9,23,247,238,485,715
3405-000,2015,7,9,24,155,160,315,485
3405-000,2015,7,10,1,89,106,195,315
3405-000,2015,7,10,2,45,80,125,195
3405-000,2015,7,10,3,46,63,109,125
3405-000,2015,7,10,4,49,61,110,109
3405-000,2015,7,10,5,101,76,177,110
3405-000,2015,7,10,6,256,231,487,177
3405-000,2015,7,10,7,528,483,1011,487
3405-000,2015,7,10,8,974,1261,2235,1011
3405-000,2015,7,10,9,1192,1211,2403,2235
3405-000,2015,7,10,10,1053,964,2017,2403
3405-000,2015,7,10,11,1100,1040,2140,2017
3405-000,2015,7,10,12,969,942,1911,2140
3405-000,2015,7,10,13,907,807,1714,1911
3405-000,2015,7,10,14,983,989,1972,1714
3405-000,2015,7,10,15,1141,1017,2158,1972
3405-000,2015,7,10,16,1097,1010,2107,2158
3405-000,2015,7,10,17,1158,949,2107,2107
3405-000,2015,7,10,18,1331,1075,2406,2107
3405-000,2015,7,10,19,1386,1032,2418,2406
3405-000,2015,7,10,20,1011,759,1770,2418
3405-000,2015,7,10,21,690,623,1313,1770
3405-000,2015,7,10,22,490,440,930,1313
3405-000,2015,7,10,23,275,284,559,930
3405-000,2015,7,10,24,175,196,371,559
3405-000,2015,7,11,1,101,112,213,371
3405-000,2015,7,11,2,69,82,151,213
3405-000,2015,7,11,3,54,70,124,151
3405-000,2015,7,11,4,52,68,120,124
3405-000,2015,7,11,5,101,97,198,120
3405-000,2015,7,11,6,263,195,458,198
3405-000,2015,7,11,7,452,363,815,458
3405-000,2015,7,11,8,726,641,1367,815
3405-000,2015,7,11,9,914,781,1695,1367
3405-000,2015,7,11,10,884,751,1635,1695
3405-000,2015,7,11,11,914,764,1678,1635
3405-000,2015,7,11,12,838,778,1616,1678
3405-000,2015,7,11,13,798,692,1490,1616
3405-000,2015,7,11,14,744,666,1410,1490
3405-000,2015,7,11,15,855,741,1596,1410
3405-000,2015,7,11,16,898,651,1549,1596
3405-000,2015,7,11,17,840,676,1516,1549
3405-000,2015,7,11,18,923,799,1722,1516
3405-000,2015,7,11,19,768,687,1455,1722
3405-000,2015,7,11,20,519,491,1010,1455
3405-000,2015,7,11,21,410,410,820,1010
3405-000,2015,7,11,22,289,283,572,820
3405-000,2015,7,11,23,211,231,442,572
3405-000,2015,7,11,24,127,147,274,442
3405-000,2015,7,12,1,71,97,168,274
3405-000,2015,7,12,2,62,55,117,168
3405-000,2015,7,12,3,42,32,74,117
3405-000,2015,7,12,4,26,38,64,74
3405-000,2015,7,12,5,47,37,84,64
3405-000,2015,7,12,6,95,71,166,84
3405-000,2015,7,12,7,136,122,258,166
3405-000,2015,7,12,8,235,220,455,258
3405-000,2015,7,12,9,328,293,621,455
3405-000,2015,7,12,10,321,282,603,621
3405-000,2015,7,12,11,408,353,761,603
3405-000,2015,7,12,12,446,402,848,761
3405-000,2015,7,12,13,385,443,828,848
3405-000,2015,7,12,14,441,410,851,828
3405-000,2015,7,12,15,459,451,910,851
3405-000,2015,7,12,16,504,513,1017,910
3405-000,2015,7,12,17,482,490,972,1017
3405-000,2015,7,12,18,452,481,933,972
3405-000,2015,7,12,19,351,504,855,933
3405-000,2015,7,12,20,347,395,742,855
3405-000,2015,7,12,21,294,334,628,742
3405-000,2015,7,12,22,217,328,545,628
3405-000,2015,7,12,23,138,206,344,545
3405-000,2015,7,12,24,107,140,247,344
3405-000,2015,7,13,1,56,84,140,247
3405-000,2015,7,13,2,26,55,81,140
3405-000,2015,7,13,3,29,36,65,81
3405-000,2015,7,13,4,41,54,95,65
3405-000,2015,7,13,5,69,76,145,95
3405-000,2015,7,13,6,226,224,450,145
3405-000,2015,7,13,7,498,592,1090,450
3405-000,2015,7,13,8,1001,1411,2412,1090
3405-000,2015,7,13,9,1098,1201,2299,2412
3405-000,2015,7,13,10,870,807,1677,2299
3405-000,2015,7,13,11,877,790,1667,1677
3405-000,2015,7,13,12,864,804,1668,1667
3405-000,2015,7,13,13,705,714,1419,1668
3405-000,2015,7,13,14,774,847,1621,1419
3405-000,2015,7,13,15,940,960,1900,1621
3405-000,2015,7,13,16,929,874,1803,1900
3405-000,2015,7,13,17,902,829,1731,1803
3405-000,2015,7,13,18,899,855,1754,1731
3405-000,2015,7,13,19,958,878,1836,1754
3405-000,2015,7,13,20,620,633,1253,1836
3405-000,2015,7,13,21,502,535,1037,1253
3405-000,2015,7,13,22,398,399,797,1037
3405-000,2015,7,13,23,261,224,485,797
3405-000,2015,7,13,24,128,127,255,485
3405-000,2015,7,14,1,72,108,180,255
3405-000,2015,7,14,2,46,76,122,180
3405-000,2015,7,14,3,49,54,103,122
3405-000,2015,7,14,4,51,66,117,103
3405-000,2015,7,14,5,103,96,199,117
3405-000,2015,7,14,6,236,244,480,199
3405-000,2015,7,14,7,507,442,949,480
3405-000,2015,7,14,8,936,1207,2143,949
3405-000,2015,7,14,9,1140,1183,2323,2143
3405-000,2015,7,14,10,997,910,1907,2323
3405-000,2015,7,14,11,1008,1009,2017,1907
3405-000,2015,7,14,12,1039,937,1976,2017
3405-000,2015,7,14,13,818,783,1601,1976
3405-000,2015,7,14,14,1073,868,1941,1601
3405-000,2015,7,14,15,1256,1045,2301,1941
3405-000,2015,7,14,16,1048,938,1986,2301
3405-000,2015,7,14,17,1074,913,1987,1986
3405-000,2015,7,14,18,1066,948,2014,1987
3405-000,2015,7,14,19,973,945,1918,2014
3405-000,2015,7,14,20,675,668,1343,1918
3405-000,2015,7,14,21,539,572,1111,1343
3405-000,2015,7,14,22,461,457,918,1111
3405-000,2015,7,14,23,300,241,541,918
3405-000,2015,7,14,24,153,174,327,541
3405-000,2015,7,15,1,79,107,186,327
3405-000,2015,7,15,2,63,73,136,186
3405-000,2015,7,15,3,42,47,89,136
3405-000,2015,7,15,4,52,59,111,89
3405-000,2015,7,15,5,94,77,171,111
3405-000,2015,7,15,6,243,223,466,171
3405-000,2015,7,15,7,484,478,962,466
3405-000,2015,7,15,8,964,1161,2125,962
3405-000,2015,7,15,9,1221,1129,2350,2125
3405-000,2015,7,15,10,1011,933,1944,2350
3405-000,2015,7,15,11,1067,988,2055,1944
3405-000,2015,7,15,12,1032,939,1971,2055
3405-000,2015,7,15,13,890,771,1661,1971
3405-000,2015,7,15,14,908,999,1907,1661
3405-000,2015,7,15,15,1075,981,2056,1907
3405-000,2015,7,15,16,1054,940,1994,2056
3405-000,2015,7,15,17,1052,956,2008,1994
3405-000,2015,7,15,18,1185,1020,2205,2008
3405-000,2015,7,15,19,1146,1059,2205,2205
3405-000,2015,7,15,20,747,683,1430,2205
3405-000,2015,7,15,21,555,502,1057,1430
3405-000,2015,7,15,22,371,394,765,1057
3405-000,2015,7,15,23,252,262,514,765
3405-000,2015,7,15,24,180,160,340,514
3405-000,2015,7,16,1,114,114,228,340
3405-000,2015,7,16,2,81,85,166,228
3405-000,2015,7,16,3,44,53,97,166
3405-000,2015,7,16,4,70,82,152,97
3405-000,2015,7,16,5,102,106,208,152
3405-000,2015,7,16,6,251,227,478,208
3405-000,2015,7,16,7,511,480,991,478
3405-000,2015,7,16,8,991,1153,2144,991
3405-000,2015,7,16,9,1168,1202,2370,2144
3405-000,2015,7,16,10,1015,917,1932,2370
3405-000,2015,7,16,11,1020,952,1972,1932
3405-000,2015,7,16,12,1035,878,1913,1972
3405-000,2015,7,16,13,834,822,1656,1913
3405-000,2015,7,16,14,852,945,1797,1656
3405-000,2015,7,16,15,1012,974,1986,1797
3405-000,2015,7,16,16,1044,948,1992,1986
3405-000,2015,7,16,17,1036,880,1916,1992
3405-000,2015,7,16,18,1020,902,1922,1916
3405-000,2015,7,16,19,1047,931,1978,1922
3405-000,2015,7,16,20,682,684,1366,1978
3405-000,2015,7,16,21,579,570,1149,1366
3405-000,2015,7,16,22,399,419,818,1149
3405-000,2015,7,16,23,264,286,550,818
3405-000,2015,7,16,24,171,207,378,550
3405-000,2015,7,17,1,99,92,191,378
3405-000,2015,7,17,2,78,95,173,191
3405-000,2015,7,17,3,58,59,117,173
3405-000,2015,7,17,4,60,74,134,117
3405-000,2015,7,17,5,107,96,203,134
3405-000,2015,7,17,6,256,203,459,203
3405-000,2015,7,17,7,540,403,943,459
3405-000,2015,7,17,8,956,1125,2081,943
3405-000,2015,7,17,9,1222,1226,2448,2081
3405-000,2015,7,17,10,991,943,1934,2448
3405-000,2015,7,17,11,1032,884,1916,1934
3405-000,2015,7,17,12,1012,841,1853,1916
3405-000,2015,7,17,13,822,859,1681,1853
3405-000,2015,7,17,14,882,945,1827,1681
3405-000,2015,7,17,15,1047,945,1992,1827
3405-000,2015,7,17,16,1098,975,2073,1992
3405-000,2015,7,17,17,1073,914,1987,2073
3405-000,2015,7,17,18,1216,1012,2228,1987
3405-000,2015,7,17,19,1361,1045,2406,2228
3405-000,2015,7,17,20,865,731,1596,2406
3405-000,2015,7,17,21,601,592,1193,1596
3405-000,2015,7,17,22,414,418,832,1193
3405-000,2015,7,17,23,263,265,528,832
3405-000,2015,7,17,24,212,196,408,528
3405-000,2015,7,18,1,103,105,208,408
3405-000,2015,7,18,2,70,65,135,208
3405-000,2015,7,18,3,60,66,126,135
3405-000,2015,7,18,4,53,71,124,126
3405-000,2015,7,18,5,101,98,199,124
3405-000,2015,7,18,6,217,181,398,199
3405-000,2015,7,18,7,421,333,754,398
3405-000,2015,7,18,8,644,555,1199,754
3405-000,2015,7,18,9,860,698,1558,1199
3405-000,2015,7,18,10,805,759,1564,1558
3405-000,2015,7,18,11,871,700,1571,1564
3405-000,2015,7,18,12,787,705,1492,1571
3405-000,2015,7,18,13,841,683,1524,1492
3405-000,2015,7,18,14,813,722,1535,1524
3405-000,2015,7,18,15,773,714,1487,1535
3405-000,2015,7,18,16,739,680,1419,1487
3405-000,2015,7,18,17,805,641,1446,1419
3405-000,2015,7,18,18,850,795,1645,1446
3405-000,2015,7,18,19,701,756,1457,1645
3405-000,2015,7,18,20,449,502,951,1457
3405-000,2015,7,18,21,405,367,772,951
3405-000,2015,7,18,22,288,260,548,772
3405-000,2015,7,18,23,199,201,400,548
3405-000,2015,7,18,24,106,152,258,400
3405-000,2015,7,19,1,89,83,172,258
3405-000,2015,7,19,2,56,45,101,172
3405-000,2015,7,19,3,41,39,80,101
3405-000,2015,7,19,4,29,34,63,80
3405-000,2015,7,19,5,45,34,79,63
3405-000,2015,7,19,6,111,72,183,79
3405-000,2015,7,19,7,196,174,370,183
3405-000,2015,7,19,8,286,242,528,370
3405-000,2015,7,19,9,373,337,710,528
3405-000,2015,7,19,10,369,349,718,710
3405-000,2015,7,19,11,486,384,870,718
3405-000,2015,7,19,12,490,446,936,870
3405-000,2015,7,19,13,454,479,933,936
3405-000,2015,7,19,14,473,542,1015,933
3405-000,2015,7,19,15,531,506,1037,1015
3405-000,2015,7,19,16,521,569,1090,1037
3405-000,2015,7,19,17,533,617,1150,1090
3405-000,2015,7,19,18,563,594,1157,1150
3405-000,2015,7,19,19,420,529,949,1157
3405-000,2015,7,19,20,408,474,882,949
3405-000,2015,7,19,21,380,459,839,882
3405-000,2015,7,19,22,282,347,629,839
3405-000,2015,7,19,23,192,306,498,629
3405-000,2015,7,19,24,126,177,303,498
3405-000,2015,7,20,1,79,92,171,303
3405-000,2015,7,20,2,32,65,97,171
3405-000,2015,7,20,3,23,52,75,97
3405-000,2015,7,20,4,34,51,85,75
3405-000,2015,7,20,5,96,93,189,85
3405-000,2015,7,20,6,252,284,536,189
3405-000,2015,7,20,7,567,650,1217,536
3405-000,2015,7,20,8,986,1389,2375,1217
3405-000,2015,7,20,9,1187,1294,2481,2375
3405-000,2015,7,20,10,981,922,1903,2481
3405-000,2015,7,20,11,1029,936,1965,1903
3405-000,2015,7,20,12,1010,867,1877,1965
3405-000,2015,7,20,13,793,810,1603,1877
3405-000,2015,7,20,14,823,949,1772,1603
3405-000,2015,7,20,15,1053,996,2049,1772
3405-000,2015,7,20,16,929,979,1908,2049
3405-000,2015,7,20,17,960,850,1810,1908
3405-000,2015,7,20,18,1036,897,1933,1810
3405-000,2015,7,20,19,977,965,1942,1933
3405-000,2015,7,20,20,696,660,1356,1942
3405-000,2015,7,20,21,568,578,1146,1356
3405-000,2015,7,20,22,435,425,860,1146
3405-000,2015,7,20,23,275,241,516,860
3405-000,2015,7,20,24,161,173,334,516
3405-000,2015,7,21,1,82,94,176,334
3405-000,2015,7,21,2,64,67,131,176
3405-000,2015,7,21,3,41,64,105,131
3405-000,2015,7,21,4,57,70,127,105
3405-000,2015,7,21,5,105,93,198,127
3405-000,2015,7,21,6,195,175,370,198
3405-000,2015,7,21,7,421,420,841,370
3405-000,2015,7,21,8,935,1114,2049,841
3405-000,2015,7,21,9,1139,1270,2409,2049
3405-000,2015,7,21,10,1049,906,1955,2409
3405-000,2015,7,21,11,971,906,1877,1955
3405-000,2015,7,21,12,950,978,1928,1877
3405-000,2015,7,21,13,809,783,1592,1928
3405-000,2015,7,21,14,903,930,1833,1592
3405-000,2015,7,21,15,1021,921,1942,1833
3405-000,2015,7,21,16,1053,921,1974,1942
3405-000,2015,7,21,17,960,863,1823,1974
3405-000,2015,7,21,18,1051,885,1936,1823
3405-000,2015,7,21,19,1001,895,1896,1936
3405-000,2015,7,21,20,637,668,1305,1896
3405-000,2015,7,21,21,563,538,1101,1305
3405-000,2015,7,21,22,382,455,837,1101
3405-000,2015,7,21,23,288,253,541,837
3405-000,2015,7,21,24,132,148,280,541
3405-000,2015,7,22,1,73,88,161,280
3405-000,2015,7,22,2,61,70,131,161
3405-000,2015,7,22,3,46,53,99,131
3405-000,2015,7,22,4,50,67,117,99
3405-000,2015,7,22,5,99,87,186,117
3405-000,2015,7,22,6,206,203,409,186
3405-000,2015,7,22,7,492,433,925,409
3405-000,2015,7,22,8,982,1193,2175,925
3405-000,2015,7,22,9,1216,1210,2426,2175
3405-000,2015,7,22,10,1040,891,1931,2426
3405-000,2015,7,22,11,1056,953,2009,1931
3405-000,2015,7,22,12,984,925,1909,2009
3405-000,2015,7,22,13,795,808,1603,1909
3405-000,2015,7,22,14,864,871,1735,1603
3405-000,2015,7,22,15,1024,946,1970,1735
3405-000,2015,7,22,16,1003,935,1938,1970
3405-000,2015,7,22,17,960,914,1874,1938
3405-000,2015,7,22,18,1262,989,2251,1874
3405-000,2015,7,22,19,1128,992,2120,2251
3405-000,2015,7,22,20,679,674,1353,2120
3405-000,2015,7,22,21,539,465,1004,1353
3405-000,2015,7,22,22,366,390,756,1004
3405-000,2015,7,22,23,289,260,549,756
3405-000,2015,7,22,24,155,183,338,549
3405-000,2015,7,23,1,97,112,209,338
3405-000,2015,7,23,2,63,71,134,209
3405-000,2015,7,23,3,46,63,109,134
3405-000,2015,7,23,4,42,62,104,109
3405-000,2015,7,23,5,78,98,176,104
3405-000,2015,7,23,6,203,222,425,176
3405-000,2015,7,23,7,449,460,909,425
3405-000,2015,7,23,8,981,1102,2083,909
3405-000,2015,7,23,9,1190,1181,2371,2083
3405-000,2015,7,23,10,1046,920,1966,2371
3405-000,2015,7,23,11,995,917,1912,1966
3405-000,2015,7,23,12,1001,847,1848,1912
3405-000,2015,7,23,13,750,789,1539,1848
3405-000,2015,7,23,14,882,917,1799,1539
3405-000,2015,7,23,15,955,938,1893,1799
3405-000,2015,7,23,16,986,930,1916,1893
3405-000,2015,7,23,17,998,824,1822,1916
3405-000,2015,7,23,18,1045,905,1950,1822
3405-000,2015,7,23,19,996,969,1965,1950
3405-000,2015,7,23,20,613,623,1236,1965
3405-000,2015,7,23,21,445,516,961,1236
3405-000,2015,7,23,22,363,399,762,961
3405-000,2015,7,23,23,270,239,509,762
3405-000,2015,7,23,24,123,150,273,509
3405-000,2015,7,24,1,85,101,186,273
3405-000,2015,7,24,2,57,67,124,186
3405-000,2015,7,24,3,34,42,76,124
3405-000,2015,7,24,4,53,67,120,76
3405-000,2015,7,24,5,95,88,183,120
3405-000,2015,7,24,6,198,161,359,183
3405-000,2015,7,24,7,383,367,750,359
3405-000,2015,7,24,8,822,956,1778,750
3405-000,2015,7,24,9,1109,1080,2189,1778
3405-000,2015,7,24,10,870,799,1669,2189
3405-000,2015,7,24,11,909,821,1730,1669
3405-000,2015,7,24,12,931,837,1768,1730
3405-000,2015,7,24,13,783,715,1498,1768
3405-000,2015,7,24,14,909,871,1780,1498
3405-000,2015,7,24,15,1039,867,1906,1780
3405-000,2015,7,24,16,1011,970,1981,1906
3405-000,2015,7,24,17,1030,816,1846,1981
3405-000,2015,7,24,18,1207,927,2134,1846
3405-000,2015,7,24,19,1166,981,2147,2134
3405-000,2015,7,24,20,789,697,1486,2147
3405-000,2015,7,24,21,561,515,1076,1486
3405-000,2015,7,24,22,433,376,809,1076
3405-000,2015,7,24,23,260,243,503,809
3405-000,2015,7,24,24,147,184,331,503
3405-000,2015,7,25,1,107,131,238,331
3405-000,2015,7,25,2,71,80,151,238
3405-000,2015,7,25,3,50,57,107,151
3405-000,2015,7,25,4,66,71,137,107
3405-000,2015,7,25,5,103,87,190,137
3405-000,2015,7,25,6,183,148,331,190
3405-000,2015,7,25,7,367,307,674,331
3405-000,2015,7,25,8,651,557,1208,674
3405-000,2015,7,25,9,836,662,1498,1208
3405-000,2015,7,25,10,814,646,1460,1498
3405-000,2015,7,25,11,832,658,1490,1460
3405-000,2015,7,25,12,826,760,1586,1490
3405-000,2015,7,25,13,718,679,1397,1586
3405-000,2015,7,25,14,743,658,1401,1397
3405-000,2015,7,25,15,769,672,1441,1401
3405-000,2015,7,25,16,723,673,1396,1441
3405-000,2015,7,25,17,725,699,1424,1396
3405-000,2015,7,25,18,805,739,1544,1424
3405-000,2015,7,25,19,624,600,1224,1544
3405-000,2015,7,25,20,456,432,888,1224
3405-000,2015,7,25,21,365,358,723,888
3405-000,2015,7,25,22,243,274,517,723
3405-000,2015,7,25,23,196,190,386,517
3405-000,2015,7,25,24,113,126,239,386
3405-000,2015,7,26,1,98,80,178,239
3405-000,2015,7,26,2,41,59,100,178
3405-000,2015,7,26,3,47,33,80,100
3405-000,2015,7,26,4,28,41,69,80
3405-000,2015,7,26,5,47,29,76,69
3405-000,2015,7,26,6,114,96,210,76
3405-000,2015,7,26,7,192,167,359,210
3405-000,2015,7,26,8,318,221,539,359
3405-000,2015,7,26,9,372,328,700,539
3405-000,2015,7,26,10,455,358,813,700
3405-000,2015,7,26,11,521,387,908,813
3405-000,2015,7,26,12,522,432,954,908
3405-000,2015,7,26,13,469,472,941,954
3405-000,2015,7,26,14,460,470,930,941
3405-000,2015,7,26,15,560,561,1121,930
3405-000,2015,7,26,16,582,581,1163,1121
3405-000,2015,7,26,17,557,545,1102,1163
3405-000,2015,7,26,18,555,618,1173,1102
3405-000,2015,7,26,19,506,593,1099,1173
3405-000,2015,7,26,20,399,544,943,1099
3405-000,2015,7,26,21,380,452,832,943
3405-000,2015,7,26,22,286,403,689,832
3405-000,2015,7,26,23,223,325,548,689
3405-000,2015,7,26,24,119,221,340,548
3405-000,2015,7,27,1,67,98,165,340
3405-000,2015,7,27,2,53,61,114,165
3405-000,2015,7,27,3,46,43,89,114
3405-000,2015,7,27,4,33,61,94,89
3405-000,2015,7,27,5,72,88,160,94
3405-000,2015,7,27,6,229,259,488,160
3405-000,2015,7,27,7,550,571,1121,488
3405-000,2015,7,27,8,967,1390,2357,1121
3405-000,2015,7,27,9,1118,1182,2300,2357
3405-000,2015,7,27,10,971,875,1846,2300
3405-000,2015,7,27,11,1021,968,1989,1846
3405-000,2015,7,27,12,996,1000,1996,1989
3405-000,2015,7,27,13,795,894,1689,1996
3405-000,2015,7,27,14,900,902,1802,1689
3405-000,2015,7,27,15,1043,1040,2083,1802
3405-000,2015,7,27,16,1021,947,1968,2083
3405-000,2015,7,27,17,1049,894,1943,1968
3405-000,2015,7,27,18,1060,940,2000,1943
3405-000,2015,7,27,19,1009,928,1937,2000
3405-000,2015,7,27,20,695,659,1354,1937
3405-000,2015,7,27,21,611,570,1181,1354
3405-000,2015,7,27,22,412,431,843,1181
3405-000,2015,7,27,23,270,243,513,843
3405-000,2015,7,27,24,137,171,308,513
3405-000,2015,7,28,1,73,119,192,308
3405-000,2015,7,28,2,73,68,141,192
3405-000,2015,7,28,3,59,49,108,141
3405-000,2015,7,28,4,42,77,119,108
3405-000,2015,7,28,5,105,108,213,119
3405-000,2015,7,28,6,230,208,438,213
3405-000,2015,7,28,7,486,462,948,438
3405-000,2015,7,28,8,936,1176,2112,948
3405-000,2015,7,28,9,1173,1155,2328,2112
3405-000,2015,7,28,10,1065,926,1991,2328
3405-000,2015,7,28,11,1152,957,2109,1991
3405-000,2015,7,28,12,968,1008,1976,2109
3405-000,2015,7,28,13,842,886,1728,1976
3405-000,2015,7,28,14,922,900,1822,1728
3405-000,2015,7,28,15,1066,1052,2118,1822
3405-000,2015,7,28,16,953,1079,2032,2118
3405-000,2015,7,28,17,1021,972,1993,2032
3405-000,2015,7,28,18,1150,1040,2190,1993
3405-000,2015,7,28,19,1174,1041,2215,2190
3405-000,2015,7,28,20,717,705,1422,2215
3405-000,2015,7,28,21,591,588,1179,1422
3405-000,2015,7,28,22,453,445,898,1179
3405-000,2015,7,28,23,275,247,522,898
3405-000,2015,7,28,24,169,196,365,522
3405-000,2015,7,29,1,89,109,198,365
3405-000,2015,7,29,2,55,63,118,198
3405-000,2015,7,29,3,54,57,111,118
3405-000,2015,7,29,4,58,85,143,111
3405-000,2015,7,29,5,92,92,184,143
3405-000,2015,7,29,6,198,194,392,184
3405-000,2015,7,29,7,451,391,842,392
3405-000,2015,7,29,8,875,906,1781,842
3405-000,2015,7,29,9,1153,1114,2267,1781
3405-000,2015,7,29,10,913,844,1757,2267
3405-000,2015,7,29,11,936,781,1717,1757
3405-000,2015,7,29,12,893,810,1703,1717
3405-000,2015,7,29,13,797,812,1609,1703
3405-000,2015,7,29,14,875,876,1751,1609
3405-000,2015,7,29,15,978,858,1836,1751
3405-000,2015,7,29,16,939,934,1873,1836
3405-000,2015,7,29,17,989,870,1859,1873
3405-000,2015,7,29,18,1022,955,1977,1859
3405-000,2015,7,29,19,1071,874,1945,1977
3405-000,2015,7,29,20,652,611,1263,1945
3405-000,2015,7,29,21,491,509,1000,1263
3405-000,2015,7,29,22,400,411,811,1000
3405-000,2015,7,29,23,266,221,487,811
3405-000,2015,7,29,24,151,142,293,487
3405-000,2015,7,30,1,119,100,219,293
3405-000,2015,7,30,2,64,73,137,219
3405-000,2015,7,30,3,56,60,116,137
3405-000,2015,7,30,4,61,57,118,116
3405-000,2015,7,30,5,107,99,206,118
3405-000,2015,7,30,6,228,206,434,206
3405-000,2015,7,30,7,496,450,946,434
3405-000,2015,7,30,8,979,1090,2069,946
3405-000,2015,7,30,9,1125,1068,2193,2069
3405-000,2015,7,30,10,998,873,1871,2193
3405-000,2015,7,30,11,1042,907,1949,1871
3405-000,2015,7,30,12,959,1020,1979,1949
3405-000,2015,7,30,13,837,824,1661,1979
3405-000,2015,7,30,14,915,871,1786,1661
3405-000,2015,7,30,15,953,979,1932,1786
3405-000,2015,7,30,16,987,922,1909,1932
3405-000,2015,7,30,17,1011,883,1894,1909
3405-000,2015,7,30,18,1061,946,2007,1894
3405-000,2015,7,30,19,1276,946,2222,2007
3405-000,2015,7,30,20,755,734,1489,2222
3405-000,2015,7,30,21,573,626,1199,1489
3405-000,2015,7,30,22,442,438,880,1199
3405-000,2015,7,30,23,314,269,583,880
3405-000,2015,7,30,24,192,175,367,583
3405-000,2015,7,31,1,116,109,225,367
3405-000,2015,7,31,2,67,75,142,225
3405-000,2015,7,31,3,58,58,116,142
3405-000,2015,7,31,4,75,63,138,116
3405-000,2015,7,31,5,113,85,198,138
3405-000,2015,7,31,6,261,209,470,198
3405-000,2015,7,31,7,533,391,924,470
3405-000,2015,7,31,8,906,1054,1960,924
3405-000,2015,7,31,9,1102,1047,2149,1960
3405-000,2015,7,31,10,971,834,1805,2149
3405-000,2015,7,31,11,1005,884,1889,1805
3405-000,2015,7,31,12,915,860,1775,1889
3405-000,2015,7,31,13,794,781,1575,1775
3405-000,2015,7,31,14,879,865,1744,1575
3405-000,2015,7,31,15,958,960,1918,1744
3405-000,2015,7,31,16,1046,900,1946,1918
3405-000,2015,7,31,17,980,855,1835,1946
3405-000,2015,7,31,18,1323,1168,2491,1835
3405-000,2015,7,31,19,1594,1160,2754,2491
3405-000,2015,7,31,20,1055,817,1872,2754
3405-000,2015,7,31,21,692,556,1248,1872
3405-000,2015,7,31,22,467,414,881,1248
3405-000,2015,7,31,23,292,334,626,881
3405-000,2015,7,31,24,191,229,420,626
3405-000,2015,8,1,1,142,118,260,420
3405-000,2015,8,1,2,75,92,167,260
3405-000,2015,8,1,3,83,54,137,167
3405-000,2015,8,1,4,71,63,134,137
3405-000,2015,8,1,5,113,77,190,134
3405-000,2015,8,1,6,287,179,466,190
3405-000,2015,8,1,7,505,316,821,466
3405-000,2015,8,1,8,694,609,1303,821
3405-000,2015,8,1,9,913,709,1622,1303
3405-000,2015,8,1,10,982,661,1643,1622
3405-000,2015,8,1,11,1142,781,1923,1643
3405-000,2015,8,1,12,1188,853,2041,1923
3405-000,2015,8,1,13,1170,784,1954,2041
3405-000,2015,8,1,14,1012,787,1799,1954
3405-000,2015,8,1,15,889,766,1655,1799
3405-000,2015,8,1,16,785,712,1497,1655
3405-000,2015,8,1,17,690,636,1326,1497
3405-000,2015,8,1,18,681,735,1416,1326
3405-000,2015,8,1,19,665,657,1322,1416
3405-000,2015,8,1,20,441,492,933,1322
3405-000,2015,8,1,21,344,391,735,933
3405-000,2015,8,1,22,281,321,602,735
3405-000,2015,8,1,23,202,200,402,602
3405-000,2015,8,1,24,136,177,313,402
3405-000,2015,8,2,1,88,96,184,313
3405-000,2015,8,2,2,56,59,115,184
3405-000,2015,8,2,3,42,50,92,115
3405-000,2015,8,2,4,54,38,92,92
3405-000,2015,8,2,5,68,46,114,92
3405-000,2015,8,2,6,133,90,223,114
3405-000,2015,8,2,7,226,163,389,223
3405-000,2015,8,2,8,310,259,569,389
3405-000,2015,8,2,9,425,283,708,569
3405-000,2015,8,2,10,482,297,779,708
3405-000,2015,8,2,11,537,409,946,779
3405-000,2015,8,2,12,511,435,946,946
3405-000,2015,8,2,13,449,468,917,946
3405-000,2015,8,2,14,444,473,917,917
3405-000,2015,8,2,15,539,594,1133,917
3405-000,2015,8,2,16,549,662,1211,1133
3405-000,2015,8,2,17,587,559,1146,1211
3405-000,2015,8,2,18,550,578,1128,1146
3405-000,2015,8,2,19,490,578,1068,1128
3405-000,2015,8,2,20,369,440,809,1068
3405-000,2015,8,2,21,368,433,801,809
3405-000,2015,8,2,22,277,347,624,801
3405-000,2015,8,2,23,173,244,417,624
3405-000,2015,8,2,24,144,168,312,417
3405-000,2015,8,3,1,63,124,187,312
3405-000,2015,8,3,2,33,74,107,187
3405-000,2015,8,3,3,38,52,90,107
3405-000,2015,8,3,4,51,58,109,90
3405-000,2015,8,3,5,77,80,157,109
3405-000,2015,8,3,6,219,202,421,157
3405-000,2015,8,3,7,470,469,939,421
3405-000,2015,8,3,8,772,938,1710,939
3405-000,2015,8,3,9,906,952,1858,1710
3405-000,2015,8,3,10,815,715,1530,1858
3405-000,2015,8,3,11,868,690,1558,1530
3405-000,2015,8,3,12,824,771,1595,1558
3405-000,2015,8,3,13,674,691,1365,1595
3405-000,2015,8,3,14,741,824,1565,1365
3405-000,2015,8,3,15,804,800,1604,1565
3405-000,2015,8,3,16,810,758,1568,1604
3405-000,2015,8,3,17,797,675,1472,1568
3405-000,2015,8,3,18,823,790,1613,1472
3405-000,2015,8,3,19,805,830,1635,1613
3405-000,2015,8,3,20,520,604,1124,1635
3405-000,2015,8,3,21,424,490,914,1124
3405-000,2015,8,3,22,333,407,740,914
3405-000,2015,8,3,23,193,246,439,740
3405-000,2015,8,3,24,127,179,306,439
3405-000,2015,8,4,1,73,122,195,306
3405-000,2015,8,4,2,48,70,118,195
3405-000,2015,8,4,3,36,45,81,118
3405-000,2015,8,4,4,49,56,105,81
3405-000,2015,8,4,5,82,74,156,105
3405-000,2015,8,4,6,215,161,376,156
3405-000,2015,8,4,7,413,358,771,376
3405-000,2015,8,4,8,714,750,1464,771
3405-000,2015,8,4,9,967,872,1839,1464
3405-000,2015,8,4,10,822,747,1569,1839
3405-000,2015,8,4,11,879,776,1655,1569
3405-000,2015,8,4,12,863,722,1585,1655
3405-000,2015,8,4,13,693,671,1364,1585
3405-000,2015,8,4,14,767,798,1565,1364
3405-000,2015,8,4,15,858,782,1640,1565
3405-000,2015,8,4,16,851,786,1637,1640
3405-000,2015,8,4,17,788,740,1528,1637
3405-000,2015,8,4,18,874,835,1709,1528
3405-000,2015,8,4,19,862,922,1784,1709
3405-000,2015,8,4,20,606,634,1240,1784
3405-000,2015,8,4,21,446,512,958,1240
3405-000,2015,8,4,22,328,367,695,958
3405-000,2015,8,4,23,191,275,466,695
3405-000,2015,8,4,24,135,197,332,466
3405-000,2015,8,5,1,81,113,194,332
3405-000,2015,8,5,2,51,71,122,194
3405-000,2015,8,5,3,39,43,82,122
3405-000,2015,8,5,4,54,48,102,82
3405-000,2015,8,5,5,80,68,148,102
3405-000,2015,8,5,6,222,172,394,148
3405-000,2015,8,5,7,418,361,779,394
3405-000,2015,8,5,8,789,779,1568,779
3405-000,2015,8,5,9,970,893,1863,1568
3405-000,2015,8,5,10,832,741,1573,1863
3405-000,2015,8,5,11,836,740,1576,1573
3405-000,2015,8,5,12,795,730,1525,1576
3405-000,2015,8,5,13,762,711,1473,1525
3405-000,2015,8,5,14,742,813,1555,1473
3405-000,2015,8,5,15,831,880,1711,1555
3405-000,2015,8,5,16,822,785,1607,1711
3405-000,2015,8,5,17,826,809,1635,1607
3405-000,2015,8,5,18,923,849,1772,1635
3405-000,2015,8,5,19,870,947,1817,1772
3405-000,2015,8,5,20,524,608,1132,1817
3405-000,2015,8,5,21,420,477,897,1132
3405-000,2015,8,5,22,324,349,673,897
3405-000,2015,8,5,23,259,222,481,673
3405-000,2015,8,5,24,127,150,277,481
3405-000,2015,8,6,1,70,98,168,277
3405-000,2015,8,6,2,49,78,127,168
3405-000,2015,8,6,3,35,56,91,127
3405-000,2015,8,6,4,61,58,119,91
3405-000,2015,8,6,5,85,71,156,119
3405-000,2015,8,6,6,216,164,380,156
3405-000,2015,8,6,7,448,414,862,380
3405-000,2015,8,6,8,859,891,1750,862
3405-000,2015,8,6,9,1054,983,2037,1750
3405-000,2015,8,6,10,918,769,1687,2037
3405-000,2015,8,6,11,928,862,1790,1687
3405-000,2015,8,6,12,939,801,1740,1790
3405-000,2015,8,6,13,719,768,1487,1740
3405-000,2015,8,6,14,759,818,1577,1487
3405-000,2015,8,6,15,893,901,1794,1577
3405-000,2015,8,6,16,898,867,1765,1794
3405-000,2015,8,6,17,820,806,1626,1765
3405-000,2015,8,6,18,982,924,1906,1626
3405-000,2015,8,6,19,944,826,1770,1906
3405-000,2015,8,6,20,580,592,1172,1770
3405-000,2015,8,6,21,465,506,971,1172
3405-000,2015,8,6,22,342,414,756,971
3405-000,2015,8,6,23,243,251,494,756
3405-000,2015,8,6,24,123,162,285,494
3405-000,2015,8,7,1,79,88,167,285
3405-000,2015,8,7,2,48,73,121,167
3405-000,2015,8,7,3,39,50,89,121
3405-000,2015,8,7,4,44,57,101,89
3405-000,2015,8,7,5,101,90,191,101
3405-000,2015,8,7,6,222,168,390,191
3405-000,2015,8,7,7,438,386,824,390
3405-000,2015,8,7,8,833,823,1656,824
3405-000,2015,8,7,9,1060,949,2009,1656
3405-000,2015,8,7,10,973,813,1786,2009
3405-000,2015,8,7,11,942,892,1834,1786
3405-000,2015,8,7,12,968,864,1832,1834
3405-000,2015,8,7,13,762,793,1555,1832
3405-000,2015,8,7,14,869,844,1713,1555
3405-000,2015,8,7,15,917,862,1779,1713
3405-000,2015,8,7,16,900,897,1797,1779
3405-000,2015,8,7,17,1050,897,1947,1797
3405-000,2015,8,7,18,1042,944,1986,1947
3405-000,2015,8,7,19,1154,928,2082,1986
3405-000,2015,8,7,20,762,738,1500,2082
3405-000,2015,8,7,21,570,569,1139,1500
3405-000,2015,8,7,22,390,386,776,1139
3405-000,2015,8,7,23,261,269,530,776
3405-000,2015,8,7,24,188,189,377,530
3405-000,2015,8,8,1,116,103,219,377
3405-000,2015,8,8,2,67,71,138,219
3405-000,2015,8,8,3,62,69,131,138
3405-000,2015,8,8,4,61,61,122,131
3405-000,2015,8,8,5,106,86,192,122
3405-000,2015,8,8,6,208,166,374,192
3405-000,2015,8,8,7,383,314,697,374
3405-000,2015,8,8,8,621,539,1160,697
3405-000,2015,8,8,9,846,617,1463,1160
3405-000,2015,8,8,10,863,719,1582,1463
3405-000,2015,8,8,11,803,632,1435,1582
3405-000,2015,8,8,12,734,668,1402,1435
3405-000,2015,8,8,13,595,702,1297,1402
3405-000,2015,8,8,14,638,715,1353,1297
3405-000,2015,8,8,15,688,695,1383,1353
3405-000,2015,8,8,16,680,657,1337,1383
3405-000,2015,8,8,17,648,608,1256,1337
3405-000,2015,8,8,18,740,691,1431,1256
3405-000,2015,8,8,19,592,643,1235,1431
3405-000,2015,8,8,20,377,455,832,1235
3405-000,2015,8,8,21,350,393,743,832
3405-000,2015,8,8,22,252,262,514,743
3405-000,2015,8,8,23,183,210,393,514
3405-000,2015,8,8,24,107,143,250,393
3405-000,2015,8,9,1,74,81,155,250
3405-000,2015,8,9,2,56,47,103,155
3405-000,2015,8,9,3,37,29,66,103
3405-000,2015,8,9,4,32,36,68,66
3405-000,2015,8,9,5,47,39,86,68
3405-000,2015,8,9,6,139,91,230,86
3405-000,2015,8,9,7,231,161,392,230
3405-000,2015,8,9,8,332,258,590,392
3405-000,2015,8,9,9,390,322,712,590
3405-000,2015,8,9,10,508,318,826,712
3405-000,2015,8,9,11,513,415,928,826
3405-000,2015,8,9,12,499,462,961,928
3405-000,2015,8,9,13,484,439,923,961
3405-000,2015,8,9,14,488,522,1010,923
3405-000,2015,8,9,15,560,562,1122,1010
3405-000,2015,8,9,16,519,606,1125,1122
3405-000,2015,8,9,17,525,601,1126,1125
3405-000,2015,8,9,18,540,663,1203,1126
3405-000,2015,8,9,19,411,588,999,1203
3405-000,2015,8,9,20,334,480,814,999
3405-000,2015,8,9,21,345,414,759,814
3405-000,2015,8,9,22,241,347,588,759
3405-000,2015,8,9,23,177,292,469,588
3405-000,2015,8,9,24,82,174,256,469
3405-000,2015,8,10,1,76,96,172,256
3405-000,2015,8,10,2,42,57,99,172
3405-000,2015,8,10,3,32,54,86,99
3405-000,2015,8,10,4,64,69,133,86
3405-000,2015,8,10,5,84,87,171,133
3405-000,2015,8,10,6,266,247,513,171
3405-000,2015,8,10,7,609,614,1223,513
3405-000,2015,8,10,8,1062,1350,2412,1223
3405-000,2015,8,10,9,1108,1206,2314,2412
3405-000,2015,8,10,10,947,888,1835,2314
3405-000,2015,8,10,11,979,906,1885,1835
3405-000,2015,8,10,12,970,924,1894,1885
3405-000,2015,8,10,13,847,852,1699,1894
3405-000,2015,8,10,14,922,949,1871,1699
3405-000,2015,8,10,15,1054,941,1995,1871
3405-000,2015,8,10,16,1039,912,1951,1995
3405-000,2015,8,10,17,979,861,1840,1951
3405-000,2015,8,10,18,991,949,1940,1840
3405-000,2015,8,10,19,1009,916,1925,1940
3405-000,2015,8,10,20,690,696,1386,1925
3405-000,2015,8,10,21,569,538,1107,1386
3405-000,2015,8,10,22,362,409,771,1107
3405-000,2015,8,10,23,232,299,531,771
3405-000,2015,8,10,24,132,176,308,531
3405-000,2015,8,11,1,93,103,196,308
3405-000,2015,8,11,2,60,72,132,196
3405-000,2015,8,11,3,50,57,107,132
3405-000,2015,8,11,4,64,75,139,107
3405-000,2015,8,11,5,99,85,184,139
3405-000,2015,8,11,6,239,228,467,184
3405-000,2015,8,11,7,548,556,1104,467
3405-000,2015,8,11,8,1022,1206,2228,1104
3405-000,2015,8,11,9,1177,1081,2258,2228
3405-000,2015,8,11,10,1032,888,1920,2258
3405-000,2015,8,11,11,1080,950,2030,1920
3405-000,2015,8,11,12,992,991,1983,2030
3405-000,2015,8,11,13,840,820,1660,1983
3405-000,2015,8,11,14,887,994,1881,1660
3405-000,2015,8,11,15,1045,1107,2152,1881
3405-000,2015,8,11,16,1073,929,2002,2152
3405-000,2015,8,11,17,1028,901,1929,2002
3405-000,2015,8,11,18,1100,918,2018,1929
3405-000,2015,8,11,19,967,965,1932,2018
3405-000,2015,8,11,20,690,649,1339,1932
3405-000,2015,8,11,21,511,577,1088,1339
3405-000,2015,8,11,22,372,437,809,1088
3405-000,2015,8,11,23,224,262,486,809
3405-000,2015,8,11,24,133,160,293,486
3405-000,2015,8,12,1,97,84,181,293
3405-000,2015,8,12,2,58,77,135,181
3405-000,2015,8,12,3,53,60,113,135
3405-000,2015,8,12,4,46,74,120,113
3405-000,2015,8,12,5,95,93,188,120
3405-000,2015,8,12,6,230,177,407,188
3405-000,2015,8,12,7,504,460,964,407
3405-000,2015,8,12,8,1017,1147,2164,964
3405-000,2015,8,12,9,1128,1074,2202,2164
3405-000,2015,8,12,10,1001,887,1888,2202
3405-000,2015,8,12,11,1035,971,2006,1888
3405-000,2015,8,12,12,943,1010,1953,2006
3405-000,2015,8,12,13,880,879,1759,1953
3405-000,2015,8,12,14,895,981,1876,1759
3405-000,2015,8,12,15,1053,986,2039,1876
3405-000,2015,8,12,16,1068,935,2003,2039
3405-000,2015,8,12,17,1053,886,1939,2003
3405-000,2015,8,12,18,1125,1047,2172,1939
3405-000,2015,8,12,19,1099,978,2077,2172
3405-000,2015,8,12,20,707,652,1359,2077
3405-000,2015,8,12,21,509,524,1033,1359
3405-000,2015,8,12,22,391,399,790,1033
3405-000,2015,8,12,23,301,246,547,790
3405-000,2015,8,12,24,142,160,302,547
3405-000,2015,8,13,1,79,95,174,302
3405-000,2015,8,13,2,55,77,132,174
3405-000,2015,8,13,3,65,59,124,132
3405-000,2015,8,13,4,82,85,167,124
3405-000,2015,8,13,5,121,107,228,167
3405-000,2015,8,13,6,238,214,452,228
3405-000,2015,8,13,7,523,510,1033,452
3405-000,2015,8,13,8,1013,1251,2264,1033
3405-000,2015,8,13,9,1179,1166,2345,2264
3405-000,2015,8,13,10,1071,924,1995,2345
3405-000,2015,8,13,11,1051,994,2045,1995
3405-000,2015,8,13,12,1036,925,1961,2045
3405-000,2015,8,13,13,909,798,1707,1961
3405-000,2015,8,13,14,927,973,1900,1707
3405-000,2015,8,13,15,1119,1045,2164,1900
3405-000,2015,8,13,16,1075,967,2042,2164
3405-000,2015,8,13,17,1036,945,1981,2042
3405-000,2015,8,13,18,1189,1035,2224,1981
3405-000,2015,8,13,19,1234,1000,2234,2224
3405-000,2015,8,13,20,770,775,1545,2234
3405-000,2015,8,13,21,563,636,1199,1545
3405-000,2015,8,13,22,483,487,970,1199
3405-000,2015,8,13,23,291,282,573,970
3405-000,2015,8,13,24,168,165,333,573
3405-000,2015,8,14,1,131,119,250,333
3405-000,2015,8,14,2,85,82,167,250
3405-000,2015,8,14,3,56,55,111,167
3405-000,2015,8,14,4,60,74,134,111
3405-000,2015,8,14,5,127,93,220,134
3405-000,2015,8,14,6,263,186,449,220
3405-000,2015,8,14,7,525,434,959,449
3405-000,2015,8,14,8,926,757,1683,959
3405-000,2015,8,14,9,1064,923,1987,1683
3405-000,2015,8,14,10,999,802,1801,1987
3405-000,2015,8,14,11,1027,887,1914,1801
3405-000,2015,8,14,12,1088,975,2063,1914
3405-000,2015,8,14,13,843,833,1676,2063
3405-000,2015,8,14,14,906,813,1719,1676
3405-000,2015,8,14,15,908,873,1781,1719
3405-000,2015,8,14,16,892,880,1772,1781
3405-000,2015,8,14,17,944,794,1738,1772
3405-000,2015,8,14,18,1055,846,1901,1738
3405-000,2015,8,14,19,1028,808,1836,1901
3405-000,2015,8,14,20,751,622,1373,1836
3405-000,2015,8,14,21,508,492,1000,1373
3405-000,2015,8,14,22,377,400,777,1000
3405-000,2015,8,14,23,265,228,493,777
3405-000,2015,8,14,24,140,153,293,493
3405-000,2015,8,15,1,99,126,225,293
3405-000,2015,8,15,2,61,69,130,225
3405-000,2015,8,15,3,44,42,86,130
3405-000,2015,8,15,4,50,51,101,86
3405-000,2015,8,15,5,87,91,178,101
3405-000,2015,8,15,6,209,167,376,178
3405-000,2015,8,15,7,416,299,715,376
3405-000,2015,8,15,8,649,528,1177,715
3405-000,2015,8,15,9,752,530,1282,1177
3405-000,2015,8,15,10,716,566,1282,1282
3405-000,2015,8,15,11,746,637,1383,1282
3405-000,2015,8,15,12,739,668,1407,1383
3405-000,2015,8,15,13,667,620,1287,1407
3405-000,2015,8,15,14,625,606,1231,1287
3405-000,2015,8,15,15,652,663,1315,1231
3405-000,2015,8,15,16,667,666,1333,1315
3405-000,2015,8,15,17,728,620,1348,1333
3405-000,2015,8,15,18,781,701,1482,1348
3405-000,2015,8,15,19,651,674,1325,1482
3405-000,2015,8,15,20,483,512,995,1325
3405-000,2015,8,15,21,409,433,842,995
3405-000,2015,8,15,22,263,296,559,842
3405-000,2015,8,15,23,197,216,413,559
3405-000,2015,8,15,24,107,154,261,413
3405-000,2015,8,16,1,73,107,180,261
3405-000,2015,8,16,2,59,65,124,180
3405-000,2015,8,16,3,46,36,82,124
3405-000,2015,8,16,4,35,43,78,82
3405-000,2015,8,16,5,56,45,101,78
3405-000,2015,8,16,6,120,90,210,101
3405-000,2015,8,16,7,213,183,396,210
3405-000,2015,8,16,8,308,246,554,396
3405-000,2015,8,16,9,399,314,713,554
3405-000,2015,8,16,10,422,328,750,713
3405-000,2015,8,16,11,478,403,881,750
3405-000,2015,8,16,12,513,445,958,881
3405-000,2015,8,16,13,456,522,978,958
3405-000,2015,8,16,14,482,499,981,978
3405-000,2015,8,16,15,500,575,1075,981
3405-000,2015,8,16,16,564,664,1228,1075
3405-000,2015,8,16,17,607,717,1324,1228
3405-000,2015,8,16,18,529,559,1088,1324
3405-000,2015,8,16,19,528,587,1115,1088
3405-000,2015,8,16,20,381,512,893,1115
3405-000,2015,8,16,21,320,446,766,893
3405-000,2015,8,16,22,249,387,636,766
3405-000,2015,8,16,23,160,277,437,636
3405-000,2015,8,16,24,94,187,281,437
3405-000,2015,8,17,1,68,95,163,281
3405-000,2015,8,17,2,50,75,125,163
3405-000,2015,8,17,3,34,34,68,125
3405-000,2015,8,17,4,36,72,108,68
3405-000,2015,8,17,5,104,97,201,108
3405-000,2015,8,17,6,245,257,502,201
3405-000,2015,8,17,7,603,675,1278,502
3405-000,2015,8,17,8,1108,1422,2530,1278
3405-000,2015,8,17,9,1171,1161,2332,2530
3405-000,2015,8,17,10,985,849,1834,2332
3405-000,2015,8,17,11,910,947,1857,1834
3405-000,2015,8,17,12,961,942,1903,1857
3405-000,2015,8,17,13,827,767,1594,1903
3405-000,2015,8,17,14,882,903,1785,1594
3405-000,2015,8,17,15,1036,985,2021,1785
3405-000,2015,8,17,16,1013,880,1893,2021
3405-000,2015,8,17,17,962,953,1915,1893
3405-000,2015,8,17,18,1045,957,2002,1915
3405-000,2015,8,17,19,1061,962,2023,2002
3405-000,2015,8,17,20,710,685,1395,2023
3405-000,2015,8,17,21,595,572,1167,1395
3405-000,2015,8,17,22,393,414,807,1167
3405-000,2015,8,17,23,259,237,496,807
3405-000,2015,8,17,24,160,182,342,496
3405-000,2015,8,18,1,116,108,224,342
3405-000,2015,8,18,2,57,67,124,224
3405-000,2015,8,18,3,38,56,94,124
3405-000,2015,8,18,4,44,83,127,94
3405-000,2015,8,18,5,118,106,224,127
3405-000,2015,8,18,6,251,211,462,224
3405-000,2015,8,18,7,538,461,999,462
3405-000,2015,8,18,8,1044,1223,2267,999
3405-000,2015,8,18,9,1153,1188,2341,2267
3405-000,2015,8,18,10,1035,862,1897,2341
3405-000,2015,8,18,11,1070,973,2043,1897
3405-000,2015,8,18,12,1041,899,1940,2043
3405-000,2015,8,18,13,859,858,1717,1940
3405-000,2015,8,18,14,979,969,1948,1717
3405-000,2015,8,18,15,1067,1015,2082,1948
3405-000,2015,8,18,16,1073,1009,2082,2082
3405-000,2015,8,18,17,1057,862,1919,2082
3405-000,2015,8,18,18,1096,941,2037,1919
3405-000,2015,8,18,19,1015,992,2007,2037
3405-000,2015,8,18,20,687,686,1373,2007
3405-000,2015,8,18,21,579,575,1154,1373
3405-000,2015,8,18,22,383,410,793,1154
3405-000,2015,8,18,23,265,248,513,793
3405-000,2015,8,18,24,203,162,365,513
3405-000,2015,8,19,1,108,96,204,365
3405-000,2015,8,19,2,62,69,131,204
3405-000,2015,8,19,3,48,56,104,131
3405-000,2015,8,19,4,49,81,130,104
3405-000,2015,8,19,5,102,84,186,130
3405-000,2015,8,19,6,230,221,451,186
3405-000,2015,8,19,7,547,516,1063,451
3405-000,2015,8,19,8,984,1207,2191,1063
3405-000,2015,8,19,9,1217,1170,2387,2191
3405-000,2015,8,19,10,1059,914,1973,2387
3405-000,2015,8,19,11,1026,991,2017,1973
3405-000,2015,8,19,12,1019,927,1946,2017
3405-000,2015,8,19,13,863,863,1726,1946
3405-000,2015,8,19,14,951,963,1914,1726
3405-000,2015,8,19,15,1097,1045,2142,1914
3405-000,2015,8,19,16,1024,991,2015,2142
3405-000,2015,8,19,17,1105,914,2019,2015
3405-000,2015,8,19,18,1170,1047,2217,2019
3405-000,2015,8,19,19,1129,1002,2131,2217
3405-000,2015,8,19,20,697,665,1362,2131
3405-000,2015,8,19,21,505,495,1000,1362
3405-000,2015,8,19,22,375,369,744,1000
3405-000,2015,8,19,23,251,273,524,744
3405-000,2015,8,19,24,142,158,300,524
3405-000,2015,8,20,1,84,105,189,300
3405-000,2015,8,20,2,58,75,133,189
3405-000,2015,8,20,3,63,52,115,133
3405-000,2015,8,20,4,57,84,141,115
3405-000,2015,8,20,5,104,82,186,141
3405-000,2015,8,20,6,245,218,463,186
3405-000,2015,8,20,7,540,489,1029,463
3405-000,2015,8,20,8,984,1256,2240,1029
3405-000,2015,8,20,9,1169,1243,2412,2240
3405-000,2015,8,20,10,1098,981,2079,2412
3405-000,2015,8,20,11,1086,950,2036,2079
3405-000,2015,8,20,12,1037,901,1938,2036
3405-000,2015,8,20,13,889,849,1738,1938
3405-000,2015,8,20,14,938,975,1913,1738
3405-000,2015,8,20,15,1073,1072,2145,1913
3405-000,2015,8,20,16,1041,1051,2092,2145
3405-000,2015,8,20,17,1091,909,2000,2092
3405-000,2015,8,20,18,1051,976,2027,2000
3405-000,2015,8,20,19,1121,941,2062,2027
3405-000,2015,8,20,20,736,674,1410,2062
3405-000,2015,8,20,21,561,529,1090,1410
3405-000,2015,8,20,22,395,394,789,1090
3405-000,2015,8,20,23,213,227,440,789
3405-000,2015,8,20,24,137,160,297,440
3405-000,2015,8,21,1,103,101,204,297
3405-000,2015,8,21,2,70,64,134,204
3405-000,2015,8,21,3,46,57,103,134
3405-000,2015,8,21,4,48,64,112,103
3405-000,2015,8,21,5,87,91,178,112
3405-000,2015,8,21,6,211,169,380,178
3405-000,2015,8,21,7,470,408,878,380
3405-000,2015,8,21,8,927,1071,1998,878
3405-000,2015,8,21,9,1117,1175,2292,1998
3405-000,2015,8,21,10,1012,899,1911,2292
3405-000,2015,8,21,11,1035,914,1949,1911
3405-000,2015,8,21,12,990,932,1922,1949
3405-000,2015,8,21,13,861,786,1647,1922
3405-000,2015,8,21,14,945,909,1854,1647
3405-000,2015,8,21,15,998,990,1988,1854
3405-000,2015,8,21,16,1056,1002,2058,1988
3405-000,2015,8,21,17,1070,873,1943,2058
3405-000,2015,8,21,18,1166,977,2143,1943
3405-000,2015,8,21,19,1208,993,2201,2143
3405-000,2015,8,21,20,853,729,1582,2201
3405-000,2015,8,21,21,587,594,1181,1582
3405-000,2015,8,21,22,436,400,836,1181
3405-000,2015,8,21,23,323,278,601,836
3405-000,2015,8,21,24,179,184,363,601
3405-000,2015,8,22,1,122,103,225,363
3405-000,2015,8,22,2,79,63,142,225
3405-000,2015,8,22,3,58,55,113,142
3405-000,2015,8,22,4,67,89,156,113
3405-000,2015,8,22,5,114,104,218,156
3405-000,2015,8,22,6,224,164,388,218
3405-000,2015,8,22,7,444,365,809,388
3405-000,2015,8,22,8,753,641,1394,809
3405-000,2015,8,22,9,920,684,1604,1394
3405-000,2015,8,22,10,868,734,1602,1604
3405-000,2015,8,22,11,963,843,1806,1602
3405-000,2015,8,22,12,853,666,1519,1806
3405-000,2015,8,22,13,762,651,1413,1519
3405-000,2015,8,22,14,725,705,1430,1413
3405-000,2015,8,22,15,760,695,1455,1430
3405-000,2015,8,22,16,656,746,1402,1455
3405-000,2015,8,22,17,780,723,1503,1402
3405-000,2015,8,22,18,855,1017,1872,1503
3405-000,2015,8,22,19,732,636,1368,1872
3405-000,2015,8,22,20,482,460,942,1368
3405-000,2015,8,22,21,377,349,726,942
3405-000,2015,8,22,22,260,273,533,726
3405-000,2015,8,22,23,199,223,422,533
3405-000,2015,8,22,24,118,138,256,422
3405-000,2015,8,23,1,86,85,171,256
3405-000,2015,8,23,2,54,48,102,171
3405-000,2015,8,23,3,30,30,60,102
3405-000,2015,8,23,4,44,35,79,60
3405-000,2015,8,23,5,53,31,84,79
3405-000,2015,8,23,6,109,96,205,84
3405-000,2015,8,23,7,206,172,378,205
3405-000,2015,8,23,8,340,243,583,378
3405-000,2015,8,23,9,409,372,781,583
3405-000,2015,8,23,10,466,314,780,781
3405-000,2015,8,23,11,478,409,887,780
3405-000,2015,8,23,12,509,446,955,887
3405-000,2015,8,23,13,446,499,945,955
3405-000,2015,8,23,14,489,479,968,945
3405-000,2015,8,23,15,510,573,1083,968
3405-000,2015,8,23,16,584,614,1198,1083
3405-000,2015,8,23,17,568,603,1171,1198
3405-000,2015,8,23,18,594,605,1199,1171
3405-000,2015,8,23,19,550,530,1080,1199
3405-000,2015,8,23,20,409,522,931,1080
3405-000,2015,8,23,21,376,460,836,931
3405-000,2015,8,23,22,290,371,661,836
3405-000,2015,8,23,23,198,274,472,661
3405-000,2015,8,23,24,114,164,278,472
3405-000,2015,8,24,1,68,94,162,278
3405-000,2015,8,24,2,53,61,114,162
3405-000,2015,8,24,3,42,48,90,114
3405-000,2015,8,24,4,47,58,105,90
3405-000,2015,8,24,5,91,89,180,105
3405-000,2015,8,24,6,272,286,558,180
3405-000,2015,8,24,7,625,665,1290,558
3405-000,2015,8,24,8,1068,1510,2578,1290
3405-000,2015,8,24,9,1235,1268,2503,2578
3405-000,2015,8,24,10,992,933,1925,2503
3405-000,2015,8,24,11,1035,942,1977,1925
3405-000,2015,8,24,12,953,902,1855,1977
3405-000,2015,8,24,13,747,875,1622,1855
3405-000,2015,8,24,14,877,1004,1881,1622
3405-000,2015,8,24,15,1112,987,2099,1881
3405-000,2015,8,24,16,999,947,1946,2099
3405-000,2015,8,24,17,1008,836,1844,1946
3405-000,2015,8,24,18,1456,1063,2519,1844
3405-000,2015,8,24,19,1394,1129,2523,2519
3405-000,2015,8,24,20,936,676,1612,2523
3405-000,2015,8,24,21,581,546,1127,1612
3405-000,2015,8,24,22,372,408,780,1127
3405-000,2015,8,24,23,238,214,452,780
3405-000,2015,8,24,24,128,161,289,452
3405-000,2015,8,25,1,98,98,196,289
3405-000,2015,8,25,2,49,81,130,196
3405-000,2015,8,25,3,45,58,103,130
3405-000,2015,8,25,4,40,77,117,103
3405-000,2015,8,25,5,94,94,188,117
3405-000,2015,8,25,6,200,154,354,188
3405-000,2015,8,25,7,375,406,781,354
3405-000,2015,8,25,8,852,1108,1960,781
3405-000,2015,8,25,9,1033,1117,2150,1960
3405-000,2015,8,25,10,842,861,1703,2150
3405-000,2015,8,25,11,838,848,1686,1703
3405-000,2015,8,25,12,834,863,1697,1686
3405-000,2015,8,25,13,718,699,1417,1697
3405-000,2015,8,25,14,746,849,1595,1417
3405-000,2015,8,25,15,940,927,1867,1595
3405-000,2015,8,25,16,857,910,1767,1867
3405-000,2015,8,25,17,828,856,1684,1767
3405-000,2015,8,25,18,838,849,1687,1684
3405-000,2015,8,25,19,859,841,1700,1687
3405-000,2015,8,25,20,525,606,1131,1700
3405-000,2015,8,25,21,477,501,978,1131
3405-000,2015,8,25,22,355,395,750,978
3405-000,2015,8,25,23,230,185,415,750
3405-000,2015,8,25,24,122,137,259,415
3405-000,2015,8,26,1,84,87,171,259
3405-000,2015,8,26,2,54,68,122,171
3405-000,2015,8,26,3,45,58,103,122
3405-000,2015,8,26,4,64,68,132,103
3405-000,2015,8,26,5,108,85,193,132
3405-000,2015,8,26,6,237,206,443,193
3405-000,2015,8,26,7,490,507,997,443
3405-000,2015,8,26,8,1004,1253,2257,997
3405-000,2015,8,26,9,1229,1208,2437,2257
3405-000,2015,8,26,10,1011,948,1959,2437
3405-000,2015,8,26,11,1078,1034,2112,1959
3405-000,2015,8,26,12,981,940,1921,2112
3405-000,2015,8,26,13,881,908,1789,1921
3405-000,2015,8,26,14,931,972,1903,1789
3405-000,2015,8,26,15,1097,1016,2113,1903
3405-000,2015,8,26,16,971,1030,2001,2113
3405-000,2015,8,26,17,1033,897,1930,2001
3405-000,2015,8,26,18,1215,1051,2266,1930
3405-000,2015,8,26,19,1150,984,2134,2266
3405-000,2015,8,26,20,655,643,1298,2134
3405-000,2015,8,26,21,500,494,994,1298
3405-000,2015,8,26,22,388,419,807,994
3405-000,2015,8,26,23,266,199,465,807
3405-000,2015,8,26,24,131,155,286,465
3405-000,2015,8,27,1,90,116,206,286
3405-000,2015,8,27,2,68,76,144,206
3405-000,2015,8,27,3,53,62,115,144
3405-000,2015,8,27,4,50,80,130,115
3405-000,2015,8,27,5,105,98,203,130
3405-000,2015,8,27,6,260,218,478,203
3405-000,2015,8,27,7,502,521,1023,478
3405-000,2015,8,27,8,1045,1178,2223,1023
3405-000,2015,8,27,9,1236,1215,2451,2223
3405-000,2015,8,27,10,1034,949,1983,2451
3405-000,2015,8,27,11,1007,1000,2007,1983
3405-000,2015,8,27,12,1045,930,1975,2007
3405-000,2015,8,27,13,811,782,1593,1975
3405-000,2015,8,27,14,931,942,1873,1593
3405-000,2015,8,27,15,1032,1005,2037,1873
3405-000,2015,8,27,16,953,923,1876,2037
3405-000,2015,8,27,17,983,934,1917,1876
3405-000,2015,8,27,18,1154,1021,2175,1917
3405-000,2015,8,27,19,1034,961,1995,2175
3405-000,2015,8,27,20,776,697,1473,1995
3405-000,2015,8,27,21,603,579,1182,1473
3405-000,2015,8,27,22,376,441,817,1182
3405-000,2015,8,27,23,271,261,532,817
3405-000,2015,8,27,24,157,168,325,532
3405-000,2015,8,28,1,113,103,216,325
3405-000,2015,8,28,2,48,79,127,216
3405-000,2015,8,28,3,54,52,106,127
3405-000,2015,8,28,4,74,78,152,106
3405-000,2015,8,28,5,85,100,185,152
3405-000,2015,8,28,6,245,211,456,185
3405-000,2015,8,28,7,542,454,996,456
3405-000,2015,8,28,8,998,1193,2191,996
3405-000,2015,8,28,9,1211,1249,2460,2191
3405-000,2015,8,28,10,997,937,1934,2460
3405-000,2015,8,28,11,1121,947,2068,1934
3405-000,2015,8,28,12,1048,948,1996,2068
3405-000,2015,8,28,13,880,853,1733,1996
3405-000,2015,8,28,14,921,988,1909,1733
3405-000,2015,8,28,15,1068,1136,2204,1909
3405-000,2015,8,28,16,1029,986,2015,2204
3405-000,2015,8,28,17,1055,999,2054,2015
3405-000,2015,8,28,18,1353,1023,2376,2054
3405-000,2015,8,28,19,1400,1039,2439,2376
3405-000,2015,8,28,20,896,825,1721,2439
3405-000,2015,8,28,21,652,637,1289,1721
3405-000,2015,8,28,22,475,452,927,1289
3405-000,2015,8,28,23,330,249,579,927
3405-000,2015,8,28,24,170,174,344,579
3405-000,2015,8,29,1,132,126,258,344
3405-000,2015,8,29,2,75,101,176,258
3405-000,2015,8,29,3,53,51,104,176
3405-000,2015,8,29,4,64,90,154,104
3405-000,2015,8,29,5,109,97,206,154
3405-000,2015,8,29,6,204,195,399,206
3405-000,2015,8,29,7,454,368,822,399
3405-000,2015,8,29,8,754,670,1424,822
3405-000,2015,8,29,9,853,800,1653,1424
3405-000,2015,8,29,10,876,721,1597,1653
3405-000,2015,8,29,11,950,786,1736,1597
3405-000,2015,8,29,12,920,669,1589,1736
3405-000,2015,8,29,13,849,745,1594,1589
3405-000,2015,8,29,14,767,737,1504,1594
3405-000,2015,8,29,15,755,803,1558,1504
3405-000,2015,8,29,16,815,709,1524,1558
3405-000,2015,8,29,17,840,723,1563,1524
3405-000,2015,8,29,18,910,887,1797,1563
3405-000,2015,8,29,19,789,706,1495,1797
3405-000,2015,8,29,20,563,514,1077,1495
3405-000,2015,8,29,21,421,411,832,1077
3405-000,2015,8,29,22,304,348,652,832
3405-000,2015,8,29,23,204,223,427,652
3405-000,2015,8,29,24,133,177,310,427
3405-000,2015,8,30,1,98,89,187,310
3405-000,2015,8,30,2,51,53,104,187
3405-000,2015,8,30,3,33,49,82,104
3405-000,2015,8,30,4,55,40,95,82
3405-000,2015,8,30,5,60,43,103,95
3405-000,2015,8,30,6,148,80,228,103
3405-000,2015,8,30,7,244,208,452,228
3405-000,2015,8,30,8,358,282,640,452
3405-000,2015,8,30,9,434,358,792,640
3405-000,2015,8,30,10,465,357,822,792
3405-000,2015,8,30,11,567,445,1012,822
3405-000,2015,8,30,12,524,511,1035,1012
3405-000,2015,8,30,13,466,530,996,1035
3405-000,2015,8,30,14,527,542,1069,996
3405-000,2015,8,30,15,580,610,1190,1069
3405-000,2015,8,30,16,660,698,1358,1190
3405-000,2015,8,30,17,681,635,1316,1358
3405-000,2015,8,30,18,671,705,1376,1316
3405-000,2015,8,30,19,599,666,1265,1376
3405-000,2015,8,30,20,469,579,1048,1265
3405-000,2015,8,30,21,414,465,879,1048
3405-000,2015,8,30,22,292,405,697,879
3405-000,2015,8,30,23,197,303,500,697
3405-000,2015,8,30,24,103,172,275,500
3405-000,2015,8,31,1,65,119,184,275
3405-000,2015,8,31,2,29,63,92,184
3405-000,2015,8,31,3,28,45,73,92
3405-000,2015,8,31,4,54,69,123,73
3405-000,2015,8,31,5,96,84,180,123
3405-000,2015,8,31,6,273,270,543,180
3405-000,2015,8,31,7,574,690,1264,543
3405-000,2015,8,31,8,1098,1516,2614,1264
3405-000,2015,8,31,9,1170,1261,2431,2614
3405-000,2015,8,31,10,971,834,1805,2431
3405-000,2015,8,31,11,1016,929,1945,1805
3405-000,2015,8,31,12,968,940,1908,1945
3405-000,2015,8,31,13,785,829,1614,1908
3405-000,2015,8,31,14,907,945,1852,1614
3405-000,2015,8,31,15,1067,997,2064,1852
3405-000,2015,8,31,16,1060,960,2020,2064
3405-000,2015,8,31,17,1073,973,2046,2020
3405-000,2015,8,31,18,1077,988,2065,2046
3405-000,2015,8,31,19,1019,1003,2022,2065
3405-000,2015,8,31,20,698,661,1359,2022
3405-000,2015,8,31,21,564,568,1132,1359
3405-000,2015,8,31,22,382,410,792,1132
3405-000,2015,8,31,23,295,253,548,792
3405-000,2015,8,31,24,162,138,300,548
3405-000,2015,9,1,1,93,106,199,300
3405-000,2015,9,1,2,74,69,143,199
3405-000,2015,9,1,3,48,44,92,143
3405-000,2015,9,1,4,51,69,120,92
3405-000,2015,9,1,5,92,87,179,120
3405-000,2015,9,1,6,219,204,423,179
3405-000,2015,9,1,7,494,495,989,423
3405-000,2015,9,1,8,1019,1249,2268,989
3405-000,2015,9,1,9,1254,1225,2479,2268
3405-000,2015,9,1,10,1063,991,2054,2479
3405-000,2015,9,1,11,1030,977,2007,2054
3405-000,2015,9,1,12,1006,949,1955,2007
3405-000,2015,9,1,13,812,804,1616,1955
3405-000,2015,9,1,14,880,949,1829,1616
3405-000,2015,9,1,15,1054,1071,2125,1829
3405-000,2015,9,1,16,1072,1002,2074,2125
3405-000,2015,9,1,17,1019,883,1902,2074
3405-000,2015,9,1,18,1123,984,2107,1902
3405-000,2015,9,1,19,1058,907,1965,2107
3405-000,2015,9,1,20,692,673,1365,1965
3405-000,2015,9,1,21,552,574,1126,1365
3405-000,2015,9,1,22,384,401,785,1126
3405-000,2015,9,1,23,270,237,507,785
3405-000,2015,9,1,24,143,153,296,507
3405-000,2015,9,2,1,79,100,179,296
3405-000,2015,9,2,2,58,71,129,179
3405-000,2015,9,2,3,49,48,97,129
3405-000,2015,9,2,4,53,50,103,97
3405-000,2015,9,2,5,101,98,199,103
3405-000,2015,9,2,6,245,220,465,199
3405-000,2015,9,2,7,545,489,1034,465
3405-000,2015,9,2,8,1002,1254,2256,1034
3405-000,2015,9,2,9,1224,1201,2425,2256
3405-000,2015,9,2,10,1055,885,1940,2425
3405-000,2015,9,2,11,1050,963,2013,1940
3405-000,2015,9,2,12,1024,937,1961,2013
3405-000,2015,9,2,13,846,852,1698,1961
3405-000,2015,9,2,14,876,874,1750,1698
3405-000,2015,9,2,15,1063,980,2043,1750
3405-000,2015,9,2,16,1098,921,2019,2043
3405-000,2015,9,2,17,1015,889,1904,2019
3405-000,2015,9,2,18,1118,976,2094,1904
3405-000,2015,9,2,19,1101,987,2088,2094
3405-000,2015,9,2,20,671,626,1297,2088
3405-000,2015,9,2,21,475,508,983,1297
3405-000,2015,9,2,22,330,354,684,983
3405-000,2015,9,2,23,270,216,486,684
3405-000,2015,9,2,24,132,138,270,486
3405-000,2015,9,3,1,89,89,178,270
3405-000,2015,9,3,2,54,73,127,178
3405-000,2015,9,3,3,38,50,88,127
3405-000,2015,9,3,4,55,51,106,88
3405-000,2015,9,3,5,86,85,171,106
3405-000,2015,9,3,6,221,229,450,171
3405-000,2015,9,3,7,498,493,991,450
3405-000,2015,9,3,8,1022,1248,2270,991
3405-000,2015,9,3,9,1241,1231,2472,2270
3405-000,2015,9,3,10,1016,927,1943,2472
3405-000,2015,9,3,11,1068,945,2013,1943
3405-000,2015,9,3,12,1026,939,1965,2013
3405-000,2015,9,3,13,790,844,1634,1965
3405-000,2015,9,3,14,915,967,1882,1634
3405-000,2015,9,3,15,1074,999,2073,1882
3405-000,2015,9,3,16,1096,926,2022,2073
3405-000,2015,9,3,17,1062,940,2002,2022
3405-000,2015,9,3,18,1142,981,2123,2002
3405-000,2015,9,3,19,1060,983,2043,2123
3405-000,2015,9,3,20,696,682,1378,2043
3405-000,2015,9,3,21,568,548,1116,1378
3405-000,2015,9,3,22,413,396,809,1116
3405-000,2015,9,3,23,305,273,578,809
3405-000,2015,9,3,24,156,155,311,578
3405-000,2015,9,4,1,85,86,171,311
3405-000,2015,9,4,2,64,78,142,171
3405-000,2015,9,4,3,45,53,98,142
3405-000,2015,9,4,4,61,66,127,98
3405-000,2015,9,4,5,90,94,184,127
3405-000,2015,9,4,6,220,205,425,184
3405-000,2015,9,4,7,526,499,1025,425
3405-000,2015,9,4,8,1038,1176,2214,1025
3405-000,2015,9,4,9,1219,1195,2414,2214
3405-000,2015,9,4,10,1050,914,1964,2414
3405-000,2015,9,4,11,1057,950,2007,1964
3405-000,2015,9,4,12,1105,890,1995,2007
3405-000,2015,9,4,13,858,852,1710,1995
3405-000,2015,9,4,14,845,939,1784,1710
3405-000,2015,9,4,15,1096,1012,2108,1784
3405-000,2015,9,4,16,1145,1018,2163,2108
3405-000,2015,9,4,17,1187,948,2135,2163
3405-000,2015,9,4,18,1347,1122,2469,2135
3405-000,2015,9,4,19,1363,1157,2520,2469
3405-000,2015,9,4,20,977,751,1728,2520
3405-000,2015,9,4,21,676,612,1288,1728
3405-000,2015,9,4,22,463,405,868,1288
3405-000,2015,9,4,23,297,273,570,868
3405-000,2015,9,4,24,170,172,342,570
3405-000,2015,9,5,1,104,100,204,342
3405-000,2015,9,5,2,83,64,147,204
3405-000,2015,9,5,3,55,47,102,147
3405-000,2015,9,5,4,57,84,141,102
3405-000,2015,9,5,5,94,91,185,141
3405-000,2015,9,5,6,231,154,385,185
3405-000,2015,9,5,7,458,363,821,385
3405-000,2015,9,5,8,794,623,1417,821
3405-000,2015,9,5,9,897,795,1692,1417
3405-000,2015,9,5,10,894,724,1618,1692
3405-000,2015,9,5,11,853,761,1614,1618
3405-000,2015,9,5,12,910,820,1730,1614
3405-000,2015,9,5,13,773,783,1556,1730
3405-000,2015,9,5,14,772,733,1505,1556
3405-000,2015,9,5,15,800,754,1554,1505
3405-000,2015,9,5,16,807,877,1684,1554
3405-000,2015,9,5,17,791,808,1599,1684
3405-000,2015,9,5,18,864,903,1767,1599
3405-000,2015,9,5,19,717,827,1544,1767
3405-000,2015,9,5,20,593,559,1152,1544
3405-000,2015,9,5,21,364,437,801,1152
3405-000,2015,9,5,22,338,311,649,801
3405-000,2015,9,5,23,245,236,481,649
3405-000,2015,9,5,24,125,153,278,481
3405-000,2015,9,6,1,97,99,196,278
3405-000,2015,9,6,2,59,38,97,196
3405-000,2015,9,6,3,35,38,73,97
3405-000,2015,9,6,4,37,42,79,73
3405-000,2015,9,6,5,57,47,104,79
3405-000,2015,9,6,6,151,94,245,104
3405-000,2015,9,6,7,270,200,470,245
3405-000,2015,9,6,8,409,305,714,470
3405-000,2015,9,6,9,492,345,837,714
3405-000,2015,9,6,10,539,389,928,837
3405-000,2015,9,6,11,575,466,1041,928
3405-000,2015,9,6,12,485,552,1037,1041
3405-000,2015,9,6,13,483,586,1069,1037
3405-000,2015,9,6,14,537,578,1115,1069
3405-000,2015,9,6,15,598,620,1218,1115
3405-000,2015,9,6,16,624,689,1313,1218
3405-000,2015,9,6,17,684,696,1380,1313
3405-000,2015,9,6,18,736,705,1441,1380
3405-000,2015,9,6,19,572,600,1172,1441
3405-000,2015,9,6,20,498,505,1003,1172
3405-000,2015,9,6,21,397,470,867,1003
3405-000,2015,9,6,22,308,393,701,867
3405-000,2015,9,6,23,190,236,426,701
3405-000,2015,9,6,24,107,147,254,426
3405-000,2015,9,7,1,61,80,141,254
3405-000,2015,9,7,2,35,62,97,141
3405-000,2015,9,7,3,35,39,74,97
3405-000,2015,9,7,4,50,65,115,74
3405-000,2015,9,7,5,81,109,190,115
3405-000,2015,9,7,6,258,267,525,190
3405-000,2015,9,7,7,590,678,1268,525
3405-000,2015,9,7,8,1110,1490,2600,1268
3405-000,2015,9,7,9,1218,1320,2538,2600
3405-000,2015,9,7,10,994,944,1938,2538
3405-000,2015,9,7,11,1021,942,1963,1938
3405-000,2015,9,7,12,1006,904,1910,1963
3405-000,2015,9,7,13,809,821,1630,1910
3405-000,2015,9,7,14,929,1008,1937,1630
3405-000,2015,9,7,15,1053,1078,2131,1937
3405-000,2015,9,7,16,1082,994,2076,2131
3405-000,2015,9,7,17,1001,987,1988,2076
3405-000,2015,9,7,18,1139,1033,2172,1988
3405-000,2015,9,7,19,1047,947,1994,2172
3405-000,2015,9,7,20,726,701,1427,1994
3405-000,2015,9,7,21,560,559,1119,1427
3405-000,2015,9,7,22,395,424,819,1119
3405-000,2015,9,7,23,244,237,481,819
3405-000,2015,9,7,24,143,148,291,481
3405-000,2015,9,8,1,83,93,176,291
3405-000,2015,9,8,2,54,70,124,176
3405-000,2015,9,8,3,47,55,102,124
3405-000,2015,9,8,4,65,88,153,102
3405-000,2015,9,8,5,98,93,191,153
3405-000,2015,9,8,6,243,226,469,191
3405-000,2015,9,8,7,546,520,1066,469
3405-000,2015,9,8,8,1044,1246,2290,1066
3405-000,2015,9,8,9,1232,1189,2421,2290
3405-000,2015,9,8,10,1080,942,2022,2421
3405-000,2015,9,8,11,1066,1012,2078,2022
3405-000,2015,9,8,12,1039,868,1907,2078
3405-000,2015,9,8,13,822,818,1640,1907
3405-000,2015,9,8,14,934,966,1900,1640
3405-000,2015,9,8,15,1033,997,2030,1900
3405-000,2015,9,8,16,983,977,1960,2030
3405-000,2015,9,8,17,1121,933,2054,1960
3405-000,2015,9,8,18,1183,1002,2185,2054
3405-000,2015,9,8,19,1053,971,2024,2185
3405-000,2015,9,8,20,716,724,1440,2024
3405-000,2015,9,8,21,591,581,1172,1440
3405-000,2015,9,8,22,387,411,798,1172
3405-000,2015,9,8,23,259,267,526,798
3405-000,2015,9,8,24,154,166,320,526
3405-000,2015,9,9,1,88,111,199,320
3405-000,2015,9,9,2,69,75,144,199
3405-000,2015,9,9,3,49,58,107,144
3405-000,2015,9,9,4,56,51,107,107
3405-000,2015,9,9,5,90,93,183,107
3405-000,2015,9,9,6,229,218,447,183
3405-000,2015,9,9,7,554,513,1067,447
3405-000,2015,9,9,8,1058,1232,2290,1067
3405-000,2015,9,9,9,1255,1245,2500,2290
3405-000,2015,9,9,10,1075,917,1992,2500
3405-000,2015,9,9,11,1008,932,1940,1992
3405-000,2015,9,9,12,970,966,1936,1940
3405-000,2015,9,9,13,792,814,1606,1936
3405-000,2015,9,9,14,886,972,1858,1606
3405-000,2015,9,9,15,985,1039,2024,1858
3405-000,2015,9,9,16,1100,996,2096,2024
3405-000,2015,9,9,17,1037,956,1993,2096
3405-000,2015,9,9,18,1161,1010,2171,1993
3405-000,2015,9,9,19,1258,1028,2286,2171
3405-000,2015,9,9,20,719,723,1442,2286
3405-000,2015,9,9,21,562,540,1102,1442
3405-000,2015,9,9,22,372,399,771,1102
3405-000,2015,9,9,23,260,226,486,771
3405-000,2015,9,9,24,174,149,323,486
3405-000,2015,9,10,1,107,103,210,323
3405-000,2015,9,10,2,63,89,152,210
3405-000,2015,9,10,3,50,55,105,152
3405-000,2015,9,10,4,63,74,137,105
3405-000,2015,9,10,5,102,89,191,137
3405-000,2015,9,10,6,245,198,443,191
3405-000,2015,9,10,7,577,556,1133,443
3405-000,2015,9,10,8,1079,1297,2376,1133
3405-000,2015,9,10,9,1316,1262,2578,2376
3405-000,2015,9,10,10,1037,877,1914,2578
3405-000,2015,9,10,11,1067,989,2056,1914
3405-000,2015,9,10,12,1087,940,2027,2056
3405-000,2015,9,10,13,858,765,1623,2027
3405-000,2015,9,10,14,926,960,1886,1623
3405-000,2015,9,10,15,1055,1048,2103,1886
3405-000,2015,9,10,16,1096,1046,2142,2103
3405-000,2015,9,10,17,1058,931,1989,2142
3405-000,2015,9,10,18,1189,1015,2204,1989
3405-000,2015,9,10,19,1150,991,2141,2204
3405-000,2015,9,10,20,746,697,1443,2141
3405-000,2015,9,10,21,570,565,1135,1443
3405-000,2015,9,10,22,399,434,833,1135
3405-000,2015,9,10,23,242,265,507,833
3405-000,2015,9,10,24,139,169,308,507
3405-000,2015,9,11,1,122,108,230,308
3405-000,2015,9,11,2,54,78,132,230
3405-000,2015,9,11,3,37,50,87,132
3405-000,2015,9,11,4,58,74,132,87
3405-000,2015,9,11,5,102,95,197,132
3405-000,2015,9,11,6,238,223,461,197
3405-000,2015,9,11,7,562,541,1103,461
3405-000,2015,9,11,8,1013,1215,2228,1103
3405-000,2015,9,11,9,1253,1228,2481,2228
3405-000,2015,9,11,10,1066,992,2058,2481
3405-000,2015,9,11,11,1107,984,2091,2058
3405-000,2015,9,11,12,1107,896,2003,2091
3405-000,2015,9,11,13,921,860,1781,2003
3405-000,2015,9,11,14,996,997,1993,1781
3405-000,2015,9,11,15,1107,1025,2132,1993
3405-000,2015,9,11,16,1104,1065,2169,2132
3405-000,2015,9,11,17,1169,1017,2186,2169
3405-000,2015,9,11,18,1346,1070,2416,2186
3405-000,2015,9,11,19,1519,1073,2592,2416
3405-000,2015,9,11,20,1009,792,1801,2592
3405-000,2015,9,11,21,636,577,1213,1801
3405-000,2015,9,11,22,465,453,918,1213
3405-000,2015,9,11,23,304,260,564,918
3405-000,2015,9,11,24,144,169,313,564
3405-000,2015,9,12,1,102,109,211,313
3405-000,2015,9,12,2,80,67,147,211
3405-000,2015,9,12,3,52,71,123,147
3405-000,2015,9,12,4,70,66,136,123
3405-000,2015,9,12,5,109,90,199,136
3405-000,2015,9,12,6,246,172,418,199
3405-000,2015,9,12,7,468,398,866,418
3405-000,2015,9,12,8,751,720,1471,866
3405-000,2015,9,12,9,1015,949,1964,1471
3405-000,2015,9,12,10,1062,861,1923,1964
3405-000,2015,9,12,11,1075,815,1890,1923
3405-000,2015,9,12,12,1166,827,1993,1890
3405-000,2015,9,12,13,968,785,1753,1993
3405-000,2015,9,12,14,846,836,1682,1753
3405-000,2015,9,12,15,840,865,1705,1682
3405-000,2015,9,12,16,905,812,1717,1705
3405-000,2015,9,12,17,944,793,1737,1717
3405-000,2015,9,12,18,1008,847,1855,1737
3405-000,2015,9,12,19,902,792,1694,1855
3405-000,2015,9,12,20,660,628,1288,1694
3405-000,2015,9,12,21,463,459,922,1288
3405-000,2015,9,12,22,319,341,660,922
3405-000,2015,9,12,23,219,251,470,660
3405-000,2015,9,12,24,115,153,268,470
3405-000,2015,9,13,1,77,75,152,268
3405-000,2015,9,13,2,47,57,104,152
3405-000,2015,9,13,3,32,46,78,104
3405-000,2015,9,13,4,37,33,70,78
3405-000,2015,9,13,5,78,43,121,70
3405-000,2015,9,13,6,169,93,262,121
3405-000,2015,9,13,7,348,209,557,262
3405-000,2015,9,13,8,545,337,882,557
3405-000,2015,9,13,9,573,371,944,882
3405-000,2015,9,13,10,543,409,952,944
3405-000,2015,9,13,11,641,445,1086,952
3405-000,2015,9,13,12,585,491,1076,1086
3405-000,2015,9,13,13,574,608,1182,1076
3405-000,2015,9,13,14,687,562,1249,1182
3405-000,2015,9,13,15,654,634,1288,1249
3405-000,2015,9,13,16,702,782,1484,1288
3405-000,2015,9,13,17,968,710,1678,1484
3405-000,2015,9,13,18,790,779,1569,1678
3405-000,2015,9,13,19,825,685,1510,1569
3405-000,2015,9,13,20,576,618,1194,1510
3405-000,2015,9,13,21,558,528,1086,1194
3405-000,2015,9,13,22,398,541,939,1086
3405-000,2015,9,13,23,217,413,630,939
3405-000,2015,9,13,24,145,197,342,630
3405-000,2015,9,14,1,75,99,174,342
3405-000,2015,9,14,2,61,69,130,174
3405-000,2015,9,14,3,32,47,79,130
3405-000,2015,9,14,4,62,67,129,79
3405-000,2015,9,14,5,86,87,173,129
3405-000,2015,9,14,6,256,239,495,173
3405-000,2015,9,14,7,571,643,1214,495
3405-000,2015,9,14,8,1091,1500,2591,1214
3405-000,2015,9,14,9,1255,1323,2578,2591
3405-000,2015,9,14,10,1021,906,1927,2578
3405-000,2015,9,14,11,1118,966,2084,1927
3405-000,2015,9,14,12,1044,929,1973,2084
3405-000,2015,9,14,13,857,877,1734,1973
3405-000,2015,9,14,14,915,997,1912,1734
3405-000,2015,9,14,15,1060,1038,2098,1912
3405-000,2015,9,14,16,1031,958,1989,2098
3405-000,2015,9,14,17,1059,992,2051,1989
3405-000,2015,9,14,18,1161,997,2158,2051
3405-000,2015,9,14,19,1074,1008,2082,2158
3405-000,2015,9,14,20,733,677,1410,2082
3405-000,2015,9,14,21,588,587,1175,1410
3405-000,2015,9,14,22,395,443,838,1175
3405-000,2015,9,14,23,271,283,554,838
3405-000,2015,9,14,24,159,164,323,554
3405-000,2015,9,15,1,82,89,171,323
3405-000,2015,9,15,2,54,79,133,171
3405-000,2015,9,15,3,41,50,91,133
3405-000,2015,9,15,4,63,79,142,91
3405-000,2015,9,15,5,99,89,188,142
3405-000,2015,9,15,6,267,214,481,188
3405-000,2015,9,15,7,534,517,1051,481
3405-000,2015,9,15,8,1056,1257,2313,1051
3405-000,2015,9,15,9,1272,1302,2574,2313
3405-000,2015,9,15,10,1122,969,2091,2574
3405-000,2015,9,15,11,1113,957,2070,2091
3405-000,2015,9,15,12,1017,917,1934,2070
3405-000,2015,9,15,13,843,871,1714,1934
3405-000,2015,9,15,14,964,982,1946,1714
3405-000,2015,9,15,15,1082,1018,2100,1946
3405-000,2015,9,15,16,1080,999,2079,2100
3405-000,2015,9,15,17,1153,918,2071,2079
3405-000,2015,9,15,18,1207,1024,2231,2071
3405-000,2015,9,15,19,1128,1061,2189,2231
3405-000,2015,9,15,20,712,660,1372,2189
3405-000,2015,9,15,21,585,603,1188,1372
3405-000,2015,9,15,22,416,444,860,1188
3405-000,2015,9,15,23,274,268,542,860
3405-000,2015,9,15,24,165,161,326,542
3405-000,2015,9,16,1,105,93,198,326
3405-000,2015,9,16,2,58,62,120,198
3405-000,2015,9,16,3,49,59,108,120
3405-000,2015,9,16,4,65,73,138,108
3405-000,2015,9,16,5,127,90,217,138
3405-000,2015,9,16,6,223,201,424,217
3405-000,2015,9,16,7,552,538,1090,424
3405-000,2015,9,16,8,1040,1217,2257,1090
3405-000,2015,9,16,9,1284,1269,2553,2257
3405-000,2015,9,16,10,1027,989,2016,2553
3405-000,2015,9,16,11,1087,970,2057,2016
3405-000,2015,9,16,12,1055,903,1958,2057
3405-000,2015,9,16,13,803,896,1699,1958
3405-000,2015,9,16,14,1017,948,1965,1699
3405-000,2015,9,16,15,1092,1128,2220,1965
3405-000,2015,9,16,16,1154,1088,2242,2220
3405-000,2015,9,16,17,1047,942,1989,2242
3405-000,2015,9,16,18,1283,1120,2403,1989
3405-000,2015,9,16,19,1217,1063,2280,2403
3405-000,2015,9,16,20,741,675,1416,2280
3405-000,2015,9,16,21,534,534,1068,1416
3405-000,2015,9,16,22,407,396,803,1068
3405-000,2015,9,16,23,278,254,532,803
3405-000,2015,9,16,24,151,201,352,532
3405-000,2015,9,17,1,102,99,201,352
3405-000,2015,9,17,2,57,68,125,201
3405-000,2015,9,17,3,62,61,123,125
3405-000,2015,9,17,4,74,71,145,123
3405-000,2015,9,17,5,109,101,210,145
3405-000,2015,9,17,6,239,197,436,210
3405-000,2015,9,17,7,521,528,1049,436
3405-000,2015,9,17,8,1059,1286,2345,1049
3405-000,2015,9,17,9,1215,1292,2507,2345
3405-000,2015,9,17,10,1025,935,1960,2507
3405-000,2015,9,17,11,1066,1017,2083,1960
3405-000,2015,9,17,12,1027,904,1931,2083
3405-000,2015,9,17,13,865,854,1719,1931
3405-000,2015,9,17,14,1011,852,1863,1719
3405-000,2015,9,17,15,1151,1117,2268,1863
3405-000,2015,9,17,16,1100,1023,2123,2268
3405-000,2015,9,17,17,1131,982,2113,2123
3405-000,2015,9,17,18,1243,1034,2277,2113
3405-000,2015,9,17,19,1464,981,2445,2277
3405-000,2015,9,17,20,901,750,1651,2445
3405-000,2015,9,17,21,608,589,1197,1651
3405-000,2015,9,17,22,413,452,865,1197
3405-000,2015,9,17,23,270,239,509,865
3405-000,2015,9,17,24,158,172,330,509
3405-000,2015,9,18,1,93,102,195,330
3405-000,2015,9,18,2,62,76,138,195
3405-000,2015,9,18,3,56,57,113,138
3405-000,2015,9,18,4,65,80,145,113
3405-000,2015,9,18,5,107,95,202,145
3405-000,2015,9,18,6,267,218,485,202
3405-000,2015,9,18,7,569,531,1100,485
3405-000,2015,9,18,8,998,1253,2251,1100
3405-000,2015,9,18,9,1242,1277,2519,2251
3405-000,2015,9,18,10,1149,926,2075,2519
3405-000,2015,9,18,11,1120,1048,2168,2075
3405-000,2015,9,18,12,1105,962,2067,2168
3405-000,2015,9,18,13,958,877,1835,2067
3405-000,2015,9,18,14,993,956,1949,1835
3405-000,2015,9,18,15,1110,1125,2235,1949
3405-000,2015,9,18,16,1155,1098,2253,2235
3405-000,2015,9,18,17,1164,1107,2271,2253
3405-000,2015,9,18,18,1371,1093,2464,2271
3405-000,2015,9,18,19,1390,1184,2574,2464
3405-000,2015,9,18,20,1049,796,1845,2574
3405-000,2015,9,18,21,679,617,1296,1845
3405-000,2015,9,18,22,461,451,912,1296
3405-000,2015,9,18,23,320,256,576,912
3405-000,2015,9,18,24,178,177,355,576
3405-000,2015,9,19,1,117,109,226,355
3405-000,2015,9,19,2,87,75,162,226
3405-000,2015,9,19,3,79,84,163,162
3405-000,2015,9,19,4,67,77,144,163
3405-000,2015,9,19,5,109,103,212,144
3405-000,2015,9,19,6,209,168,377,212
3405-000,2015,9,19,7,425,393,818,377
3405-000,2015,9,19,8,774,695,1469,818
3405-000,2015,9,19,9,960,778,1738,1469
3405-000,2015,9,19,10,863,803,1666,1738
3405-000,2015,9,19,11,964,852,1816,1666
3405-000,2015,9,19,12,1043,796,1839,1816
3405-000,2015,9,19,13,728,757,1485,1839
3405-000,2015,9,19,14,775,734,1509,1485
3405-000,2015,9,19,15,858,760,1618,1509
3405-000,2015,9,19,16,882,758,1640,1618
3405-000,2015,9,19,17,894,681,1575,1640
3405-000,2015,9,19,18,1014,803,1817,1575
3405-000,2015,9,19,19,873,684,1557,1817
3405-000,2015,9,19,20,571,516,1087,1557
3405-000,2015,9,19,21,370,409,779,1087
3405-000,2015,9,19,22,311,301,612,779
3405-000,2015,9,19,23,233,209,442,612
3405-000,2015,9,19,24,125,157,282,442
3405-000,2015,9,20,1,90,79,169,282
3405-000,2015,9,20,2,57,67,124,169
3405-000,2015,9,20,3,51,46,97,124
3405-000,2015,9,20,4,31,42,73,97
3405-000,2015,9,20,5,64,52,116,73
3405-000,2015,9,20,6,150,97,247,116
3405-000,2015,9,20,7,266,205,471,247
3405-000,2015,9,20,8,457,359,816,471
3405-000,2015,9,20,9,535,387,922,816
3405-000,2015,9,20,10,529,389,918,922
3405-000,2015,9,20,11,590,475,1065,918
3405-000,2015,9,20,12,553,529,1082,1065
3405-000,2015,9,20,13,521,548,1069,1082
3405-000,2015,9,20,14,506,559,1065,1069
3405-000,2015,9,20,15,588,605,1193,1065
3405-000,2015,9,20,16,640,689,1329,1193
3405-000,2015,9,20,17,662,682,1344,1329
3405-000,2015,9,20,18,684,679,1363,1344
3405-000,2015,9,20,19,556,589,1145,1363
3405-000,2015,9,20,20,435,438,873,1145
3405-000,2015,9,20,21,331,424,755,873
3405-000,2015,9,20,22,308,358,666,755
3405-000,2015,9,20,23,203,261,464,666
3405-000,2015,9,20,24,99,159,258,464
3405-000,2015,9,21,1,81,86,167,258
3405-000,2015,9,21,2,48,59,107,167
3405-000,2015,9,21,3,33,46,79,107
3405-000,2015,9,21,4,63,56,119,79
3405-000,2015,9,21,5,94,101,195,119
3405-000,2015,9,21,6,272,238,510,195
3405-000,2015,9,21,7,566,612,1178,510
3405-000,2015,9,21,8,1102,1437,2539,1178
3405-000,2015,9,21,9,1175,1348,2523,2539
3405-000,2015,9,21,10,1008,910,1918,2523
3405-000,2015,9,21,11,1082,966,2048,1918
3405-000,2015,9,21,12,1005,939,1944,2048
3405-000,2015,9,21,13,849,921,1770,1944
3405-000,2015,9,21,14,950,980,1930,1770
3405-000,2015,9,21,15,1109,1065,2174,1930
3405-000,2015,9,21,16,1124,1074,2198,2174
3405-000,2015,9,21,17,1106,957,2063,2198
3405-000,2015,9,21,18,1143,1036,2179,2063
3405-000,2015,9,21,19,1150,1056,2206,2179
3405-000,2015,9,21,20,796,725,1521,2206
3405-000,2015,9,21,21,595,572,1167,1521
3405-000,2015,9,21,22,404,422,826,1167
3405-000,2015,9,21,23,293,266,559,826
3405-000,2015,9,21,24,155,185,340,559
3405-000,2015,9,22,1,107,115,222,340
3405-000,2015,9,22,2,66,88,154,222
3405-000,2015,9,22,3,59,56,115,154
3405-000,2015,9,22,4,67,73,140,115
3405-000,2015,9,22,5,114,103,217,140
3405-000,2015,9,22,6,254,214,468,217
3405-000,2015,9,22,7,504,520,1024,468
3405-000,2015,9,22,8,1067,1288,2355,1024
3405-000,2015,9,22,9,1321,1252,2573,2355
3405-000,2015,9,22,10,1112,963,2075,2573
3405-000,2015,9,22,11,1099,962,2061,2075
3405-000,2015,9,22,12,1122,930,2052,2061
3405-000,2015,9,22,13,894,894,1788,2052
3405-000,2015,9,22,14,955,1054,2009,1788
3405-000,2015,9,22,15,1175,1078,2253,2009
3405-000,2015,9,22,16,1089,1007,2096,2253
3405-000,2015,9,22,17,1203,976,2179,2096
3405-000,2015,9,22,18,1210,1054,2264,2179
3405-000,2015,9,22,19,1223,1044,2267,2264
3405-000,2015,9,22,20,760,760,1520,2267
3405-000,2015,9,22,21,622,553,1175,1520
3405-000,2015,9,22,22,425,483,908,1175
3405-000,2015,9,22,23,291,247,538,908
3405-000,2015,9,22,24,189,196,385,538
3405-000,2015,9,23,1,114,122,236,385
3405-000,2015,9,23,2,63,83,146,236
3405-000,2015,9,23,3,63,57,120,146
3405-000,2015,9,23,4,61,72,133,120
3405-000,2015,9,23,5,110,102,212,133
3405-000,2015,9,23,6,258,200,458,212
3405-000,2015,9,23,7,516,488,1004,458
3405-000,2015,9,23,8,1025,1292,2317,1004
3405-000,2015,9,23,9,1256,1280,2536,2317
3405-000,2015,9,23,10,1094,1015,2109,2536
3405-000,2015,9,23,11,1128,1046,2174,2109
3405-000,2015,9,23,12,1142,1034,2176,2174
3405-000,2015,9,23,13,927,894,1821,2176
3405-000,2015,9,23,14,1020,1041,2061,1821
3405-000,2015,9,23,15,1178,1116,2294,2061
3405-000,2015,9,23,16,1168,1103,2271,2294
3405-000,2015,9,23,17,1137,1036,2173,2271
3405-000,2015,9,23,18,1245,1190,2435,2173
3405-000,2015,9,23,19,1221,1033,2254,2435
3405-000,2015,9,23,20,748,736,1484,2254
3405-000,2015,9,23,21,577,502,1079,1484
3405-000,2015,9,23,22,418,409,827,1079
3405-000,2015,9,23,23,313,269,582,827
3405-000,2015,9,23,24,160,189,349,582
3405-000,2015,9,24,1,122,135,257,349
3405-000,2015,9,24,2,58,74,132,257
3405-000,2015,9,24,3,45,55,100,132
3405-000,2015,9,24,4,59,76,135,100
3405-000,2015,9,24,5,122,117,239,135
3405-000,2015,9,24,6,238,220,458,239
3405-000,2015,9,24,7,502,520,1022,458
3405-000,2015,9,24,8,971,1278,2249,1022
3405-000,2015,9,24,9,1236,1313,2549,2249
3405-000,2015,9,24,10,1116,1013,2129,2549
3405-000,2015,9,24,11,1178,1174,2352,2129
3405-000,2015,9,24,12,1091,1005,2096,2352
3405-000,2015,9,24,13,1031,889,1920,2096
3405-000,2015,9,24,14,1006,1016,2022,1920
3405-000,2015,9,24,15,1172,1131,2303,2022
3405-000,2015,9,24,16,1186,1135,2321,2303
3405-000,2015,9,24,17,1026,1070,2096,2321
3405-000,2015,9,24,18,1080,1176,2256,2096
3405-000,2015,9,24,19,1363,1081,2444,2256
3405-000,2015,9,24,20,825,790,1615,2444
3405-000,2015,9,24,21,677,597,1274,1615
3405-000,2015,9,24,22,491,449,940,1274
3405-000,2015,9,24,23,309,274,583,940
3405-000,2015,9,24,24,168,228,396,583
3405-000,2015,9,25,1,102,111,213,396
3405-000,2015,9,25,2,70,74,144,213
3405-000,2015,9,25,3,63,79,142,144
3405-000,2015,9,25,4,66,73,139,142
3405-000,2015,9,25,5,106,119,225,139
3405-000,2015,9,25,6,212,182,394,225
3405-000,2015,9,25,7,508,428,936,394
3405-000,2015,9,25,8,974,1140,2114,936
3405-000,2015,9,25,9,1216,1216,2432,2114
3405-000,2015,9,25,10,998,964,1962,2432
3405-000,2015,9,25,11,1047,970,2017,1962
3405-000,2015,9,25,12,1038,990,2028,2017
3405-000,2015,9,25,13,988,895,1883,2028
3405-000,2015,9,25,14,1116,864,1980,1883
3405-000,2015,9,25,15,1161,918,2079,1980
3405-000,2015,9,25,16,1364,1028,2392,2079
3405-000,2015,9,25,17,1352,1101,2453,2392
3405-000,2015,9,25,18,1378,1362,2740,2453
3405-000,2015,9,25,19,1192,1296,2488,2740
3405-000,2015,9,25,20,912,1006,1918,2488
3405-000,2015,9,25,21,732,778,1510,1918
3405-000,2015,9,25,22,578,434,1012,1510
3405-000,2015,9,25,23,382,445,827,1012
3405-000,2015,9,25,24,165,218,383,827
3405-000,2015,9,26,1,143,122,265,383
3405-000,2015,9,26,2,99,98,197,265
3405-000,2015,9,26,3,109,77,186,197
3405-000,2015,9,26,4,100,114,214,186
3405-000,2015,9,26,5,147,95,242,214
3405-000,2015,9,26,6,298,162,460,242
3405-000,2015,9,26,7,528,298,826,460
3405-000,2015,9,26,8,614,385,999,826
3405-000,2015,9,26,9,712,607,1319,999
3405-000,2015,9,26,10,738,633,1371,1319
3405-000,2015,9,26,11,760,679,1439,1371
3405-000,2015,9,26,12,948,846,1794,1439
3405-000,2015,9,26,13,775,625,1400,1794
3405-000,2015,9,26,14,553,655,1208,1400
3405-000,2015,9,26,15,527,478,1005,1208
3405-000,2015,9,26,16,445,391,836,1005
3405-000,2015,9,26,17,440,351,791,836
3405-000,2015,9,26,18,423,351,774,791
3405-000,2015,9,26,19,384,303,687,774
3405-000,2015,9,26,20,289,238,527,687
3405-000,2015,9,26,21,246,204,450,527
3405-000,2015,9,26,22,182,136,318,450
3405-000,2015,9,26,23,126,105,231,318
3405-000,2015,9,26,24,81,77,158,231
3405-000,2015,9,27,1,51,70,121,158
3405-000,2015,9,27,2,35,28,63,121
3405-000,2015,9,27,3,21,23,44,63
3405-000,2015,9,27,4,29,21,50,44
3405-000,2015,9,27,5,48,24,72,50
3405-000,2015,9,27,6,90,47,137,72
3405-000,2015,9,27,7,284,127,411,137
3405-000,2015,9,27,8,435,280,715,411
3405-000,2015,9,27,9,444,241,685,715
3405-000,2015,9,27,10,672,294,966,685
3405-000,2015,9,27,11,934,435,1369,966
3405-000,2015,9,27,12,1104,720,1824,1369
3405-000,2015,9,27,13,1073,782,1855,1824
3405-000,2015,9,27,14,951,797,1748,1855
3405-000,2015,9,27,15,1153,1125,2278,1748
3405-000,2015,9,27,16,1245,1247,2492,2278
3405-000,2015,9,27,17,1034,1213,2247,2492
3405-000,2015,9,27,18,1255,1259,2514,2247
3405-000,2015,9,27,19,1070,923,1993,2514
3405-000,2015,9,27,20,632,647,1279,1993
3405-000,2015,9,27,21,449,470,919,1279
3405-000,2015,9,27,22,356,359,715,919
3405-000,2015,9,27,23,235,262,497,715
3405-000,2015,9,27,24,120,215,335,497
3405-000,2015,9,28,1,91,103,194,335
3405-000,2015,9,28,2,41,73,114,194
3405-000,2015,9,28,3,34,27,61,114
3405-000,2015,9,28,4,32,19,51,61
3405-000,2015,9,28,5,37,38,75,51
3405-000,2015,9,28,6,83,48,131,75
3405-000,2015,9,28,7,175,106,281,131
3405-000,2015,9,28,8,224,175,399,281
3405-000,2015,9,28,9,287,212,499,399
3405-000,2015,9,28,10,389,332,721,499
3405-000,2015,9,28,11,607,494,1101,721
3405-000,2015,9,28,12,712,528,1240,1101
3405-000,2015,9,28,13,630,598,1228,1240
3405-000,2015,9,28,14,598,496,1094,1228
3405-000,2015,9,28,15,658,540,1198,1094
3405-000,2015,9,28,16,653,602,1255,1198
3405-000,2015,9,28,17,532,590,1122,1255
3405-000,2015,9,28,18,625,595,1220,1122
3405-000,2015,9,28,19,623,578,1201,1220
3405-000,2015,9,28,20,519,474,993,1201
3405-000,2015,9,28,21,439,332,771,993
3405-000,2015,9,28,22,388,295,683,771
3405-000,2015,9,28,23,243,222,465,683
3405-000,2015,9,28,24,181,154,335,465
3405-000,2015,9,29,1,154,125,279,335
3405-000,2015,9,29,2,107,73,180,279
3405-000,2015,9,29,3,51,49,100,180
3405-000,2015,9,29,4,45,35,80,100
3405-000,2015,9,29,5,55,38,93,80
3405-000,2015,9,29,6,101,62,163,93
3405-000,2015,9,29,7,212,143,355,163
3405-000,2015,9,29,8,387,266,653,355
3405-000,2015,9,29,9,461,372,833,653
3405-000,2015,9,29,10,433,371,804,833
3405-000,2015,9,29,11,587,507,1094,804
3405-000,2015,9,29,12,609,534,1143,1094
3405-000,2015,9,29,13,584,584,1168,1143
3405-000,2015,9,29,14,556,580,1136,1168
3405-000,2015,9,29,15,556,593,1149,1136
3405-000,2015,9,29,16,556,634,1190,1149
3405-000,2015,9,29,17,601,680,1281,1190
3405-000,2015,9,29,18,569,668,1237,1281
3405-000,2015,9,29,19,545,644,1189,1237
3405-000,2015,9,29,20,362,462,824,1189
3405-000,2015,9,29,21,351,395,746,824
3405-000,2015,9,29,22,253,313,566,746
3405-000,2015,9,29,23,163,219,382,566
3405-000,2015,9,29,24,123,161,284,382
3405-000,2015,9,30,1,66,98,164,284
3405-000,2015,9,30,2,53,58,111,164
3405-000,2015,9,30,3,28,56,84,111
3405-000,2015,9,30,4,45,72,117,84
3405-000,2015,9,30,5,82,81,163,117
3405-000,2015,9,30,6,199,184,383,163
3405-000,2015,9,30,7,494,535,1029,383
3405-000,2015,9,30,8,979,1254,2233,1029
3405-000,2015,9,30,9,1120,1190,2310,2233
3405-000,2015,9,30,10,851,776,1627,2310
3405-000,2015,9,30,11,858,824,1682,1627
3405-000,2015,9,30,12,858,811,1669,1682
3405-000,2015,9,30,13,715,733,1448,1669
3405-000,2015,9,30,14,758,844,1602,1448
3405-000,2015,9,30,15,876,898,1774,1602
3405-000,2015,9,30,16,885,817,1702,1774
3405-000,2015,9,30,17,875,824,1699,1702
3405-000,2015,9,30,18,939,896,1835,1699
3405-000,2015,9,30,19,988,958,1946,1835
3405-000,2015,9,30,20,582,600,1182,1946
3405-000,2015,9,30,21,442,515,957,1182
3405-000,2015,9,30,22,302,361,663,957
3405-000,2015,9,30,23,217,220,437,663
3405-000,2015,9,30,24,115,171,286,437
3405-000,2015,10,1,1,74,68,142,286
3405-000,2015,10,1,2,56,76,132,142
3405-000,2015,10,1,3,43,54,97,132
3405-000,2015,10,1,4,63,67,130,97
3405-000,2015,10,1,5,76,94,170,130
3405-000,2015,10,1,6,179,180,359,170
3405-000,2015,10,1,7,396,389,785,359
3405-000,2015,10,1,8,913,1172,2085,785
3405-000,2015,10,1,9,1179,1160,2339,2085
3405-000,2015,10,1,10,944,819,1763,2339
3405-000,2015,10,1,11,919,932,1851,1763
3405-000,2015,10,1,12,957,824,1781,1851
3405-000,2015,10,1,13,685,730,1415,1781
3405-000,2015,10,1,14,799,840,1639,1415
3405-000,2015,10,1,15,1056,872,1928,1639
3405-000,2015,10,1,16,988,860,1848,1928
3405-000,2015,10,1,17,922,833,1755,1848
3405-000,2015,10,1,18,917,862,1779,1755
3405-000,2015,10,1,19,923,891,1814,1779
3405-000,2015,10,1,20,593,557,1150,1814
3405-000,2015,10,1,21,503,495,998,1150
3405-000,2015,10,1,22,346,379,725,998
3405-000,2015,10,1,23,197,198,395,725
3405-000,2015,10,1,24,141,158,299,395
3405-000,2015,10,2,1,62,98,160,299
3405-000,2015,10,2,2,49,72,121,160
3405-000,2015,10,2,3,52,56,108,121
3405-000,2015,10,2,4,56,73,129,108
3405-000,2015,10,2,5,89,86,175,129
3405-000,2015,10,2,6,207,191,398,175
3405-000,2015,10,2,7,447,443,890,398
3405-000,2015,10,2,8,988,1244,2232,890
3405-000,2015,10,2,9,1296,1304,2600,2232
3405-000,2015,10,2,10,1057,915,1972,2600
3405-000,2015,10,2,11,1080,967,2047,1972
3405-000,2015,10,2,12,1035,950,1985,2047
3405-000,2015,10,2,13,911,780,1691,1985
3405-000,2015,10,2,14,909,910,1819,1691
3405-000,2015,10,2,15,1102,980,2082,1819
3405-000,2015,10,2,16,1107,1105,2212,2082
3405-000,2015,10,2,17,1142,918,2060,2212
3405-000,2015,10,2,18,1351,1127,2478,2060
3405-000,2015,10,2,19,1264,1070,2334,2478
3405-000,2015,10,2,20,842,765,1607,2334
3405-000,2015,10,2,21,652,603,1255,1607
3405-000,2015,10,2,22,428,417,845,1255
3405-000,2015,10,2,23,289,243,532,845
3405-000,2015,10,2,24,181,210,391,532
3405-000,2015,10,3,1,111,109,220,391
3405-000,2015,10,3,2,66,65,131,220
3405-000,2015,10,3,3,55,49,104,131
3405-000,2015,10,3,4,54,68,122,104
3405-000,2015,10,3,5,82,100,182,122
3405-000,2015,10,3,6,176,157,333,182
3405-000,2015,10,3,7,370,320,690,333
3405-000,2015,10,3,8,725,572,1297,690
3405-000,2015,10,3,9,832,675,1507,1297
3405-000,2015,10,3,10,781,666,1447,1507
3405-000,2015,10,3,11,901,784,1685,1447
3405-000,2015,10,3,12,1004,912,1916,1685
3405-000,2015,10,3,13,896,804,1700,1916
3405-000,2015,10,3,14,697,736,1433,1700
3405-000,2015,10,3,15,730,681,1411,1433
3405-000,2015,10,3,16,727,666,1393,1411
3405-000,2015,10,3,17,801,634,1435,1393
3405-000,2015,10,3,18,885,802,1687,1435
3405-000,2015,10,3,19,775,647,1422,1687
3405-000,2015,10,3,20,449,450,899,1422
3405-000,2015,10,3,21,349,365,714,899
3405-000,2015,10,3,22,262,277,539,714
3405-000,2015,10,3,23,186,216,402,539
3405-000,2015,10,3,24,120,117,237,402
3405-000,2015,10,4,1,99,114,213,237
3405-000,2015,10,4,2,49,57,106,213
3405-000,2015,10,4,3,43,29,72,106
3405-000,2015,10,4,4,32,35,67,72
3405-000,2015,10,4,5,39,52,91,67
3405-000,2015,10,4,6,112,79,191,91
3405-000,2015,10,4,7,188,201,389,191
3405-000,2015,10,4,8,329,250,579,389
3405-000,2015,10,4,9,438,324,762,579
3405-000,2015,10,4,10,443,348,791,762
3405-000,2015,10,4,11,519,438,957,791
3405-000,2015,10,4,12,511,439,950,957
3405-000,2015,10,4,13,467,480,947,950
3405-000,2015,10,4,14,477,514,991,947
3405-000,2015,10,4,15,578,549,1127,991
3405-000,2015,10,4,16,669,604,1273,1127
3405-000,2015,10,4,17,696,577,1273,1273
3405-000,2015,10,4,18,667,731,1398,1273
3405-000,2015,10,4,19,591,591,1182,1398
3405-000,2015,10,4,20,393,429,822,1182
3405-000,2015,10,4,21,319,383,702,822
3405-000,2015,10,4,22,223,321,544,702
3405-000,2015,10,4,23,156,213,369,544
3405-000,2015,10,4,24,93,136,229,369
3405-000,2015,10,5,1,59,82,141,229
3405-000,2015,10,5,2,39,76,115,141
3405-000,2015,10,5,3,34,38,72,115
3405-000,2015,10,5,4,57,81,138,72
3405-000,2015,10,5,5,77,90,167,138
3405-000,2015,10,5,6,254,229,483,167
3405-000,2015,10,5,7,553,618,1171,483
3405-000,2015,10,5,8,1078,1472,2550,1171
3405-000,2015,10,5,9,1192,1323,2515,2550
3405-000,2015,10,5,10,1065,932,1997,2515
3405-000,2015,10,5,11,1013,968,1981,1997
3405-000,2015,10,5,12,1030,906,1936,1981
3405-000,2015,10,5,13,826,803,1629,1936
3405-000,2015,10,5,14,914,949,1863,1629
3405-000,2015,10,5,15,1026,1089,2115,1863
3405-000,2015,10,5,16,1061,1023,2084,2115
3405-000,2015,10,5,17,1061,956,2017,2084
3405-000,2015,10,5,18,1189,971,2160,2017
3405-000,2015,10,5,19,1150,992,2142,2160
3405-000,2015,10,5,20,712,651,1363,2142
3405-000,2015,10,5,21,506,584,1090,1363
3405-000,2015,10,5,22,376,423,799,1090
3405-000,2015,10,5,23,242,222,464,799
3405-000,2015,10,5,24,140,165,305,464
3405-000,2015,10,6,1,101,90,191,305
3405-000,2015,10,6,2,63,55,118,191
3405-000,2015,10,6,3,39,52,91,118
3405-000,2015,10,6,4,58,81,139,91
3405-000,2015,10,6,5,93,88,181,139
3405-000,2015,10,6,6,223,208,431,181
3405-000,2015,10,6,7,480,487,967,431
3405-000,2015,10,6,8,1065,1221,2286,967
3405-000,2015,10,6,9,1285,1271,2556,2286
3405-000,2015,10,6,10,1107,970,2077,2556
3405-000,2015,10,6,11,1027,1025,2052,2077
3405-000,2015,10,6,12,1086,941,2027,2052
3405-000,2015,10,6,13,837,854,1691,2027
3405-000,2015,10,6,14,955,990,1945,1691
3405-000,2015,10,6,15,1105,999,2104,1945
3405-000,2015,10,6,16,1101,1070,2171,2104
3405-000,2015,10,6,17,1112,970,2082,2171
3405-000,2015,10,6,18,1179,1058,2237,2082
3405-000,2015,10,6,19,1141,1036,2177,2237
3405-000,2015,10,6,20,739,635,1374,2177
3405-000,2015,10,6,21,531,565,1096,1374
3405-000,2015,10,6,22,362,386,748,1096
3405-000,2015,10,6,23,264,235,499,748
3405-000,2015,10,6,24,157,165,322,499
3405-000,2015,10,7,1,70,98,168,322
3405-000,2015,10,7,2,48,81,129,168
3405-000,2015,10,7,3,54,47,101,129
3405-000,2015,10,7,4,78,63,141,101
3405-000,2015,10,7,5,87,83,170,141
3405-000,2015,10,7,6,221,177,398,170
3405-000,2015,10,7,7,494,471,965,398
3405-000,2015,10,7,8,998,1271,2269,965
3405-000,2015,10,7,9,1211,1307,2518,2269
3405-000,2015,10,7,10,1119,1048,2167,2518
3405-000,2015,10,7,11,1090,994,2084,2167
3405-000,2015,10,7,12,1027,974,2001,2084
3405-000,2015,10,7,13,916,849,1765,2001
3405-000,2015,10,7,14,936,1019,1955,1765
3405-000,2015,10,7,15,1148,1037,2185,1955
3405-000,2015,10,7,16,1049,1105,2154,2185
3405-000,2015,10,7,17,1092,936,2028,2154
3405-000,2015,10,7,18,1212,1000,2212,2028
3405-000,2015,10,7,19,1111,957,2068,2212
3405-000,2015,10,7,20,685,645,1330,2068
3405-000,2015,10,7,21,469,515,984,1330
3405-000,2015,10,7,22,390,409,799,984
3405-000,2015,10,7,23,270,254,524,799
3405-000,2015,10,7,24,135,167,302,524
3405-000,2015,10,8,1,78,100,178,302
3405-000,2015,10,8,2,49,73,122,178
3405-000,2015,10,8,3,59,68,127,122
3405-000,2015,10,8,4,63,72,135,127
3405-000,2015,10,8,5,75,98,173,135
3405-000,2015,10,8,6,212,184,396,173
3405-000,2015,10,8,7,495,478,973,396
3405-000,2015,10,8,8,1026,1289,2315,973
3405-000,2015,10,8,9,1293,1321,2614,2315
3405-000,2015,10,8,10,1177,1035,2212,2614
3405-000,2015,10,8,11,1078,1046,2124,2212
3405-000,2015,10,8,12,1106,983,2089,2124
3405-000,2015,10,8,13,934,923,1857,2089
3405-000,2015,10,8,14,941,1057,1998,1857
3405-000,2015,10,8,15,1175,1102,2277,1998
3405-000,2015,10,8,16,1176,1138,2314,2277
3405-000,2015,10,8,17,1209,1011,2220,2314
3405-000,2015,10,8,18,1370,1183,2553,2220
3405-000,2015,10,8,19,1345,1079,2424,2553
3405-000,2015,10,8,20,946,763,1709,2424
3405-000,2015,10,8,21,704,634,1338,1709
3405-000,2015,10,8,22,486,436,922,1338
3405-000,2015,10,8,23,285,287,572,922
3405-000,2015,10,8,24,177,179,356,572
3405-000,2015,10,9,1,109,118,227,356
3405-000,2015,10,9,2,71,79,150,227
3405-000,2015,10,9,3,57,61,118,150
3405-000,2015,10,9,4,65,62,127,118
3405-000,2015,10,9,5,103,88,191,127
3405-000,2015,10,9,6,232,158,390,191
3405-000,2015,10,9,7,446,367,813,390
3405-000,2015,10,9,8,811,689,1500,813
3405-000,2015,10,9,9,1003,779,1782,1500
3405-000,2015,10,9,10,1005,853,1858,1782
3405-000,2015,10,9,11,1096,923,2019,1858
3405-000,2015,10,9,12,1175,857,2032,2019
3405-000,2015,10,9,13,982,864,1846,2032
3405-000,2015,10,9,14,1005,874,1879,1846
3405-000,2015,10,9,15,933,900,1833,1879
3405-000,2015,10,9,16,856,932,1788,1833
3405-000,2015,10,9,17,861,1007,1868,1788
3405-000,2015,10,9,18,1101,1187,2288,1868
3405-000,2015,10,9,19,932,860,1792,2288
3405-000,2015,10,9,20,594,552,1146,1792
3405-000,2015,10,9,21,381,459,840,1146
3405-000,2015,10,9,22,293,309,602,840
3405-000,2015,10,9,23,231,216,447,602
3405-000,2015,10,9,24,139,137,276,447
3405-000,2015,10,10,1,84,89,173,276
3405-000,2015,10,10,2,58,66,124,173
3405-000,2015,10,10,3,52,46,98,124
3405-000,2015,10,10,4,49,60,109,98
3405-000,2015,10,10,5,71,69,140,109
3405-000,2015,10,10,6,151,153,304,140
3405-000,2015,10,10,7,331,278,609,304
3405-000,2015,10,10,8,585,467,1052,609
3405-000,2015,10,10,9,792,634,1426,1052
3405-000,2015,10,10,10,796,616,1412,1426
3405-000,2015,10,10,11,829,620,1449,1412
3405-000,2015,10,10,12,720,632,1352,1449
3405-000,2015,10,10,13,633,648,1281,1352
3405-000,2015,10,10,14,621,588,1209,1281
3405-000,2015,10,10,15,682,632,1314,1209
3405-000,2015,10,10,16,783,653,1436,1314
3405-000,2015,10,10,17,782,626,1408,1436
3405-000,2015,10,10,18,818,640,1458,1408
3405-000,2015,10,10,19,632,562,1194,1458
3405-000,2015,10,10,20,463,422,885,1194
3405-000,2015,10,10,21,308,393,701,885
3405-000,2015,10,10,22,260,289,549,701
3405-000,2015,10,10,23,187,189,376,549
3405-000,2015,10,10,24,112,155,267,376
3405-000,2015,10,11,1,72,91,163,267
3405-000,2015,10,11,2,43,42,85,163
3405-000,2015,10,11,3,46,49,95,85
3405-000,2015,10,11,4,28,36,64,95
3405-000,2015,10,11,5,38,35,73,64
3405-000,2015,10,11,6,89,65,154,73
3405-000,2015,10,11,7,186,148,334,154
3405-000,2015,10,11,8,293,242,535,334
3405-000,2015,10,11,9,352,335,687,535
3405-000,2015,10,11,10,444,377,821,687
3405-000,2015,10,11,11,568,417,985,821
3405-000,2015,10,11,12,536,481,1017,985
3405-000,2015,10,11,13,485,437,922,1017
3405-000,2015,10,11,14,520,493,1013,922
3405-000,2015,10,11,15,548,540,1088,1013
3405-000,2015,10,11,16,545,649,1194,1088
3405-000,2015,10,11,17,712,719,1431,1194
3405-000,2015,10,11,18,622,711,1333,1431
3405-000,2015,10,11,19,531,566,1097,1333
3405-000,2015,10,11,20,380,469,849,1097
3405-000,2015,10,11,21,328,392,720,849
3405-000,2015,10,11,22,199,332,531,720
3405-000,2015,10,11,23,162,248,410,531
3405-000,2015,10,11,24,85,147,232,410
3405-000,2015,10,12,1,53,87,140,232
3405-000,2015,10,12,2,40,56,96,140
3405-000,2015,10,12,3,21,40,61,96
3405-000,2015,10,12,4,35,60,95,61
3405-000,2015,10,12,5,70,88,158,95
3405-000,2015,10,12,6,240,243,483,158
3405-000,2015,10,12,7,512,580,1092,483
3405-000,2015,10,12,8,1009,1400,2409,1092
3405-000,2015,10,12,9,1196,1400,2596,2409
3405-000,2015,10,12,10,929,936,1865,2596
3405-000,2015,10,12,11,1074,899,1973,1865
3405-000,2015,10,12,12,1039,903,1942,1973
3405-000,2015,10,12,13,815,859,1674,1942
3405-000,2015,10,12,14,930,914,1844,1674
3405-000,2015,10,12,15,1072,1055,2127,1844
3405-000,2015,10,12,16,1061,996,2057,2127
3405-000,2015,10,12,17,1089,942,2031,2057
3405-000,2015,10,12,18,1162,1078,2240,2031
3405-000,2015,10,12,19,1096,948,2044,2240
3405-000,2015,10,12,20,730,657,1387,2044
3405-000,2015,10,12,21,581,600,1181,1387
3405-000,2015,10,12,22,380,388,768,1181
3405-000,2015,10,12,23,270,252,522,768
3405-000,2015,10,12,24,153,168,321,522
3405-000,2015,10,13,1,81,86,167,321
3405-000,2015,10,13,2,54,70,124,167
3405-000,2015,10,13,3,36,45,81,124
3405-000,2015,10,13,4,53,62,115,81
3405-000,2015,10,13,5,107,94,201,115
3405-000,2015,10,13,6,199,205,404,201
3405-000,2015,10,13,7,478,509,987,404
3405-000,2015,10,13,8,981,1257,2238,987
3405-000,2015,10,13,9,1291,1327,2618,2238
3405-000,2015,10,13,10,1099,975,2074,2618
3405-000,2015,10,13,11,1170,1011,2181,2074
3405-000,2015,10,13,12,1043,955,1998,2181
3405-000,2015,10,13,13,913,853,1766,1998
3405-000,2015,10,13,14,954,1034,1988,1766
3405-000,2015,10,13,15,1152,1004,2156,1988
3405-000,2015,10,13,16,1128,1038,2166,2156
3405-000,2015,10,13,17,1137,924,2061,2166
3405-000,2015,10,13,18,1211,1008,2219,2061
3405-000,2015,10,13,19,1004,970,1974,2219
3405-000,2015,10,13,20,662,682,1344,1974
3405-000,2015,10,13,21,558,558,1116,1344
3405-000,2015,10,13,22,411,390,801,1116
3405-000,2015,10,13,23,258,240,498,801
3405-000,2015,10,13,24,146,151,297,498
3405-000,2015,10,14,1,90,94,184,297
3405-000,2015,10,14,2,55,85,140,184
3405-000,2015,10,14,3,53,51,104,140
3405-000,2015,10,14,4,52,75,127,104
3405-000,2015,10,14,5,93,80,173,127
3405-000,2015,10,14,6,197,202,399,173
3405-000,2015,10,14,7,484,469,953,399
3405-000,2015,10,14,8,983,1244,2227,953
3405-000,2015,10,14,9,1266,1255,2521,2227
3405-000,2015,10,14,10,1070,984,2054,2521
3405-000,2015,10,14,11,1082,993,2075,2054
3405-000,2015,10,14,12,1048,976,2024,2075
3405-000,2015,10,14,13,884,796,1680,2024
3405-000,2015,10,14,14,913,964,1877,1680
3405-000,2015,10,14,15,1099,1057,2156,1877
3405-000,2015,10,14,16,1134,1028,2162,2156
3405-000,2015,10,14,17,1165,980,2145,2162
3405-000,2015,10,14,18,1318,1031,2349,2145
3405-000,2015,10,14,19,1339,1013,2352,2349
3405-000,2015,10,14,20,679,647,1326,2352
3405-000,2015,10,14,21,488,537,1025,1326
3405-000,2015,10,14,22,364,354,718,1025
3405-000,2015,10,14,23,285,246,531,718
3405-000,2015,10,14,24,133,170,303,531
3405-000,2015,10,15,1,104,99,203,303
3405-000,2015,10,15,2,59,64,123,203
3405-000,2015,10,15,3,39,62,101,123
3405-000,2015,10,15,4,71,69,140,101
3405-000,2015,10,15,5,85,111,196,140
3405-000,2015,10,15,6,219,194,413,196
3405-000,2015,10,15,7,470,457,927,413
3405-000,2015,10,15,8,990,1236,2226,927
3405-000,2015,10,15,9,1308,1289,2597,2226
3405-000,2015,10,15,10,1074,970,2044,2597
3405-000,2015,10,15,11,1076,1018,2094,2044
3405-000,2015,10,15,12,1106,1001,2107,2094
3405-000,2015,10,15,13,857,825,1682,2107
3405-000,2015,10,15,14,960,924,1884,1682
3405-000,2015,10,15,15,1085,981,2066,1884
3405-000,2015,10,15,16,1084,994,2078,2066
3405-000,2015,10,15,17,1110,951,2061,2078
3405-000,2015,10,15,18,1187,1022,2209,2061
3405-000,2015,10,15,19,1095,997,2092,2209
3405-000,2015,10,15,20,672,669,1341,2092
3405-000,2015,10,15,21,542,557,1099,1341
3405-000,2015,10,15,22,389,398,787,1099
3405-000,2015,10,15,23,236,245,481,787
3405-000,2015,10,15,24,155,171,326,481
3405-000,2015,10,16,1,91,113,204,326
3405-000,2015,10,16,2,58,51,109,204
3405-000,2015,10,16,3,53,58,111,109
3405-000,2015,10,16,4,51,71,122,111
3405-000,2015,10,16,5,101,101,202,122
3405-000,2015,10,16,6,244,200,444,202
3405-000,2015,10,16,7,482,458,940,444
3405-000,2015,10,16,8,983,1170,2153,940
3405-000,2015,10,16,9,1266,1221,2487,2153
3405-000,2015,10,16,10,989,1012,2001,2487
3405-000,2015,10,16,11,1138,981,2119,2001
3405-000,2015,10,16,12,1068,904,1972,2119
3405-000,2015,10,16,13,905,852,1757,1972
3405-000,2015,10,16,14,961,1002,1963,1757
3405-000,2015,10,16,15,1138,1068,2206,1963
3405-000,2015,10,16,16,1143,988,2131,2206
3405-000,2015,10,16,17,1288,995,2283,2131
3405-000,2015,10,16,18,1337,1119,2456,2283
3405-000,2015,10,16,19,1303,1075,2378,2456
3405-000,2015,10,16,20,826,740,1566,2378
3405-000,2015,10,16,21,610,625,1235,1566
3405-000,2015,10,16,22,412,381,793,1235
3405-000,2015,10,16,23,319,250,569,793
3405-000,2015,10,16,24,158,171,329,569
3405-000,2015,10,17,1,129,113,242,329
3405-000,2015,10,17,2,57,74,131,242
3405-000,2015,10,17,3,66,61,127,131
3405-000,2015,10,17,4,62,79,141,127
3405-000,2015,10,17,5,75,82,157,141
3405-000,2015,10,17,6,175,135,310,157
3405-000,2015,10,17,7,366,338,704,310
3405-000,2015,10,17,8,776,611,1387,704
3405-000,2015,10,17,9,1016,724,1740,1387
3405-000,2015,10,17,10,973,689,1662,1740
3405-000,2015,10,17,11,950,784,1734,1662
3405-000,2015,10,17,12,994,865,1859,1734
3405-000,2015,10,17,13,1005,836,1841,1859
3405-000,2015,10,17,14,762,860,1622,1841
3405-000,2015,10,17,15,822,839,1661,1622
3405-000,2015,10,17,16,900,818,1718,1661
3405-000,2015,10,17,17,1022,748,1770,1718
3405-000,2015,10,17,18,985,941,1926,1770
3405-000,2015,10,17,19,837,758,1595,1926
3405-000,2015,10,17,20,576,570,1146,1595
3405-000,2015,10,17,21,404,423,827,1146
3405-000,2015,10,17,22,273,340,613,827
3405-000,2015,10,17,23,225,238,463,613
3405-000,2015,10,17,24,129,145,274,463
3405-000,2015,10,18,1,87,95,182,274
3405-000,2015,10,18,2,43,52,95,182
3405-000,2015,10,18,3,48,43,91,95
3405-000,2015,10,18,4,38,34,72,91
3405-000,2015,10,18,5,38,39,77,72
3405-000,2015,10,18,6,97,79,176,77
3405-000,2015,10,18,7,229,168,397,176
3405-000,2015,10,18,8,374,299,673,397
3405-000,2015,10,18,9,499,391,890,673
3405-000,2015,10,18,10,533,435,968,890
3405-000,2015,10,18,11,631,455,1086,968
3405-000,2015,10,18,12,531,473,1004,1086
3405-000,2015,10,18,13,526,465,991,1004
3405-000,2015,10,18,14,526,533,1059,991
3405-000,2015,10,18,15,610,538,1148,1059
3405-000,2015,10,18,16,641,641,1282,1148
3405-000,2015,10,18,17,661,656,1317,1282
3405-000,2015,10,18,18,658,737,1395,1317
3405-000,2015,10,18,19,636,686,1322,1395
3405-000,2015,10,18,20,464,533,997,1322
3405-000,2015,10,18,21,409,424,833,997
3405-000,2015,10,18,22,265,367,632,833
3405-000,2015,10,18,23,188,319,507,632
3405-000,2015,10,18,24,112,175,287,507
3405-000,2015,10,19,1,66,101,167,287
3405-000,2015,10,19,2,38,61,99,167
3405-000,2015,10,19,3,39,37,76,99
3405-000,2015,10,19,4,46,55,101,76
3405-000,2015,10,19,5,82,109,191,101
3405-000,2015,10,19,6,215,230,445,191
3405-000,2015,10,19,7,550,556,1106,445
3405-000,2015,10,19,8,1021,1453,2474,1106
3405-000,2015,10,19,9,1220,1347,2567,2474
3405-000,2015,10,19,10,950,901,1851,2567
3405-000,2015,10,19,11,1056,923,1979,1851
3405-000,2015,10,19,12,999,939,1938,1979
3405-000,2015,10,19,13,834,866,1700,1938
3405-000,2015,10,19,14,869,898,1767,1700
3405-000,2015,10,19,15,1062,1023,2085,1767
3405-000,2015,10,19,16,1072,1018,2090,2085
3405-000,2015,10,19,17,1013,928,1941,2090
3405-000,2015,10,19,18,1103,1037,2140,1941
3405-000,2015,10,19,19,1053,978,2031,2140
3405-000,2015,10,19,20,609,623,1232,2031
3405-000,2015,10,19,21,490,519,1009,1232
3405-000,2015,10,19,22,384,409,793,1009
3405-000,2015,10,19,23,242,246,488,793
3405-000,2015,10,19,24,147,170,317,488
3405-000,2015,10,20,1,87,101,188,317
3405-000,2015,10,20,2,60,66,126,188
3405-000,2015,10,20,3,59,65,124,126
3405-000,2015,10,20,4,51,68,119,124
3405-000,2015,10,20,5,83,97,180,119
3405-000,2015,10,20,6,208,198,406,180
3405-000,2015,10,20,7,453,478,931,406
3405-000,2015,10,20,8,976,1215,2191,931
3405-000,2015,10,20,9,1158,1235,2393,2191
3405-000,2015,10,20,10,974,932,1906,2393
3405-000,2015,10,20,11,1168,960,2128,1906
3405-000,2015,10,20,12,1028,950,1978,2128
3405-000,2015,10,20,13,840,848,1688,1978
3405-000,2015,10,20,14,899,988,1887,1688
3405-000,2015,10,20,15,1094,969,2063,1887
3405-000,2015,10,20,16,1102,958,2060,2063
3405-000,2015,10,20,17,1065,973,2038,2060
3405-000,2015,10,20,18,1122,987,2109,2038
3405-000,2015,10,20,19,1088,955,2043,2109
3405-000,2015,10,20,20,626,621,1247,2043
3405-000,2015,10,20,21,514,560,1074,1247
3405-000,2015,10,20,22,352,346,698,1074
3405-000,2015,10,20,23,232,226,458,698
3405-000,2015,10,20,24,129,103,232,458
3405-000,2015,10,21,1,97,87,184,232
3405-000,2015,10,21,2,54,74,128,184
3405-000,2015,10,21,3,48,65,113,128
3405-000,2015,10,21,4,50,67,117,113
3405-000,2015,10,21,5,83,100,183,117
3405-000,2015,10,21,6,211,210,421,183
3405-000,2015,10,21,7,470,485,955,421
3405-000,2015,10,21,8,964,1231,2195,955
3405-000,2015,10,21,9,1227,1252,2479,2195
3405-000,2015,10,21,10,987,1003,1990,2479
3405-000,2015,10,21,11,1088,999,2087,1990
3405-000,2015,10,21,12,1088,979,2067,2087
3405-000,2015,10,21,13,903,784,1687,2067
3405-000,2015,10,21,14,966,951,1917,1687
3405-000,2015,10,21,15,1115,1000,2115,1917
3405-000,2015,10,21,16,1082,1002,2084,2115
3405-000,2015,10,21,17,1113,929,2042,2084
3405-000,2015,10,21,18,1178,1062,2240,2042
3405-000,2015,10,21,19,1183,924,2107,2240
3405-000,2015,10,21,20,603,637,1240,2107
3405-000,2015,10,21,21,498,478,976,1240
3405-000,2015,10,21,22,348,380,728,976
3405-000,2015,10,21,23,253,225,478,728
3405-000,2015,10,21,24,163,163,326,478
3405-000,2015,10,22,1,120,107,227,326
3405-000,2015,10,22,2,44,76,120,227
3405-000,2015,10,22,3,45,53,98,120
3405-000,2015,10,22,4,57,76,133,98
3405-000,2015,10,22,5,85,93,178,133
3405-000,2015,10,22,6,199,204,403,178
3405-000,2015,10,22,7,490,441,931,403
3405-000,2015,10,22,8,986,1261,2247,931
3405-000,2015,10,22,9,1192,1256,2448,2247
3405-000,2015,10,22,10,992,1007,1999,2448
3405-000,2015,10,22,11,1059,1041,2100,1999
3405-000,2015,10,22,12,1040,1022,2062,2100
3405-000,2015,10,22,13,858,851,1709,2062
3405-000,2015,10,22,14,922,968,1890,1709
3405-000,2015,10,22,15,1115,1020,2135,1890
3405-000,2015,10,22,16,1104,994,2098,2135
3405-000,2015,10,22,17,1064,969,2033,2098
3405-000,2015,10,22,18,1136,1029,2165,2033
3405-000,2015,10,22,19,1149,932,2081,2165
3405-000,2015,10,22,20,562,695,1257,2081
3405-000,2015,10,22,21,480,534,1014,1257
3405-000,2015,10,22,22,322,340,662,1014
3405-000,2015,10,22,23,286,225,511,662
3405-000,2015,10,22,24,207,140,347,511
3405-000,2015,10,23,1,106,107,213,347
3405-000,2015,10,23,2,46,66,112,213
3405-000,2015,10,23,3,32,52,84,112
3405-000,2015,10,23,4,55,92,147,84
3405-000,2015,10,23,5,93,99,192,147
3405-000,2015,10,23,6,209,203,412,192
3405-000,2015,10,23,7,461,461,922,412
3405-000,2015,10,23,8,951,1251,2202,922
3405-000,2015,10,23,9,1116,1199,2315,2202
3405-000,2015,10,23,10,1080,996,2076,2315
3405-000,2015,10,23,11,1115,999,2114,2076
3405-000,2015,10,23,12,1101,981,2082,2114
3405-000,2015,10,23,13,878,790,1668,2082
3405-000,2015,10,23,14,957,1003,1960,1668
3405-000,2015,10,23,15,1143,1068,2211,1960
3405-000,2015,10,23,16,1212,1004,2216,2211
3405-000,2015,10,23,17,1223,1037,2260,2216
3405-000,2015,10,23,18,1478,1117,2595,2260
3405-000,2015,10,23,19,1492,1072,2564,2595
3405-000,2015,10,23,20,861,761,1622,2564
3405-000,2015,10,23,21,607,512,1119,1622
3405-000,2015,10,23,22,412,388,800,1119
3405-000,2015,10,23,23,255,223,478,800
3405-000,2015,10,23,24,154,168,322,478
3405-000,2015,10,24,1,115,103,218,322
3405-000,2015,10,24,2,69,79,148,218
3405-000,2015,10,24,3,57,70,127,148
3405-000,2015,10,24,4,63,75,138,127
3405-000,2015,10,24,5,78,94,172,138
3405-000,2015,10,24,6,202,156,358,172
3405-000,2015,10,24,7,377,367,744,358
3405-000,2015,10,24,8,694,550,1244,744
3405-000,2015,10,24,9,871,718,1589,1244
3405-000,2015,10,24,10,853,706,1559,1589
3405-000,2015,10,24,11,950,869,1819,1559
3405-000,2015,10,24,12,1147,956,2103,1819
3405-000,2015,10,24,13,1032,859,1891,2103
3405-000,2015,10,24,14,914,864,1778,1891
3405-000,2015,10,24,15,811,750,1561,1778
3405-000,2015,10,24,16,813,808,1621,1561
3405-000,2015,10,24,17,890,773,1663,1621
3405-000,2015,10,24,18,972,814,1786,1663
3405-000,2015,10,24,19,765,687,1452,1786
3405-000,2015,10,24,20,471,487,958,1452
3405-000,2015,10,24,21,409,384,793,958
3405-000,2015,10,24,22,269,307,576,793
3405-000,2015,10,24,23,212,215,427,576
3405-000,2015,10,24,24,101,145,246,427
3405-000,2015,10,25,1,73,87,160,246
3405-000,2015,10,25,2,38,54,92,160
3405-000,2015,10,25,3,39,20,59,92
3405-000,2015,10,25,4,44,36,80,59
3405-000,2015,10,25,5,54,41,95,80
3405-000,2015,10,25,6,117,91,208,95
3405-000,2015,10,25,7,202,156,358,208
3405-000,2015,10,25,8,373,262,635,358
3405-000,2015,10,25,9,440,361,801,635
3405-000,2015,10,25,10,543,373,916,801
3405-000,2015,10,25,11,635,473,1108,916
3405-000,2015,10,25,12,545,581,1126,1108
3405-000,2015,10,25,13,512,524,1036,1126
3405-000,2015,10,25,14,510,585,1095,1036
3405-000,2015,10,25,15,605,647,1252,1095
3405-000,2015,10,25,16,671,595,1266,1252
3405-000,2015,10,25,17,658,644,1302,1266
3405-000,2015,10,25,18,694,662,1356,1302
3405-000,2015,10,25,19,613,572,1185,1356
3405-000,2015,10,25,20,502,516,1018,1185
3405-000,2015,10,25,21,351,462,813,1018
3405-000,2015,10,25,22,236,372,608,813
3405-000,2015,10,25,23,171,259,430,608
3405-000,2015,10,25,24,92,196,288,430
3405-000,2015,10,26,1,68,95,163,288
3405-000,2015,10,26,2,39,56,95,163
3405-000,2015,10,26,3,31,37,68,95
3405-000,2015,10,26,4,41,65,106,68
3405-000,2015,10,26,5,86,91,177,106
3405-000,2015,10,26,6,217,247,464,177
3405-000,2015,10,26,7,548,600,1148,464
3405-000,2015,10,26,8,1022,1375,2397,1148
3405-000,2015,10,26,9,1139,1174,2313,2397
3405-000,2015,10,26,10,1009,943,1952,2313
3405-000,2015,10,26,11,1001,913,1914,1952
3405-000,2015,10,26,12,984,907,1891,1914
3405-000,2015,10,26,13,855,823,1678,1891
3405-000,2015,10,26,14,940,931,1871,1678
3405-000,2015,10,26,15,1089,1033,2122,1871
3405-000,2015,10,26,16,1051,957,2008,2122
3405-000,2015,10,26,17,1062,935,1997,2008
3405-000,2015,10,26,18,1163,1033,2196,1997
3405-000,2015,10,26,19,1069,954,2023,2196
3405-000,2015,10,26,20,661,643,1304,2023
3405-000,2015,10,26,21,503,524,1027,1304
3405-000,2015,10,26,22,340,381,721,1027
3405-000,2015,10,26,23,209,239,448,721
3405-000,2015,10,26,24,118,140,258,448
3405-000,2015,10,27,1,69,98,167,258
3405-000,2015,10,27,2,43,56,99,167
3405-000,2015,10,27,3,45,43,88,99
3405-000,2015,10,27,4,48,61,109,88
3405-000,2015,10,27,5,65,100,165,109
3405-000,2015,10,27,6,187,177,364,165
3405-000,2015,10,27,7,398,347,745,364
3405-000,2015,10,27,8,859,1127,1986,745
3405-000,2015,10,27,9,1083,1147,2230,1986
3405-000,2015,10,27,10,916,897,1813,2230
3405-000,2015,10,27,11,932,915,1847,1813
3405-000,2015,10,27,12,825,874,1699,1847
3405-000,2015,10,27,13,838,762,1600,1699
3405-000,2015,10,27,14,933,868,1801,1600
3405-000,2015,10,27,15,1042,1046,2088,1801
3405-000,2015,10,27,16,1026,925,1951,2088
3405-000,2015,10,27,17,990,894,1884,1951
3405-000,2015,10,27,18,995,943,1938,1884
3405-000,2015,10,27,19,916,967,1883,1938
3405-000,2015,10,27,20,605,604,1209,1883
3405-000,2015,10,27,21,481,543,1024,1209
3405-000,2015,10,27,22,321,335,656,1024
3405-000,2015,10,27,23,219,214,433,656
3405-000,2015,10,27,24,116,144,260,433
3405-000,2015,10,28,1,82,106,188,260
3405-000,2015,10,28,2,57,65,122,188
3405-000,2015,10,28,3,49,49,98,122
3405-000,2015,10,28,4,66,73,139,98
3405-000,2015,10,28,5,86,97,183,139
3405-000,2015,10,28,6,222,220,442,183
3405-000,2015,10,28,7,471,481,952,442
3405-000,2015,10,28,8,1016,1259,2275,952
3405-000,2015,10,28,9,1306,1273,2579,2275
3405-000,2015,10,28,10,1068,978,2046,2579
3405-000,2015,10,28,11,1023,1029,2052,2046
3405-000,2015,10,28,12,1095,870,1965,2052
3405-000,2015,10,28,13,835,839,1674,1965
3405-000,2015,10,28,14,975,967,1942,1674
3405-000,2015,10,28,15,1145,1093,2238,1942
3405-000,2015,10,28,16,1122,925,2047,2238
3405-000,2015,10,28,17,1064,964,2028,2047
3405-000,2015,10,28,18,1170,1018,2188,2028
3405-000,2015,10,28,19,1047,990,2037,2188
3405-000,2015,10,28,20,630,617,1247,2037
3405-000,2015,10,28,21,490,519,1009,1247
3405-000,2015,10,28,22,332,346,678,1009
3405-000,2015,10,28,23,225,217,442,678
3405-000,2015,10,28,24,145,155,300,442
3405-000,2015,10,29,1,84,97,181,300
3405-000,2015,10,29,2,59,70,129,181
3405-000,2015,10,29,3,57,53,110,129
3405-000,2015,10,29,4,59,64,123,110
3405-000,2015,10,29,5,96,102,198,123
3405-000,2015,10,29,6,240,194,434,198
3405-000,2015,10,29,7,475,455,930,434
3405-000,2015,10,29,8,1045,1341,2386,930
3405-000,2015,10,29,9,1283,1213,2496,2386
3405-000,2015,10,29,10,1023,930,1953,2496
3405-000,2015,10,29,11,1039,961,2000,1953
3405-000,2015,10,29,12,1010,912,1922,2000
3405-000,2015,10,29,13,894,853,1747,1922
3405-000,2015,10,29,14,902,865,1767,1747
3405-000,2015,10,29,15,1096,1044,2140,1767
3405-000,2015,10,29,16,1049,994,2043,2140
3405-000,2015,10,29,17,1080,981,2061,2043
3405-000,2015,10,29,18,1152,994,2146,2061
3405-000,2015,10,29,19,987,977,1964,2146
3405-000,2015,10,29,20,592,617,1209,1964
3405-000,2015,10,29,21,439,504,943,1209
3405-000,2015,10,29,22,352,373,725,943
3405-000,2015,10,29,23,217,213,430,725
3405-000,2015,10,29,24,142,109,251,430
3405-000,2015,10,30,1,85,109,194,251
3405-000,2015,10,30,2,69,54,123,194
3405-000,2015,10,30,3,56,59,115,123
3405-000,2015,10,30,4,66,60,126,115
3405-000,2015,10,30,5,84,110,194,126
3405-000,2015,10,30,6,216,170,386,194
3405-000,2015,10,30,7,439,463,902,386
3405-000,2015,10,30,8,1014,1206,2220,902
3405-000,2015,10,30,9,1272,1240,2512,2220
3405-000,2015,10,30,10,1034,926,1960,2512
3405-000,2015,10,30,11,1041,994,2035,1960
3405-000,2015,10,30,12,1051,877,1928,2035
3405-000,2015,10,30,13,898,798,1696,1928
3405-000,2015,10,30,14,998,952,1950,1696
3405-000,2015,10,30,15,1133,1029,2162,1950
3405-000,2015,10,30,16,1130,996,2126,2162
3405-000,2015,10,30,17,1202,1007,2209,2126
3405-000,2015,10,30,18,1255,1083,2338,2209
3405-000,2015,10,30,19,1433,1048,2481,2338
3405-000,2015,10,30,20,860,698,1558,2481
3405-000,2015,10,30,21,575,546,1121,1558
3405-000,2015,10,30,22,414,390,804,1121
3405-000,2015,10,30,23,294,225,519,804
3405-000,2015,10,30,24,146,142,288,519
3405-000,2015,10,31,1,95,100,195,288
3405-000,2015,10,31,2,55,63,118,195
3405-000,2015,10,31,3,72,64,136,118
3405-000,2015,10,31,4,64,62,126,136
3405-000,2015,10,31,5,88,85,173,126
3405-000,2015,10,31,6,203,157,360,173
3405-000,2015,10,31,7,395,332,727,360
3405-000,2015,10,31,8,707,607,1314,727
3405-000,2015,10,31,9,947,736,1683,1314
3405-000,2015,10,31,10,941,730,1671,1683
3405-000,2015,10,31,11,1024,846,1870,1671
3405-000,2015,10,31,12,992,918,1910,1870
3405-000,2015,10,31,13,981,827,1808,1910
3405-000,2015,10,31,14,799,767,1566,1808
3405-000,2015,10,31,15,799,845,1644,1566
3405-000,2015,10,31,16,865,825,1690,1644
3405-000,2015,10,31,17,893,779,1672,1690
3405-000,2015,10,31,18,992,855,1847,1672
3405-000,2015,10,31,19,793,687,1480,1847
3405-000,2015,10,31,20,533,477,1010,1480
3405-000,2015,10,31,21,363,367,730,1010
3405-000,2015,10,31,22,263,270,533,730
3405-000,2015,10,31,23,185,186,371,533
3405-000,2015,10,31,24,110,105,215,371
3405-000,2015,11,1,1,71,73,144,215
3405-000,2015,11,1,2,40,65,105,144
3405-000,2015,11,1,3,38,45,83,105
3405-000,2015,11,1,4,33,42,75,83
3405-000,2015,11,1,5,40,50,90,75
3405-000,2015,11,1,6,95,60,155,90
3405-000,2015,11,1,7,191,152,343,155
3405-000,2015,11,1,8,335,257,592,343
3405-000,2015,11,1,9,419,398,817,592
3405-000,2015,11,1,10,458,392,850,817
3405-000,2015,11,1,11,563,469,1032,850
3405-000,2015,11,1,12,475,485,960,1032
3405-000,2015,11,1,13,481,506,987,960
3405-000,2015,11,1,14,514,549,1063,987
3405-000,2015,11,1,15,591,604,1195,1063
3405-000,2015,11,1,16,661,670,1331,1195
3405-000,2015,11,1,17,621,664,1285,1331
3405-000,2015,11,1,18,631,727,1358,1285
3405-000,2015,11,1,19,505,560,1065,1358
3405-000,2015,11,1,20,474,505,979,1065
3405-000,2015,11,1,21,336,386,722,979
3405-000,2015,11,1,22,265,341,606,722
3405-000,2015,11,1,23,174,255,429,606
3405-000,2015,11,1,24,80,156,236,429
3405-000,2015,11,2,1,56,94,150,236
3405-000,2015,11,2,2,40,62,102,150
3405-000,2015,11,2,3,43,47,90,102
3405-000,2015,11,2,4,47,63,110,90
3405-000,2015,11,2,5,67,107,174,110
3405-000,2015,11,2,6,222,227,449,174
3405-000,2015,11,2,7,524,589,1113,449
3405-000,2015,11,2,8,1022,1579,2601,1113
3405-000,2015,11,2,9,1231,1329,2560,2601
3405-000,2015,11,2,10,926,965,1891,2560
3405-000,2015,11,2,11,1066,1029,2095,1891
3405-000,2015,11,2,12,1134,967,2101,2095
3405-000,2015,11,2,13,884,867,1751,2101
3405-000,2015,11,2,14,952,1005,1957,1751
3405-000,2015,11,2,15,1129,1011,2140,1957
3405-000,2015,11,2,16,1062,1010,2072,2140
3405-000,2015,11,2,17,1053,991,2044,2072
3405-000,2015,11,2,18,1209,1013,2222,2044
3405-000,2015,11,2,19,1024,989,2013,2222
3405-000,2015,11,2,20,643,573,1216,2013
3405-000,2015,11,2,21,476,525,1001,1216
3405-000,2015,11,2,22,331,422,753,1001
3405-000,2015,11,2,23,248,243,491,753
3405-000,2015,11,2,24,137,146,283,491
3405-000,2015,11,3,1,79,117,196,283
3405-000,2015,11,3,2,49,56,105,196
3405-000,2015,11,3,3,53,45,98,105
3405-000,2015,11,3,4,57,79,136,98
3405-000,2015,11,3,5,70,94,164,136
3405-000,2015,11,3,6,193,184,377,164
3405-000,2015,11,3,7,439,419,858,377
3405-000,2015,11,3,8,956,1260,2216,858
3405-000,2015,11,3,9,1251,1150,2401,2216
3405-000,2015,11,3,10,1019,990,2009,2401
3405-000,2015,11,3,11,1125,1013,2138,2009
3405-000,2015,11,3,12,1059,932,1991,2138
3405-000,2015,11,3,13,882,806,1688,1991
3405-000,2015,11,3,14,919,966,1885,1688
3405-000,2015,11,3,15,1150,1039,2189,1885
3405-000,2015,11,3,16,1077,948,2025,2189
3405-000,2015,11,3,17,1113,932,2045,2025
3405-000,2015,11,3,18,1156,1003,2159,2045
3405-000,2015,11,3,19,987,934,1921,2159
3405-000,2015,11,3,20,645,608,1253,1921
3405-000,2015,11,3,21,475,582,1057,1253
3405-000,2015,11,3,22,310,422,732,1057
3405-000,2015,11,3,23,204,203,407,732
3405-000,2015,11,3,24,120,168,288,407
3405-000,2015,11,4,1,80,106,186,288
3405-000,2015,11,4,2,55,55,110,186
3405-000,2015,11,4,3,46,41,87,110
3405-000,2015,11,4,4,57,69,126,87
3405-000,2015,11,4,5,81,103,184,126
3405-000,2015,11,4,6,200,184,384,184
3405-000,2015,11,4,7,440,459,899,384
3405-000,2015,11,4,8,988,1258,2246,899
3405-000,2015,11,4,9,1286,1249,2535,2246
3405-000,2015,11,4,10,1006,937,1943,2535
3405-000,2015,11,4,11,1071,977,2048,1943
3405-000,2015,11,4,12,1030,905,1935,2048
3405-000,2015,11,4,13,909,804,1713,1935
3405-000,2015,11,4,14,935,953,1888,1713
3405-000,2015,11,4,15,1080,1063,2143,1888
3405-000,2015,11,4,16,1136,1008,2144,2143
3405-000,2015,11,4,17,1106,913,2019,2144
3405-000,2015,11,4,18,1230,1076,2306,2019
3405-000,2015,11,4,19,1164,1023,2187,2306
3405-000,2015,11,4,20,730,617,1347,2187
3405-000,2015,11,4,21,468,543,1011,1347
3405-000,2015,11,4,22,315,359,674,1011
3405-000,2015,11,4,23,226,214,440,674
3405-000,2015,11,4,24,147,158,305,440
3405-000,2015,11,5,1,82,109,191,305
3405-000,2015,11,5,2,59,82,141,191
3405-000,2015,11,5,3,62,66,128,141
3405-000,2015,11,5,4,57,63,120,128
3405-000,2015,11,5,5,90,110,200,120
3405-000,2015,11,5,6,192,219,411,200
3405-000,2015,11,5,7,476,452,928,411
3405-000,2015,11,5,8,1003,1281,2284,928
3405-000,2015,11,5,9,1273,1308,2581,2284
3405-000,2015,11,5,10,1067,970,2037,2581
3405-000,2015,11,5,11,1172,998,2170,2037
3405-000,2015,11,5,12,1068,967,2035,2170
3405-000,2015,11,5,13,857,913,1770,2035
3405-000,2015,11,5,14,965,956,1921,1770
3405-000,2015,11,5,15,1148,1032,2180,1921
3405-000,2015,11,5,16,1156,988,2144,2180
3405-000,2015,11,5,17,1133,1050,2183,2144
3405-000,2015,11,5,18,1295,1107,2402,2183
3405-000,2015,11,5,19,1143,997,2140,2402
3405-000,2015,11,5,20,723,604,1327,2140
3405-000,2015,11,5,21,523,508,1031,1327
3405-000,2015,11,5,22,310,385,695,1031
3405-000,2015,11,5,23,243,232,475,695
3405-000,2015,11,5,24,122,154,276,475
3405-000,2015,11,6,1,77,94,171,276
3405-000,2015,11,6,2,68,67,135,171
3405-000,2015,11,6,3,60,50,110,135
3405-000,2015,11,6,4,46,76,122,110
3405-000,2015,11,6,5,75,110,185,122
3405-000,2015,11,6,6,168,172,340,185
3405-000,2015,11,6,7,454,458,912,340
3405-000,2015,11,6,8,966,1240,2206,912
3405-000,2015,11,6,9,1203,1226,2429,2206
3405-000,2015,11,6,10,1081,931,2012,2429
3405-000,2015,11,6,11,1115,982,2097,2012
3405-000,2015,11,6,12,1104,914,2018,2097
3405-000,2015,11,6,13,878,948,1826,2018
3405-000,2015,11,6,14,1008,989,1997,1826
3405-000,2015,11,6,15,1191,1051,2242,1997
3405-000,2015,11,6,16,1220,1075,2295,2242
3405-000,2015,11,6,17,1258,936,2194,2295
3405-000,2015,11,6,18,1375,1057,2432,2194
3405-000,2015,11,6,19,1534,1050,2584,2432
3405-000,2015,11,6,20,1001,652,1653,2584
3405-000,2015,11,6,21,642,593,1235,1653
3405-000,2015,11,6,22,394,351,745,1235
3405-000,2015,11,6,23,300,232,532,745
3405-000,2015,11,6,24,158,152,310,532
3405-000,2015,11,7,1,101,91,192,310
3405-000,2015,11,7,2,66,63,129,192
3405-000,2015,11,7,3,48,53,101,129
3405-000,2015,11,7,4,54,82,136,101
3405-000,2015,11,7,5,101,75,176,136
3405-000,2015,11,7,6,163,108,271,176
3405-000,2015,11,7,7,320,235,555,271
3405-000,2015,11,7,8,633,500,1133,555
3405-000,2015,11,7,9,771,621,1392,1133
3405-000,2015,11,7,10,764,677,1441,1392
3405-000,2015,11,7,11,872,900,1772,1441
3405-000,2015,11,7,12,870,863,1733,1772
3405-000,2015,11,7,13,660,724,1384,1733
3405-000,2015,11,7,14,709,689,1398,1384
3405-000,2015,11,7,15,688,710,1398,1398
3405-000,2015,11,7,16,686,765,1451,1398
3405-000,2015,11,7,17,746,639,1385,1451
3405-000,2015,11,7,18,797,768,1565,1385
3405-000,2015,11,7,19,612,603,1215,1565
3405-000,2015,11,7,20,419,398,817,1215
3405-000,2015,11,7,21,293,277,570,817
3405-000,2015,11,7,22,243,207,450,570
3405-000,2015,11,7,23,189,162,351,450
3405-000,2015,11,7,24,103,145,248,351
3405-000,2015,11,8,1,70,82,152,248
3405-000,2015,11,8,2,48,49,97,152
3405-000,2015,11,8,3,35,32,67,97
3405-000,2015,11,8,4,34,37,71,67
3405-000,2015,11,8,5,30,32,62,71
3405-000,2015,11,8,6,60,54,114,62
3405-000,2015,11,8,7,123,94,217,114
3405-000,2015,11,8,8,209,194,403,217
3405-000,2015,11,8,9,274,275,549,403
3405-000,2015,11,8,10,362,304,666,549
3405-000,2015,11,8,11,438,402,840,666
3405-000,2015,11,8,12,422,438,860,840
3405-000,2015,11,8,13,456,484,940,860
3405-000,2015,11,8,14,451,493,944,940
3405-000,2015,11,8,15,489,475,964,944
3405-000,2015,11,8,16,603,534,1137,964
3405-000,2015,11,8,17,500,558,1058,1137
3405-000,2015,11,8,18,511,617,1128,1058
3405-000,2015,11,8,19,429,455,884,1128
3405-000,2015,11,8,20,331,398,729,884
3405-000,2015,11,8,21,247,374,621,729
3405-000,2015,11,8,22,193,310,503,621
3405-000,2015,11,8,23,129,242,371,503
3405-000,2015,11,8,24,105,146,251,371
3405-000,2015,11,9,1,46,92,138,251
3405-000,2015,11,9,2,36,47,83,138
3405-000,2015,11,9,3,54,47,101,83
3405-000,2015,11,9,4,46,78,124,101
3405-000,2015,11,9,5,44,81,125,124
3405-000,2015,11,9,6,195,227,422,125
3405-000,2015,11,9,7,464,555,1019,422
3405-000,2015,11,9,8,988,1452,2440,1019
3405-000,2015,11,9,9,1168,1355,2523,2440
3405-000,2015,11,9,10,869,862,1731,2523
3405-000,2015,11,9,11,987,909,1896,1731
3405-000,2015,11,9,12,945,912,1857,1896
3405-000,2015,11,9,13,821,832,1653,1857
3405-000,2015,11,9,14,910,887,1797,1653
3405-000,2015,11,9,15,1081,1016,2097,1797
3405-000,2015,11,9,16,1057,955,2012,2097
3405-000,2015,11,9,17,1023,963,1986,2012
3405-000,2015,11,9,18,1123,1002,2125,1986
3405-000,2015,11,9,19,963,922,1885,2125
3405-000,2015,11,9,20,652,599,1251,1885
3405-000,2015,11,9,21,508,507,1015,1251
3405-000,2015,11,9,22,352,404,756,1015
3405-000,2015,11,9,23,262,219,481,756
3405-000,2015,11,9,24,134,158,292,481
3405-000,2015,11,10,1,85,81,166,292
3405-000,2015,11,10,2,56,69,125,166
3405-000,2015,11,10,3,55,56,111,125
3405-000,2015,11,10,4,58,80,138,111
3405-000,2015,11,10,5,106,98,204,138
3405-000,2015,11,10,6,214,188,402,204
3405-000,2015,11,10,7,457,459,916,402
3405-000,2015,11,10,8,967,1249,2216,916
3405-000,2015,11,10,9,1336,1289,2625,2216
3405-000,2015,11,10,10,1120,942,2062,2625
3405-000,2015,11,10,11,1094,986,2080,2062
3405-000,2015,11,10,12,1028,963,1991,2080
3405-000,2015,11,10,13,915,786,1701,1991
3405-000,2015,11,10,14,908,936,1844,1701
3405-000,2015,11,10,15,1103,1025,2128,1844
3405-000,2015,11,10,16,1103,1000,2103,2128
3405-000,2015,11,10,17,1073,893,1966,2103
3405-000,2015,11,10,18,1148,975,2123,1966
3405-000,2015,11,10,19,961,946,1907,2123
3405-000,2015,11,10,20,671,610,1281,1907
3405-000,2015,11,10,21,506,558,1064,1281
3405-000,2015,11,10,22,401,421,822,1064
3405-000,2015,11,10,23,247,200,447,822
3405-000,2015,11,10,24,141,150,291,447
3405-000,2015,11,11,1,88,94,182,291
3405-000,2015,11,11,2,60,70,130,182
3405-000,2015,11,11,3,64,50,114,130
3405-000,2015,11,11,4,37,79,116,114
3405-000,2015,11,11,5,93,90,183,116
3405-000,2015,11,11,6,234,193,427,183
3405-000,2015,11,11,7,477,425,902,427
3405-000,2015,11,11,8,999,1212,2211,902
3405-000,2015,11,11,9,1289,1327,2616,2211
3405-000,2015,11,11,10,1094,994,2088,2616
3405-000,2015,11,11,11,1146,947,2093,2088
3405-000,2015,11,11,12,1055,952,2007,2093
3405-000,2015,11,11,13,930,871,1801,2007
3405-000,2015,11,11,14,925,947,1872,1801
3405-000,2015,11,11,15,1071,1002,2073,1872
3405-000,2015,11,11,16,1080,1060,2140,2073
3405-000,2015,11,11,17,1109,967,2076,2140
3405-000,2015,11,11,18,1303,1056,2359,2076
3405-000,2015,11,11,19,1253,1022,2275,2359
3405-000,2015,11,11,20,680,576,1256,2275
3405-000,2015,11,11,21,516,522,1038,1256
3405-000,2015,11,11,22,385,378,763,1038
3405-000,2015,11,11,23,262,220,482,763
3405-000,2015,11,11,24,143,155,298,482
3405-000,2015,11,12,1,102,97,199,298
3405-000,2015,11,12,2,53,81,134,199
3405-000,2015,11,12,3,48,54,102,134
3405-000,2015,11,12,4,64,65,129,102
3405-000,2015,11,12,5,113,83,196,129
3405-000,2015,11,12,6,239,191,430,196
3405-000,2015,11,12,7,449,473,922,430
3405-000,2015,11,12,8,1008,1299,2307,922
3405-000,2015,11,12,9,1326,1279,2605,2307
3405-000,2015,11,12,10,1083,994,2077,2605
3405-000,2015,11,12,11,1170,960,2130,2077
3405-000,2015,11,12,12,1145,931,2076,2130
3405-000,2015,11,12,13,894,845,1739,2076
3405-000,2015,11,12,14,977,1020,1997,1739
3405-000,2015,11,12,15,1120,1031,2151,1997
3405-000,2015,11,12,16,1139,1080,2219,2151
3405-000,2015,11,12,17,1172,961,2133,2219
3405-000,2015,11,12,18,1197,1025,2222,2133
3405-000,2015,11,12,19,1023,932,1955,2222
3405-000,2015,11,12,20,693,663,1356,1955
3405-000,2015,11,12,21,511,547,1058,1356
3405-000,2015,11,12,22,367,379,746,1058
3405-000,2015,11,12,23,230,228,458,746
3405-000,2015,11,12,24,165,151,316,458
3405-000,2015,11,13,1,94,107,201,316
3405-000,2015,11,13,2,70,60,130,201
3405-000,2015,11,13,3,46,53,99,130
3405-000,2015,11,13,4,48,71,119,99
3405-000,2015,11,13,5,138,107,245,119
3405-000,2015,11,13,6,199,199,398,245
3405-000,2015,11,13,7,463,433,896,398
3405-000,2015,11,13,8,932,1152,2084,896
3405-000,2015,11,13,9,1193,1282,2475,2084
3405-000,2015,11,13,10,946,923,1869,2475
3405-000,2015,11,13,11,881,950,1831,1869
3405-000,2015,11,13,12,898,902,1800,1831
3405-000,2015,11,13,13,792,796,1588,1800
3405-000,2015,11,13,14,845,881,1726,1588
3405-000,2015,11,13,15,934,952,1886,1726
3405-000,2015,11,13,16,1035,924,1959,1886
3405-000,2015,11,13,17,984,817,1801,1959
3405-000,2015,11,13,18,1163,1008,2171,1801
3405-000,2015,11,13,19,1299,984,2283,2171
3405-000,2015,11,13,20,766,681,1447,2283
3405-000,2015,11,13,21,573,470,1043,1447
3405-000,2015,11,13,22,340,363,703,1043
3405-000,2015,11,13,23,244,240,484,703
3405-000,2015,11,13,24,167,181,348,484
3405-000,2015,11,14,1,85,112,197,348
3405-000,2015,11,14,2,60,64,124,197
3405-000,2015,11,14,3,51,53,104,124
3405-000,2015,11,14,4,40,65,105,104
3405-000,2015,11,14,5,47,77,124,105
3405-000,2015,11,14,6,129,120,249,124
3405-000,2015,11,14,7,270,248,518,249
3405-000,2015,11,14,8,504,533,1037,518
3405-000,2015,11,14,9,774,682,1456,1037
3405-000,2015,11,14,10,763,697,1460,1456
3405-000,2015,11,14,11,876,812,1688,1460
3405-000,2015,11,14,12,1045,743,1788,1688
3405-000,2015,11,14,13,893,752,1645,1788
3405-000,2015,11,14,14,738,737,1475,1645
3405-000,2015,11,14,15,850,753,1603,1475
3405-000,2015,11,14,16,774,842,1616,1603
3405-000,2015,11,14,17,898,773,1671,1616
3405-000,2015,11,14,18,875,882,1757,1671
3405-000,2015,11,14,19,641,710,1351,1757
3405-000,2015,11,14,20,454,446,900,1351
3405-000,2015,11,14,21,323,351,674,900
3405-000,2015,11,14,22,254,264,518,674
3405-000,2015,11,14,23,172,185,357,518
3405-000,2015,11,14,24,102,127,229,357
3405-000,2015,11,15,1,80,89,169,229
3405-000,2015,11,15,2,58,49,107,169
3405-000,2015,11,15,3,43,41,84,107
3405-000,2015,11,15,4,37,31,68,84
3405-000,2015,11,15,5,46,42,88,68
3405-000,2015,11,15,6,90,95,185,88
3405-000,2015,11,15,7,201,172,373,185
3405-000,2015,11,15,8,322,261,583,373
3405-000,2015,11,15,9,467,323,790,583
3405-000,2015,11,15,10,508,370,878,790
3405-000,2015,11,15,11,576,458,1034,878
3405-000,2015,11,15,12,562,486,1048,1034
3405-000,2015,11,15,13,541,540,1081,1048
3405-000,2015,11,15,14,605,676,1281,1081
3405-000,2015,11,15,15,751,620,1371,1281
3405-000,2015,11,15,16,725,708,1433,1371
3405-000,2015,11,15,17,693,725,1418,1433
3405-000,2015,11,15,18,701,729,1430,1418
3405-000,2015,11,15,19,618,608,1226,1430
3405-000,2015,11,15,20,519,599,1118,1226
3405-000,2015,11,15,21,460,471,931,1118
3405-000,2015,11,15,22,325,339,664,931
3405-000,2015,11,15,23,227,280,507,664
3405-000,2015,11,15,24,119,185,304,507
3405-000,2015,11,16,1,81,100,181,304
3405-000,2015,11,16,2,41,61,102,181
3405-000,2015,11,16,3,36,49,85,102
3405-000,2015,11,16,4,50,51,101,85
3405-000,2015,11,16,5,85,92,177,101
3405-000,2015,11,16,6,212,231,443,177
3405-000,2015,11,16,7,538,557,1095,443
3405-000,2015,11,16,8,1040,1502,2542,1095
3405-000,2015,11,16,9,1253,1360,2613,2542
3405-000,2015,11,16,10,1021,946,1967,2613
3405-000,2015,11,16,11,1066,952,2018,1967
3405-000,2015,11,16,12,1002,928,1930,2018
3405-000,2015,11,16,13,854,871,1725,1930
3405-000,2015,11,16,14,856,949,1805,1725
3405-000,2015,11,16,15,1068,1017,2085,1805
3405-000,2015,11,16,16,1028,968,1996,2085
3405-000,2015,11,16,17,982,962,1944,1996
3405-000,2015,11,16,18,1009,901,1910,1944
3405-000,2015,11,16,19,863,878,1741,1910
3405-000,2015,11,16,20,569,593,1162,1741
3405-000,2015,11,16,21,448,517,965,1162
3405-000,2015,11,16,22,311,328,639,965
3405-000,2015,11,16,23,210,222,432,639
3405-000,2015,11,16,24,107,131,238,432
3405-000,2015,11,17,1,70,106,176,238
3405-000,2015,11,17,2,48,67,115,176
3405-000,2015,11,17,3,33,56,89,115
3405-000,2015,11,17,4,39,64,103,89
3405-000,2015,11,17,5,62,109,171,103
3405-000,2015,11,17,6,204,178,382,171
3405-000,2015,11,17,7,387,428,815,382
3405-000,2015,11,17,8,946,1196,2142,815
3405-000,2015,11,17,9,1241,1186,2427,2142
3405-000,2015,11,17,10,942,947,1889,2427
3405-000,2015,11,17,11,955,957,1912,1889
3405-000,2015,11,17,12,954,877,1831,1912
3405-000,2015,11,17,13,776,790,1566,1831
3405-000,2015,11,17,14,812,894,1706,1566
3405-000,2015,11,17,15,1029,1010,2039,1706
3405-000,2015,11,17,16,1104,996,2100,2039
3405-000,2015,11,17,17,1104,935,2039,2100
3405-000,2015,11,17,18,1082,963,2045,2039
3405-000,2015,11,17,19,1019,970,1989,2045
3405-000,2015,11,17,20,691,593,1284,1989
3405-000,2015,11,17,21,549,532,1081,1284
3405-000,2015,11,17,22,368,432,800,1081
3405-000,2015,11,17,23,274,227,501,800
3405-000,2015,11,17,24,145,162,307,501
3405-000,2015,11,18,1,86,87,173,307
3405-000,2015,11,18,2,65,76,141,173
3405-000,2015,11,18,3,50,47,97,141
3405-000,2015,11,18,4,71,62,133,97
3405-000,2015,11,18,5,104,94,198,133
3405-000,2015,11,18,6,228,170,398,198
3405-000,2015,11,18,7,470,442,912,398
3405-000,2015,11,18,8,964,1140,2104,912
3405-000,2015,11,18,9,1234,1265,2499,2104
3405-000,2015,11,18,10,1048,875,1923,2499
3405-000,2015,11,18,11,1129,954,2083,1923
3405-000,2015,11,18,12,1067,947,2014,2083
3405-000,2015,11,18,13,833,827,1660,2014
3405-000,2015,11,18,14,834,978,1812,1660
3405-000,2015,11,18,15,918,1006,1924,1812
3405-000,2015,11,18,16,950,951,1901,1924
3405-000,2015,11,18,17,941,847,1788,1901
3405-000,2015,11,18,18,1004,1005,2009,1788
3405-000,2015,11,18,19,947,920,1867,2009
3405-000,2015,11,18,20,575,559,1134,1867
3405-000,2015,11,18,21,430,456,886,1134
3405-000,2015,11,18,22,300,347,647,886
3405-000,2015,11,18,23,200,198,398,647
3405-000,2015,11,18,24,131,137,268,398
3405-000,2015,11,19,1,72,103,175,268
3405-000,2015,11,19,2,46,61,107,175
3405-000,2015,11,19,3,60,65,125,107
3405-000,2015,11,19,4,38,59,97,125
3405-000,2015,11,19,5,76,99,175,97
3405-000,2015,11,19,6,183,169,352,175
3405-000,2015,11,19,7,401,444,845,352
3405-000,2015,11,19,8,890,1179,2069,845
3405-000,2015,11,19,9,1162,1274,2436,2069
3405-000,2015,11,19,10,976,888,1864,2436
3405-000,2015,11,19,11,953,1005,1958,1864
3405-000,2015,11,19,12,982,862,1844,1958
3405-000,2015,11,19,13,853,829,1682,1844
3405-000,2015,11,19,14,894,893,1787,1682
3405-000,2015,11,19,15,1067,958,2025,1787
3405-000,2015,11,19,16,1089,915,2004,2025
3405-000,2015,11,19,17,1018,986,2004,2004
3405-000,2015,11,19,18,1174,1020,2194,2004
3405-000,2015,11,19,19,996,918,1914,2194
3405-000,2015,11,19,20,646,619,1265,1914
3405-000,2015,11,19,21,419,500,919,1265
3405-000,2015,11,19,22,307,370,677,919
3405-000,2015,11,19,23,207,210,417,677
3405-000,2015,11,19,24,152,157,309,417
3405-000,2015,11,20,1,95,96,191,309
3405-000,2015,11,20,2,72,54,126,191
3405-000,2015,11,20,3,57,68,125,126
3405-000,2015,11,20,4,45,71,116,125
3405-000,2015,11,20,5,77,106,183,116
3405-000,2015,11,20,6,173,177,350,183
3405-000,2015,11,20,7,438,427,865,350
3405-000,2015,11,20,8,932,1184,2116,865
3405-000,2015,11,20,9,1240,1292,2532,2116
3405-000,2015,11,20,10,1105,956,2061,2532
3405-000,2015,11,20,11,1123,929,2052,2061
3405-000,2015,11,20,12,1020,968,1988,2052
3405-000,2015,11,20,13,919,850,1769,1988
3405-000,2015,11,20,14,929,948,1877,1769
3405-000,2015,11,20,15,1156,978,2134,1877
3405-000,2015,11,20,16,1167,995,2162,2134
3405-000,2015,11,20,17,1250,984,2234,2162
3405-000,2015,11,20,18,1461,1107,2568,2234
3405-000,2015,11,20,19,1478,1055,2533,2568
3405-000,2015,11,20,20,969,789,1758,2533
3405-000,2015,11,20,21,652,598,1250,1758
3405-000,2015,11,20,22,549,415,964,1250
3405-000,2015,11,20,23,324,254,578,964
3405-000,2015,11,20,24,177,178,355,578
3405-000,2015,11,21,1,117,108,225,355
3405-000,2015,11,21,2,67,87,154,225
3405-000,2015,11,21,3,65,57,122,154
3405-000,2015,11,21,4,61,73,134,122
3405-000,2015,11,21,5,84,100,184,134
3405-000,2015,11,21,6,178,152,330,184
3405-000,2015,11,21,7,393,310,703,330
3405-000,2015,11,21,8,686,571,1257,703
3405-000,2015,11,21,9,906,755,1661,1257
3405-000,2015,11,21,10,911,690,1601,1661
3405-000,2015,11,21,11,942,883,1825,1601
3405-000,2015,11,21,12,1152,860,2012,1825
3405-000,2015,11,21,13,1160,890,2050,2012
3405-000,2015,11,21,14,979,786,1765,2050
3405-000,2015,11,21,15,959,777,1736,1765
3405-000,2015,11,21,16,882,779,1661,1736
3405-000,2015,11,21,17,912,774,1686,1661
3405-000,2015,11,21,18,982,1047,2029,1686
3405-000,2015,11,21,19,863,860,1723,2029
3405-000,2015,11,21,20,556,613,1169,1723
3405-000,2015,11,21,21,398,396,794,1169
3405-000,2015,11,21,22,278,315,593,794
3405-000,2015,11,21,23,204,192,396,593
3405-000,2015,11,21,24,147,142,289,396
3405-000,2015,11,22,1,85,96,181,289
3405-000,2015,11,22,2,61,52,113,181
3405-000,2015,11,22,3,37,41,78,113
3405-000,2015,11,22,4,50,35,85,78
3405-000,2015,11,22,5,30,47,77,85
3405-000,2015,11,22,6,129,89,218,77
3405-000,2015,11,22,7,206,128,334,218
3405-000,2015,11,22,8,305,255,560,334
3405-000,2015,11,22,9,478,352,830,560
3405-000,2015,11,22,10,526,382,908,830
3405-000,2015,11,22,11,548,418,966,908
3405-000,2015,11,22,12,519,442,961,966
3405-000,2015,11,22,13,491,522,1013,961
3405-000,2015,11,22,14,574,538,1112,1013
3405-000,2015,11,22,15,651,605,1256,1112
3405-000,2015,11,22,16,711,675,1386,1256
3405-000,2015,11,22,17,720,653,1373,1386
3405-000,2015,11,22,18,816,662,1478,1373
3405-000,2015,11,22,19,718,614,1332,1478
3405-000,2015,11,22,20,668,510,1178,1332
3405-000,2015,11,22,21,525,451,976,1178
3405-000,2015,11,22,22,389,368,757,976
3405-000,2015,11,22,23,250,319,569,757
3405-000,2015,11,22,24,131,220,351,569
3405-000,2015,11,23,1,61,103,164,351
3405-000,2015,11,23,2,36,67,103,164
3405-000,2015,11,23,3,40,44,84,103
3405-000,2015,11,23,4,40,59,99,84
3405-000,2015,11,23,5,82,87,169,99
3405-000,2015,11,23,6,191,227,418,169
3405-000,2015,11,23,7,428,515,943,418
3405-000,2015,11,23,8,931,1326,2257,943
3405-000,2015,11,23,9,1219,1396,2615,2257
3405-000,2015,11,23,10,976,878,1854,2615
3405-000,2015,11,23,11,1003,935,1938,1854
3405-000,2015,11,23,12,943,886,1829,1938
3405-000,2015,11,23,13,762,852,1614,1829
3405-000,2015,11,23,14,826,879,1705,1614
3405-000,2015,11,23,15,1020,984,2004,1705
3405-000,2015,11,23,16,958,948,1906,2004
3405-000,2015,11,23,17,994,956,1950,1906
3405-000,2015,11,23,18,1032,879,1911,1950
3405-000,2015,11,23,19,907,899,1806,1911
3405-000,2015,11,23,20,611,599,1210,1806
3405-000,2015,11,23,21,498,499,997,1210
3405-000,2015,11,23,22,353,396,749,997
3405-000,2015,11,23,23,232,198,430,749
3405-000,2015,11,23,24,143,173,316,430
3405-000,2015,11,24,1,81,105,186,316
3405-000,2015,11,24,2,71,67,138,186
3405-000,2015,11,24,3,44,53,97,138
3405-000,2015,11,24,4,59,82,141,97
3405-000,2015,11,24,5,94,108,202,141
3405-000,2015,11,24,6,213,192,405,202
3405-000,2015,11,24,7,455,480,935,405
3405-000,2015,11,24,8,1012,1271,2283,935
3405-000,2015,11,24,9,1308,1286,2594,2283
3405-000,2015,11,24,10,1131,941,2072,2594
3405-000,2015,11,24,11,1114,1016,2130,2072
3405-000,2015,11,24,12,1044,970,2014,2130
3405-000,2015,11,24,13,849,843,1692,2014
3405-000,2015,11,24,14,941,955,1896,1692
3405-000,2015,11,24,15,1153,961,2114,1896
3405-000,2015,11,24,16,1092,999,2091,2114
3405-000,2015,11,24,17,1068,927,1995,2091
3405-000,2015,11,24,18,1172,1014,2186,1995
3405-000,2015,11,24,19,1070,939,2009,2186
3405-000,2015,11,24,20,658,578,1236,2009
3405-000,2015,11,24,21,529,518,1047,1236
3405-000,2015,11,24,22,387,390,777,1047
3405-000,2015,11,24,23,257,227,484,777
3405-000,2015,11,24,24,102,161,263,484
3405-000,2015,11,25,1,93,109,202,263
3405-000,2015,11,25,2,64,41,105,202
3405-000,2015,11,25,3,55,52,107,105
3405-000,2015,11,25,4,52,64,116,107
3405-000,2015,11,25,5,69,91,160,116
3405-000,2015,11,25,6,167,149,316,160
3405-000,2015,11,25,7,373,348,721,316
3405-000,2015,11,25,8,911,1076,1987,721
3405-000,2015,11,25,9,1189,1245,2434,1987
3405-000,2015,11,25,10,951,990,1941,2434
3405-000,2015,11,25,11,1059,945,2004,1941
3405-000,2015,11,25,12,998,917,1915,2004
3405-000,2015,11,25,13,813,747,1560,1915
3405-000,2015,11,25,14,844,902,1746,1560
3405-000,2015,11,25,15,1018,968,1986,1746
3405-000,2015,11,25,16,1065,928,1993,1986
3405-000,2015,11,25,17,1120,871,1991,1993
3405-000,2015,11,25,18,1085,979,2064,1991
3405-000,2015,11,25,19,939,874,1813,2064
3405-000,2015,11,25,20,587,571,1158,1813
3405-000,2015,11,25,21,435,450,885,1158
3405-000,2015,11,25,22,341,307,648,885
3405-000,2015,11,25,23,218,226,444,648
3405-000,2015,11,25,24,132,151,283,444
3405-000,2015,11,26,1,78,100,178,283
3405-000,2015,11,26,2,55,70,125,178
3405-000,2015,11,26,3,37,56,93,125
3405-000,2015,11,26,4,31,69,100,93
3405-000,2015,11,26,5,64,106,170,100
3405-000,2015,11,26,6,95,108,203,170
3405-000,2015,11,26,7,216,158,374,203
3405-000,2015,11,26,8,626,612,1238,374
3405-000,2015,11,26,9,877,942,1819,1238
3405-000,2015,11,26,10,951,930,1881,1819
3405-000,2015,11,26,11,947,915,1862,1881
3405-000,2015,11,26,12,961,718,1679,1862
3405-000,2015,11,26,13,818,695,1513,1679
3405-000,2015,11,26,14,935,775,1710,1513
3405-000,2015,11,26,15,1030,854,1884,1710
3405-000,2015,11,26,16,1058,869,1927,1884
3405-000,2015,11,26,17,1022,781,1803,1927
3405-000,2015,11,26,18,984,764,1748,1803
3405-000,2015,11,26,19,952,710,1662,1748
3405-000,2015,11,26,20,504,470,974,1662
3405-000,2015,11,26,21,365,430,795,974
3405-000,2015,11,26,22,273,263,536,795
3405-000,2015,11,26,23,144,189,333,536
3405-000,2015,11,26,24,108,123,231,333
3405-000,2015,11,27,1,83,75,158,231
3405-000,2015,11,27,2,46,57,103,158
3405-000,2015,11,27,3,44,54,98,103
3405-000,2015,11,27,4,50,59,109,98
3405-000,2015,11,27,5,78,90,168,109
3405-000,2015,11,27,6,153,147,300,168
3405-000,2015,11,27,7,308,326,634,300
3405-000,2015,11,27,8,824,926,1750,634
3405-000,2015,11,27,9,993,965,1958,1750
3405-000,2015,11,27,10,833,816,1649,1958
3405-000,2015,11,27,11,872,823,1695,1649
3405-000,2015,11,27,12,1019,846,1865,1695
3405-000,2015,11,27,13,794,770,1564,1865
3405-000,2015,11,27,14,880,823,1703,1564
3405-000,2015,11,27,15,1035,910,1945,1703
3405-000,2015,11,27,16,1030,921,1951,1945
3405-000,2015,11,27,17,1095,898,1993,1951
3405-000,2015,11,27,18,1384,943,2327,1993
3405-000,2015,11,27,19,1412,992,2404,2327
3405-000,2015,11,27,20,807,665,1472,2404
3405-000,2015,11,27,21,535,568,1103,1472
3405-000,2015,11,27,22,419,372,791,1103
3405-000,2015,11,27,23,230,206,436,791
3405-000,2015,11,27,24,159,144,303,436
3405-000,2015,11,28,1,82,99,181,303
3405-000,2015,11,28,2,71,71,142,181
3405-000,2015,11,28,3,55,52,107,142
3405-000,2015,11,28,4,65,69,134,107
3405-000,2015,11,28,5,66,78,144,134
3405-000,2015,11,28,6,152,125,277,144
3405-000,2015,11,28,7,341,242,583,277
3405-000,2015,11,28,8,546,490,1036,583
3405-000,2015,11,28,9,815,705,1520,1036
3405-000,2015,11,28,10,740,849,1589,1520
3405-000,2015,11,28,11,879,837,1716,1589
3405-000,2015,11,28,12,867,857,1724,1716
3405-000,2015,11,28,13,820,863,1683,1724
3405-000,2015,11,28,14,726,728,1454,1683
3405-000,2015,11,28,15,842,876,1718,1454
3405-000,2015,11,28,16,815,832,1647,1718
3405-000,2015,11,28,17,854,934,1788,1647
3405-000,2015,11,28,18,941,987,1928,1788
3405-000,2015,11,28,19,780,643,1423,1928
3405-000,2015,11,28,20,464,442,906,1423
3405-000,2015,11,28,21,296,289,585,906
3405-000,2015,11,28,22,250,233,483,585
3405-000,2015,11,28,23,176,168,344,483
3405-000,2015,11,28,24,111,127,238,344
3405-000,2015,11,29,1,71,75,146,238
3405-000,2015,11,29,2,49,37,86,146
3405-000,2015,11,29,3,29,28,57,86
3405-000,2015,11,29,4,35,34,69,57
3405-000,2015,11,29,5,32,48,80,69
3405-000,2015,11,29,6,86,74,160,80
3405-000,2015,11,29,7,158,130,288,160
3405-000,2015,11,29,8,249,208,457,288
3405-000,2015,11,29,9,357,297,654,457
3405-000,2015,11,29,10,406,336,742,654
3405-000,2015,11,29,11,461,450,911,742
3405-000,2015,11,29,12,586,519,1105,911
3405-000,2015,11,29,13,570,452,1022,1105
3405-000,2015,11,29,14,574,552,1126,1022
3405-000,2015,11,29,15,698,540,1238,1126
3405-000,2015,11,29,16,634,612,1246,1238
3405-000,2015,11,29,17,680,585,1265,1246
3405-000,2015,11,29,18,629,603,1232,1265
3405-000,2015,11,29,19,582,498,1080,1232
3405-000,2015,11,29,20,445,417,862,1080
3405-000,2015,11,29,21,409,412,821,862
3405-000,2015,11,29,22,256,400,656,821
3405-000,2015,11,29,23,188,285,473,656
3405-000,2015,11,29,24,110,140,250,473
3405-000,2015,11,30,1,44,75,119,250
3405-000,2015,11,30,2,53,57,110,119
3405-000,2015,11,30,3,48,39,87,110
3405-000,2015,11,30,4,53,70,123,87
3405-000,2015,11,30,5,88,76,164,123
3405-000,2015,11,30,6,192,206,398,164
3405-000,2015,11,30,7,499,481,980,398
3405-000,2015,11,30,8,952,1337,2289,980
3405-000,2015,11,30,9,1176,1378,2554,2289
3405-000,2015,11,30,10,972,910,1882,2554
3405-000,2015,11,30,11,998,968,1966,1882
3405-000,2015,11,30,12,1018,912,1930,1966
3405-000,2015,11,30,13,822,837,1659,1930
3405-000,2015,11,30,14,900,940,1840,1659
3405-000,2015,11,30,15,1037,1017,2054,1840
3405-000,2015,11,30,16,1055,944,1999,2054
3405-000,2015,11,30,17,1043,959,2002,1999
3405-000,2015,11,30,18,1059,978,2037,2002
3405-000,2015,11,30,19,1015,908,1923,2037
3405-000,2015,11,30,20,568,595,1163,1923
3405-000,2015,11,30,21,552,499,1051,1163
3405-000,2015,11,30,22,381,351,732,1051
3405-000,2015,11,30,23,239,243,482,732
3405-000,2015,11,30,24,154,153,307,482
3405-000,2015,12,1,1,102,103,205,307
3405-000,2015,12,1,2,60,77,137,205
3405-000,2015,12,1,3,39,65,104,137
3405-000,2015,12,1,4,43,66,109,104
3405-000,2015,12,1,5,98,120,218,109
3405-000,2015,12,1,6,170,160,330,218
3405-000,2015,12,1,7,430,408,838,330
3405-000,2015,12,1,8,964,1153,2117,838
3405-000,2015,12,1,9,1238,1239,2477,2117
3405-000,2015,12,1,10,1060,920,1980,2477
3405-000,2015,12,1,11,1046,881,1927,1980
3405-000,2015,12,1,12,1055,964,2019,1927
3405-000,2015,12,1,13,824,796,1620,2019
3405-000,2015,12,1,14,951,970,1921,1620
3405-000,2015,12,1,15,1038,1015,2053,1921
3405-000,2015,12,1,16,1064,1030,2094,2053
3405-000,2015,12,1,17,1132,986,2118,2094
3405-000,2015,12,1,18,1211,917,2128,2118
3405-000,2015,12,1,19,1105,977,2082,2128
3405-000,2015,12,1,20,691,568,1259,2082
3405-000,2015,12,1,21,513,507,1020,1259
3405-000,2015,12,1,22,368,401,769,1020
3405-000,2015,12,1,23,249,225,474,769
3405-000,2015,12,1,24,139,163,302,474
3405-000,2015,12,2,1,86,113,199,302
3405-000,2015,12,2,2,57,63,120,199
3405-000,2015,12,2,3,53,62,115,120
3405-000,2015,12,2,4,52,66,118,115
3405-000,2015,12,2,5,88,95,183,118
3405-000,2015,12,2,6,175,154,329,183
3405-000,2015,12,2,7,421,385,806,329
3405-000,2015,12,2,8,917,1158,2075,806
3405-000,2015,12,2,9,1205,1179,2384,2075
3405-000,2015,12,2,10,920,934,1854,2384
3405-000,2015,12,2,11,994,925,1919,1854
3405-000,2015,12,2,12,926,902,1828,1919
3405-000,2015,12,2,13,749,771,1520,1828
3405-000,2015,12,2,14,853,836,1689,1520
3405-000,2015,12,2,15,966,923,1889,1689
3405-000,2015,12,2,16,951,937,1888,1889
3405-000,2015,12,2,17,963,879,1842,1888
3405-000,2015,12,2,18,1061,925,1986,1842
3405-000,2015,12,2,19,1000,853,1853,1986
3405-000,2015,12,2,20,557,515,1072,1853
3405-000,2015,12,2,21,454,432,886,1072
3405-000,2015,12,2,22,336,352,688,886
3405-000,2015,12,2,23,219,196,415,688
3405-000,2015,12,2,24,145,141,286,415
3405-000,2015,12,3,1,91,105,196,286
3405-000,2015,12,3,2,65,77,142,196
3405-000,2015,12,3,3,44,61,105,142
3405-000,2015,12,3,4,60,71,131,105
3405-000,2015,12,3,5,68,75,143,131
3405-000,2015,12,3,6,160,131,291,143
3405-000,2015,12,3,7,365,304,669,291
3405-000,2015,12,3,8,863,895,1758,669
3405-000,2015,12,3,9,1090,917,2007,1758
3405-000,2015,12,3,10,809,796,1605,2007
3405-000,2015,12,3,11,850,837,1687,1605
3405-000,2015,12,3,12,793,786,1579,1687
3405-000,2015,12,3,13,700,614,1314,1579
3405-000,2015,12,3,14,743,762,1505,1314
3405-000,2015,12,3,15,835,679,1514,1505
3405-000,2015,12,3,16,891,774,1665,1514
3405-000,2015,12,3,17,644,614,1258,1665
3405-000,2015,12,3,18,698,690,1388,1258
3405-000,2015,12,3,19,873,793,1666,1388
3405-000,2015,12,3,20,790,538,1328,1666
3405-000,2015,12,3,21,421,418,839,1328
3405-000,2015,12,3,22,249,273,522,839
3405-000,2015,12,3,23,183,165,348,522
3405-000,2015,12,3,24,104,112,216,348
3405-000,2015,12,4,1,68,81,149,216
3405-000,2015,12,4,2,43,45,88,149
3405-000,2015,12,4,3,56,52,108,88
3405-000,2015,12,4,4,43,72,115,108
3405-000,2015,12,4,5,77,75,152,115
3405-000,2015,12,4,6,134,133,267,152
3405-000,2015,12,4,7,330,291,621,267
3405-000,2015,12,4,8,754,833,1587,621
3405-000,2015,12,4,9,978,922,1900,1587
3405-000,2015,12,4,10,771,789,1560,1900
3405-000,2015,12,4,11,965,898,1863,1560
3405-000,2015,12,4,12,938,915,1853,1863
3405-000,2015,12,4,13,849,926,1775,1853
3405-000,2015,12,4,14,927,1009,1936,1775
3405-000,2015,12,4,15,1019,987,2006,1936
3405-000,2015,12,4,16,1108,1015,2123,2006
3405-000,2015,12,4,17,1066,1053,2119,2123
3405-000,2015,12,4,18,1339,968,2307,2119
3405-000,2015,12,4,19,1315,1162,2477,2307
3405-000,2015,12,4,20,839,745,1584,2477
3405-000,2015,12,4,21,568,508,1076,1584
3405-000,2015,12,4,22,394,385,779,1076
3405-000,2015,12,4,23,273,249,522,779
3405-000,2015,12,4,24,149,159,308,522
3405-000,2015,12,5,1,119,106,225,308
3405-000,2015,12,5,2,71,88,159,225
3405-000,2015,12,5,3,51,63,114,159
3405-000,2015,12,5,4,51,94,145,114
3405-000,2015,12,5,5,83,105,188,145
3405-000,2015,12,5,6,154,164,318,188
3405-000,2015,12,5,7,324,299,623,318
3405-000,2015,12,5,8,570,541,1111,623
3405-000,2015,12,5,9,821,666,1487,1111
3405-000,2015,12,5,10,773,756,1529,1487
3405-000,2015,12,5,11,805,899,1704,1529
3405-000,2015,12,5,12,878,858,1736,1704
3405-000,2015,12,5,13,753,800,1553,1736
3405-000,2015,12,5,14,762,721,1483,1553
3405-000,2015,12,5,15,769,702,1471,1483
3405-000,2015,12,5,16,812,728,1540,1471
3405-000,2015,12,5,17,874,770,1644,1540
3405-000,2015,12,5,18,923,1035,1958,1644
3405-000,2015,12,5,19,718,870,1588,1958
3405-000,2015,12,5,20,453,460,913,1588
3405-000,2015,12,5,21,325,332,657,913
3405-000,2015,12,5,22,218,250,468,657
3405-000,2015,12,5,23,189,188,377,468
3405-000,2015,12,5,24,118,155,273,377
3405-000,2015,12,6,1,66,85,151,273
3405-000,2015,12,6,2,51,73,124,151
3405-000,2015,12,6,3,36,46,82,124
3405-000,2015,12,6,4,42,45,87,82
3405-000,2015,12,6,5,46,37,83,87
3405-000,2015,12,6,6,55,75,130,83
3405-000,2015,12,6,7,144,167,311,130
3405-000,2015,12,6,8,239,252,491,311
3405-000,2015,12,6,9,335,306,641,491
3405-000,2015,12,6,10,401,324,725,641
3405-000,2015,12,6,11,488,407,895,725
3405-000,2015,12,6,12,510,479,989,895
3405-000,2015,12,6,13,434,536,970,989
3405-000,2015,12,6,14,547,490,1037,970
3405-000,2015,12,6,15,570,568,1138,1037
3405-000,2015,12,6,16,629,591,1220,1138
3405-000,2015,12,6,17,754,644,1398,1220
3405-000,2015,12,6,18,630,607,1237,1398
3405-000,2015,12,6,19,519,555,1074,1237
3405-000,2015,12,6,20,414,421,835,1074
3405-000,2015,12,6,21,315,390,705,835
3405-000,2015,12,6,22,227,326,553,705
3405-000,2015,12,6,23,154,239,393,553
3405-000,2015,12,6,24,119,160,279,393
3405-000,2015,12,7,1,69,120,189,279
3405-000,2015,12,7,2,46,78,124,189
3405-000,2015,12,7,3,45,57,102,124
3405-000,2015,12,7,4,50,76,126,102
3405-000,2015,12,7,5,83,148,231,126
3405-000,2015,12,7,6,219,237,456,231
3405-000,2015,12,7,7,463,606,1069,456
3405-000,2015,12,7,8,1040,1297,2337,1069
3405-000,2015,12,7,9,1258,1383,2641,2337
3405-000,2015,12,7,10,999,929,1928,2641
3405-000,2015,12,7,11,980,997,1977,1928
3405-000,2015,12,7,12,1007,1025,2032,1977
3405-000,2015,12,7,13,895,859,1754,2032
3405-000,2015,12,7,14,906,1030,1936,1754
3405-000,2015,12,7,15,1082,1066,2148,1936
3405-000,2015,12,7,16,1059,1019,2078,2148
3405-000,2015,12,7,17,1072,1043,2115,2078
3405-000,2015,12,7,18,1142,1036,2178,2115
3405-000,2015,12,7,19,1072,919,1991,2178
3405-000,2015,12,7,20,591,600,1191,1991
3405-000,2015,12,7,21,536,508,1044,1191
3405-000,2015,12,7,22,364,407,771,1044
3405-000,2015,12,7,23,226,245,471,771
3405-000,2015,12,7,24,141,153,294,471
3405-000,2015,12,8,1,87,93,180,294
3405-000,2015,12,8,2,54,65,119,180
3405-000,2015,12,8,3,40,71,111,119
3405-000,2015,12,8,4,66,98,164,111
3405-000,2015,12,8,5,87,140,227,164
3405-000,2015,12,8,6,230,209,439,227
3405-000,2015,12,8,7,458,452,910,439
3405-000,2015,12,8,8,956,1131,2087,910
3405-000,2015,12,8,9,1206,1320,2526,2087
3405-000,2015,12,8,10,1082,995,2077,2526
3405-000,2015,12,8,11,1087,1042,2129,2077
3405-000,2015,12,8,12,1028,1013,2041,2129
3405-000,2015,12,8,13,815,881,1696,2041
3405-000,2015,12,8,14,920,1012,1932,1696
3405-000,2015,12,8,15,1117,1004,2121,1932
3405-000,2015,12,8,16,1084,1048,2132,2121
3405-000,2015,12,8,17,1091,942,2033,2132
3405-000,2015,12,8,18,1177,1042,2219,2033
3405-000,2015,12,8,19,1074,947,2021,2219
3405-000,2015,12,8,20,643,575,1218,2021
3405-000,2015,12,8,21,510,502,1012,1218
3405-000,2015,12,8,22,342,368,710,1012
3405-000,2015,12,8,23,265,218,483,710
3405-000,2015,12,8,24,160,149,309,483
3405-000,2015,12,9,1,105,106,211,309
3405-000,2015,12,9,2,60,84,144,211
3405-000,2015,12,9,3,54,60,114,144
3405-000,2015,12,9,4,63,109,172,114
3405-000,2015,12,9,5,96,119,215,172
3405-000,2015,12,9,6,217,233,450,215
3405-000,2015,12,9,7,447,443,890,450
3405-000,2015,12,9,8,953,1105,2058,890
3405-000,2015,12,9,9,1240,1269,2509,2058
3405-000,2015,12,9,10,1045,992,2037,2509
3405-000,2015,12,9,11,1108,1058,2166,2037
3405-000,2015,12,9,12,1022,1003,2025,2166
3405-000,2015,12,9,13,846,920,1766,2025
3405-000,2015,12,9,14,907,980,1887,1766
3405-000,2015,12,9,15,1113,1083,2196,1887
3405-000,2015,12,9,16,1069,1045,2114,2196
3405-000,2015,12,9,17,1043,1032,2075,2114
3405-000,2015,12,9,18,1300,1024,2324,2075
3405-000,2015,12,9,19,1195,894,2089,2324
3405-000,2015,12,9,20,677,578,1255,2089
3405-000,2015,12,9,21,479,510,989,1255
3405-000,2015,12,9,22,335,368,703,989
3405-000,2015,12,9,23,234,238,472,703
3405-000,2015,12,9,24,161,175,336,472
3405-000,2015,12,10,1,124,114,238,336
3405-000,2015,12,10,2,65,76,141,238
3405-000,2015,12,10,3,42,80,122,141
3405-000,2015,12,10,4,76,125,201,122
3405-000,2015,12,10,5,108,129,237,201
3405-000,2015,12,10,6,197,239,436,237
3405-000,2015,12,10,7,454,462,916,436
3405-000,2015,12,10,8,925,1145,2070,916
3405-000,2015,12,10,9,1296,1228,2524,2070
3405-000,2015,12,10,10,1026,1004,2030,2524
3405-000,2015,12,10,11,1068,1016,2084,2030
3405-000,2015,12,10,12,962,971,1933,2084
3405-000,2015,12,10,13,820,833,1653,1933
3405-000,2015,12,10,14,975,1023,1998,1653
3405-000,2015,12,10,15,1041,1005,2046,1998
3405-000,2015,12,10,16,1039,916,1955,2046
3405-000,2015,12,10,17,1007,1042,2049,1955
3405-000,2015,12,10,18,1065,966,2031,2049
3405-000,2015,12,10,19,977,876,1853,2031
3405-000,2015,12,10,20,651,606,1257,1853
3405-000,2015,12,10,21,512,502,1014,1257
3405-000,2015,12,10,22,326,402,728,1014
3405-000,2015,12,10,23,231,245,476,728
3405-000,2015,12,10,24,159,178,337,476
3405-000,2015,12,11,1,100,110,210,337
3405-000,2015,12,11,2,65,80,145,210
3405-000,2015,12,11,3,52,78,130,145
3405-000,2015,12,11,4,59,93,152,130
3405-000,2015,12,11,5,97,113,210,152
3405-000,2015,12,11,6,206,189,395,210
3405-000,2015,12,11,7,440,443,883,395
3405-000,2015,12,11,8,917,1098,2015,883
3405-000,2015,12,11,9,1291,1213,2504,2015
3405-000,2015,12,11,10,1070,1027,2097,2504
3405-000,2015,12,11,11,1046,1063,2109,2097
3405-000,2015,12,11,12,1110,991,2101,2109
3405-000,2015,12,11,13,916,921,1837,2101
3405-000,2015,12,11,14,956,1015,1971,1837
3405-000,2015,12,11,15,1097,1135,2232,1971
3405-000,2015,12,11,16,1163,1037,2200,2232
3405-000,2015,12,11,17,1170,1008,2178,2200
3405-000,2015,12,11,18,1331,1145,2476,2178
3405-000,2015,12,11,19,1502,1183,2685,2476
3405-000,2015,12,11,20,979,742,1721,2685
3405-000,2015,12,11,21,608,564,1172,1721
3405-000,2015,12,11,22,426,381,807,1172
3405-000,2015,12,11,23,300,255,555,807
3405-000,2015,12,11,24,173,163,336,555
3405-000,2015,12,12,1,103,113,216,336
3405-000,2015,12,12,2,71,74,145,216
3405-000,2015,12,12,3,69,74,143,145
3405-000,2015,12,12,4,82,81,163,143
3405-000,2015,12,12,5,90,121,211,163
3405-000,2015,12,12,6,195,176,371,211
3405-000,2015,12,12,7,385,280,665,371
3405-000,2015,12,12,8,642,582,1224,665
3405-000,2015,12,12,9,868,700,1568,1224
3405-000,2015,12,12,10,795,722,1517,1568
3405-000,2015,12,12,11,852,795,1647,1517
3405-000,2015,12,12,12,848,810,1658,1647
3405-000,2015,12,12,13,812,800,1612,1658
3405-000,2015,12,12,14,828,718,1546,1612
3405-000,2015,12,12,15,869,808,1677,1546
3405-000,2015,12,12,16,1029,812,1841,1677
3405-000,2015,12,12,17,895,758,1653,1841
3405-000,2015,12,12,18,1013,819,1832,1653
3405-000,2015,12,12,19,686,766,1452,1832
3405-000,2015,12,12,20,479,431,910,1452
3405-000,2015,12,12,21,317,382,699,910
3405-000,2015,12,12,22,263,262,525,699
3405-000,2015,12,12,23,219,210,429,525
3405-000,2015,12,12,24,145,159,304,429
3405-000,2015,12,13,1,84,107,191,304
3405-000,2015,12,13,2,59,59,118,191
3405-000,2015,12,13,3,47,57,104,118
3405-000,2015,12,13,4,37,46,83,104
3405-000,2015,12,13,5,57,62,119,83
3405-000,2015,12,13,6,97,89,186,119
3405-000,2015,12,13,7,180,168,348,186
3405-000,2015,12,13,8,313,242,555,348
3405-000,2015,12,13,9,380,354,734,555
3405-000,2015,12,13,10,416,350,766,734
3405-000,2015,12,13,11,573,442,1015,766
3405-000,2015,12,13,12,498,449,947,1015
3405-000,2015,12,13,13,472,613,1085,947
3405-000,2015,12,13,14,513,587,1100,1085
3405-000,2015,12,13,15,563,622,1185,1100
3405-000,2015,12,13,16,748,621,1369,1185
3405-000,2015,12,13,17,676,648,1324,1369
3405-000,2015,12,13,18,646,676,1322,1324
3405-000,2015,12,13,19,499,556,1055,1322
3405-000,2015,12,13,20,382,426,808,1055
3405-000,2015,12,13,21,315,379,694,808
3405-000,2015,12,13,22,226,375,601,694
3405-000,2015,12,13,23,154,274,428,601
3405-000,2015,12,13,24,126,152,278,428
3405-000,2015,12,14,1,64,92,156,278
3405-000,2015,12,14,2,51,64,115,156
3405-000,2015,12,14,3,32,58,90,115
3405-000,2015,12,14,4,50,65,115,90
3405-000,2015,12,14,5,91,124,215,115
3405-000,2015,12,14,6,227,254,481,215
3405-000,2015,12,14,7,528,601,1129,481
3405-000,2015,12,14,8,1020,1371,2391,1129
3405-000,2015,12,14,9,1217,1399,2616,2391
3405-000,2015,12,14,10,996,903,1899,2616
3405-000,2015,12,14,11,1041,996,2037,1899
3405-000,2015,12,14,12,969,1042,2011,2037
3405-000,2015,12,14,13,819,843,1662,2011
3405-000,2015,12,14,14,881,975,1856,1662
3405-000,2015,12,14,15,947,975,1922,1856
3405-000,2015,12,14,16,976,968,1944,1922
3405-000,2015,12,14,17,983,950,1933,1944
3405-000,2015,12,14,18,1011,947,1958,1933
3405-000,2015,12,14,19,998,857,1855,1958
3405-000,2015,12,14,20,634,574,1208,1855
3405-000,2015,12,14,21,462,499,961,1208
3405-000,2015,12,14,22,366,394,760,961
3405-000,2015,12,14,23,219,231,450,760
3405-000,2015,12,14,24,117,141,258,450
3405-000,2015,12,15,1,97,111,208,258
3405-000,2015,12,15,2,61,89,150,208
3405-000,2015,12,15,3,45,76,121,150
3405-000,2015,12,15,4,56,103,159,121
3405-000,2015,12,15,5,92,126,218,159
3405-000,2015,12,15,6,208,179,387,218
3405-000,2015,12,15,7,449,450,899,387
3405-000,2015,12,15,8,966,1124,2090,899
3405-000,2015,12,15,9,1309,1325,2634,2090
3405-000,2015,12,15,10,1023,1010,2033,2634
3405-000,2015,12,15,11,1095,1063,2158,2033
3405-000,2015,12,15,12,1014,970,1984,2158
3405-000,2015,12,15,13,861,881,1742,1984
3405-000,2015,12,15,14,964,1035,1999,1742
3405-000,2015,12,15,15,1069,1032,2101,1999
3405-000,2015,12,15,16,1137,1068,2205,2101
3405-000,2015,12,15,17,1076,985,2061,2205
3405-000,2015,12,15,18,1183,1017,2200,2061
3405-000,2015,12,15,19,1014,916,1930,2200
3405-000,2015,12,15,20,651,579,1230,1930
3405-000,2015,12,15,21,511,524,1035,1230
3405-000,2015,12,15,22,350,376,726,1035
3405-000,2015,12,15,23,264,242,506,726
3405-000,2015,12,15,24,151,184,335,506
3405-000,2015,12,16,1,104,113,217,335
3405-000,2015,12,16,2,80,83,163,217
3405-000,2015,12,16,3,42,77,119,163
3405-000,2015,12,16,4,76,92,168,119
3405-000,2015,12,16,5,109,100,209,168
3405-000,2015,12,16,6,179,175,354,209
3405-000,2015,12,16,7,414,413,827,354
3405-000,2015,12,16,8,937,1036,1973,827
3405-000,2015,12,16,9,1250,1221,2471,1973
3405-000,2015,12,16,10,1037,909,1946,2471
3405-000,2015,12,16,11,1027,1046,2073,1946
3405-000,2015,12,16,12,937,991,1928,2073
3405-000,2015,12,16,13,810,852,1662,1928
3405-000,2015,12,16,14,949,931,1880,1662
3405-000,2015,12,16,15,1074,987,2061,1880
3405-000,2015,12,16,16,1078,934,2012,2061
3405-000,2015,12,16,17,1034,908,1942,2012
3405-000,2015,12,16,18,1124,1023,2147,1942
3405-000,2015,12,16,19,1061,919,1980,2147
3405-000,2015,12,16,20,557,586,1143,1980
3405-000,2015,12,16,21,440,431,871,1143
3405-000,2015,12,16,22,312,343,655,871
3405-000,2015,12,16,23,251,202,453,655
3405-000,2015,12,16,24,155,146,301,453
3405-000,2015,12,17,1,106,107,213,301
3405-000,2015,12,17,2,64,82,146,213
3405-000,2015,12,17,3,56,75,131,146
3405-000,2015,12,17,4,43,85,128,131
3405-000,2015,12,17,5,89,121,210,128
3405-000,2015,12,17,6,187,157,344,210
3405-000,2015,12,17,7,422,409,831,344
3405-000,2015,12,17,8,911,1115,2026,831
3405-000,2015,12,17,9,1268,1237,2505,2026
3405-000,2015,12,17,10,1006,972,1978,2505
3405-000,2015,12,17,11,1015,1038,2053,1978
3405-000,2015,12,17,12,1039,948,1987,2053
3405-000,2015,12,17,13,1011,923,1934,1987
3405-000,2015,12,17,14,994,952,1946,1934
3405-000,2015,12,17,15,1150,987,2137,1946
3405-000,2015,12,17,16,1090,912,2002,2137
3405-000,2015,12,17,17,1084,989,2073,2002
3405-000,2015,12,17,18,1175,1012,2187,2073
3405-000,2015,12,17,19,1100,894,1994,2187
3405-000,2015,12,17,20,637,631,1268,1994
3405-000,2015,12,17,21,484,490,974,1268
3405-000,2015,12,17,22,369,388,757,974
3405-000,2015,12,17,23,221,216,437,757
3405-000,2015,12,17,24,156,168,324,437
3405-000,2015,12,18,1,109,117,226,324
3405-000,2015,12,18,2,79,68,147,226
3405-000,2015,12,18,3,49,81,130,147
3405-000,2015,12,18,4,46,85,131,130
3405-000,2015,12,18,5,69,121,190,131
3405-000,2015,12,18,6,175,194,369,190
3405-000,2015,12,18,7,406,437,843,369
3405-000,2015,12,18,8,909,1090,1999,843
3405-000,2015,12,18,9,1236,1299,2535,1999
3405-000,2015,12,18,10,986,943,1929,2535
3405-000,2015,12,18,11,1109,1036,2145,1929
3405-000,2015,12,18,12,1062,1012,2074,2145
3405-000,2015,12,18,13,929,933,1862,2074
3405-000,2015,12,18,14,979,968,1947,1862
3405-000,2015,12,18,15,1137,1000,2137,1947
3405-000,2015,12,18,16,1134,986,2120,2137
3405-000,2015,12,18,17,1131,997,2128,2120
3405-000,2015,12,18,18,1279,1124,2403,2128
3405-000,2015,12,18,19,1313,948,2261,2403
3405-000,2015,12,18,20,812,671,1483,2261
3405-000,2015,12,18,21,598,518,1116,1483
3405-000,2015,12,18,22,438,362,800,1116
3405-000,2015,12,18,23,263,242,505,800
3405-000,2015,12,18,24,181,187,368,505
3405-000,2015,12,19,1,104,120,224,368
3405-000,2015,12,19,2,81,82,163,224
3405-000,2015,12,19,3,55,71,126,163
3405-000,2015,12,19,4,60,82,142,126
3405-000,2015,12,19,5,75,67,142,142
3405-000,2015,12,19,6,135,123,258,142
3405-000,2015,12,19,7,313,285,598,258
3405-000,2015,12,19,8,583,520,1103,598
3405-000,2015,12,19,9,889,695,1584,1103
3405-000,2015,12,19,10,761,625,1386,1584
3405-000,2015,12,19,11,832,658,1490,1386
3405-000,2015,12,19,12,843,766,1609,1490
3405-000,2015,12,19,13,722,729,1451,1609
3405-000,2015,12,19,14,722,705,1427,1451
3405-000,2015,12,19,15,868,716,1584,1427
3405-000,2015,12,19,16,830,662,1492,1584
3405-000,2015,12,19,17,762,705,1467,1492
3405-000,2015,12,19,18,871,846,1717,1467
3405-000,2015,12,19,19,699,607,1306,1717
3405-000,2015,12,19,20,452,410,862,1306
3405-000,2015,12,19,21,330,310,640,862
3405-000,2015,12,19,22,258,228,486,640
3405-000,2015,12,19,23,186,188,374,486
3405-000,2015,12,19,24,125,160,285,374
3405-000,2015,12,20,1,74,73,147,285
3405-000,2015,12,20,2,50,53,103,147
3405-000,2015,12,20,3,42,42,84,103
3405-000,2015,12,20,4,48,43,91,84
3405-000,2015,12,20,5,50,46,96,91
3405-000,2015,12,20,6,94,76,170,96
3405-000,2015,12,20,7,148,107,255,170
3405-000,2015,12,20,8,266,209,475,255
3405-000,2015,12,20,9,426,274,700,475
3405-000,2015,12,20,10,479,310,789,700
3405-000,2015,12,20,11,489,416,905,789
3405-000,2015,12,20,12,474,439,913,905
3405-000,2015,12,20,13,447,478,925,913
3405-000,2015,12,20,14,433,559,992,925
3405-000,2015,12,20,15,490,563,1053,992
3405-000,2015,12,20,16,549,640,1189,1053
3405-000,2015,12,20,17,549,618,1167,1189
3405-000,2015,12,20,18,563,678,1241,1167
3405-000,2015,12,20,19,422,508,930,1241
3405-000,2015,12,20,20,361,413,774,930
3405-000,2015,12,20,21,250,339,589,774
3405-000,2015,12,20,22,262,293,555,589
3405-000,2015,12,20,23,179,243,422,555
3405-000,2015,12,20,24,120,140,260,422
3405-000,2015,12,21,1,63,95,158,260
3405-000,2015,12,21,2,60,56,116,158
3405-000,2015,12,21,3,44,52,96,116
3405-000,2015,12,21,4,46,61,107,96
3405-000,2015,12,21,5,79,79,158,107
3405-000,2015,12,21,6,223,223,446,158
3405-000,2015,12,21,7,515,570,1085,446
3405-000,2015,12,21,8,930,1271,2201,1085
3405-000,2015,12,21,9,1171,1264,2435,2201
3405-000,2015,12,21,10,933,804,1737,2435
3405-000,2015,12,21,11,960,904,1864,1737
3405-000,2015,12,21,12,934,850,1784,1864
3405-000,2015,12,21,13,826,857,1683,1784
3405-000,2015,12,21,14,929,934,1863,1683
3405-000,2015,12,21,15,1084,973,2057,1863
3405-000,2015,12,21,16,1027,915,1942,2057
3405-000,2015,12,21,17,968,881,1849,1942
3405-000,2015,12,21,18,1011,902,1913,1849
3405-000,2015,12,21,19,883,856,1739,1913
3405-000,2015,12,21,20,609,567,1176,1739
3405-000,2015,12,21,21,447,489,936,1176
3405-000,2015,12,21,22,326,351,677,936
3405-000,2015,12,21,23,217,178,395,677
3405-000,2015,12,21,24,127,136,263,395
3405-000,2015,12,22,1,81,94,175,263
3405-000,2015,12,22,2,62,64,126,175
3405-000,2015,12,22,3,47,71,118,126
3405-000,2015,12,22,4,43,83,126,118
3405-000,2015,12,22,5,90,101,191,126
3405-000,2015,12,22,6,192,177,369,191
3405-000,2015,12,22,7,450,396,846,369
3405-000,2015,12,22,8,990,1090,2080,846
3405-000,2015,12,22,9,1259,1280,2539,2080
3405-000,2015,12,22,10,1073,959,2032,2539
3405-000,2015,12,22,11,1144,962,2106,2032
3405-000,2015,12,22,12,1036,934,1970,2106
3405-000,2015,12,22,13,843,849,1692,1970
3405-000,2015,12,22,14,949,950,1899,1692
3405-000,2015,12,22,15,1111,1048,2159,1899
3405-000,2015,12,22,16,1134,1013,2147,2159
3405-000,2015,12,22,17,1108,953,2061,2147
3405-000,2015,12,22,18,1117,1018,2135,2061
3405-000,2015,12,22,19,935,829,1764,2135
3405-000,2015,12,22,20,629,547,1176,1764
3405-000,2015,12,22,21,481,493,974,1176
3405-000,2015,12,22,22,327,343,670,974
3405-000,2015,12,22,23,203,202,405,670
3405-000,2015,12,22,24,135,162,297,405
3405-000,2015,12,23,1,101,110,211,297
3405-000,2015,12,23,2,59,75,134,211
3405-000,2015,12,23,3,58,66,124,134
3405-000,2015,12,23,4,51,80,131,124
3405-000,2015,12,23,5,96,92,188,131
3405-000,2015,12,23,6,182,176,358,188
3405-000,2015,12,23,7,410,429,839,358
3405-000,2015,12,23,8,929,1092,2021,839
3405-000,2015,12,23,9,1225,1190,2415,2021
3405-000,2015,12,23,10,1003,945,1948,2415
3405-000,2015,12,23,11,1099,955,2054,1948
3405-000,2015,12,23,12,946,941,1887,2054
3405-000,2015,12,23,13,880,836,1716,1887
3405-000,2015,12,23,14,963,954,1917,1716
3405-000,2015,12,23,15,1027,1034,2061,1917
3405-000,2015,12,23,16,1064,959,2023,2061
3405-000,2015,12,23,17,1017,920,1937,2023
3405-000,2015,12,23,18,1167,998,2165,1937
3405-000,2015,12,23,19,1016,862,1878,2165
3405-000,2015,12,23,20,647,562,1209,1878
3405-000,2015,12,23,21,425,479,904,1209
3405-000,2015,12,23,22,345,364,709,904
3405-000,2015,12,23,23,256,229,485,709
3405-000,2015,12,23,24,156,150,306,485
3405-000,2015,12,24,1,125,117,242,306
3405-000,2015,12,24,2,68,74,142,242
3405-000,2015,12,24,3,57,59,116,142
3405-000,2015,12,24,4,64,75,139,116
3405-000,2015,12,24,5,88,93,181,139
3405-000,2015,12,24,6,179,161,340,181
3405-000,2015,12,24,7,422,401,823,340
3405-000,2015,12,24,8,950,1043,1993,823
3405-000,2015,12,24,9,1163,1146,2309,1993
3405-000,2015,12,24,10,938,916,1854,2309
3405-000,2015,12,24,11,1041,953,1994,1854
3405-000,2015,12,24,12,952,900,1852,1994
3405-000,2015,12,24,13,857,797,1654,1852
3405-000,2015,12,24,14,956,913,1869,1654
3405-000,2015,12,24,15,1080,967,2047,1869
3405-000,2015,12,24,16,1096,966,2062,2047
3405-000,2015,12,24,17,1048,997,2045,2062
3405-000,2015,12,24,18,1421,1195,2616,2045
3405-000,2015,12,24,19,1568,1067,2635,2616
3405-000,2015,12,24,20,949,687,1636,2635
3405-000,2015,12,24,21,542,504,1046,1636
3405-000,2015,12,24,22,373,335,708,1046
3405-000,2015,12,24,23,260,200,460,708
3405-000,2015,12,24,24,143,158,301,460
3405-000,2015,12,25,1,98,122,220,301
3405-000,2015,12,25,2,62,56,118,220
3405-000,2015,12,25,3,53,65,118,118
3405-000,2015,12,25,4,54,68,122,118
3405-000,2015,12,25,5,79,79,158,122
3405-000,2015,12,25,6,129,130,259,158
3405-000,2015,12,25,7,271,244,515,259
3405-000,2015,12,25,8,465,333,798,515
3405-000,2015,12,25,9,588,435,1023,798
3405-000,2015,12,25,10,552,395,947,1023
3405-000,2015,12,25,11,686,499,1185,947
3405-000,2015,12,25,12,612,546,1158,1185
3405-000,2015,12,25,13,614,565,1179,1158
3405-000,2015,12,25,14,608,553,1161,1179
3405-000,2015,12,25,15,627,598,1225,1161
3405-000,2015,12,25,16,626,551,1177,1225
3405-000,2015,12,25,17,613,527,1140,1177
3405-000,2015,12,25,18,731,560,1291,1140
3405-000,2015,12,25,19,506,391,897,1291
3405-000,2015,12,25,20,368,317,685,897
3405-000,2015,12,25,21,254,241,495,685
3405-000,2015,12,25,22,181,198,379,495
3405-000,2015,12,25,23,155,183,338,379
3405-000,2015,12,25,24,90,120,210,338
3405-000,2015,12,26,1,70,81,151,210
3405-000,2015,12,26,2,40,47,87,151
3405-000,2015,12,26,3,30,44,74,87
3405-000,2015,12,26,4,35,50,85,74
3405-000,2015,12,26,5,61,70,131,85
3405-000,2015,12,26,6,129,140,269,131
3405-000,2015,12,26,7,272,211,483,269
3405-000,2015,12,26,8,453,365,818,483
3405-000,2015,12,26,9,541,412,953,818
3405-000,2015,12,26,10,564,461,1025,953
3405-000,2015,12,26,11,585,516,1101,1025
3405-000,2015,12,26,12,635,590,1225,1101
3405-000,2015,12,26,13,566,573,1139,1225
3405-000,2015,12,26,14,581,545,1126,1139
3405-000,2015,12,26,15,661,590,1251,1126
3405-000,2015,12,26,16,718,615,1333,1251
3405-000,2015,12,26,17,692,630,1322,1333
3405-000,2015,12,26,18,722,668,1390,1322
3405-000,2015,12,26,19,570,454,1024,1390
3405-000,2015,12,26,20,526,395,921,1024
3405-000,2015,12,26,21,253,309,562,921
3405-000,2015,12,26,22,194,213,407,562
3405-000,2015,12,26,23,139,177,316,407
3405-000,2015,12,26,24,88,114,202,316
3405-000,2015,12,27,1,64,80,144,202
3405-000,2015,12,27,2,35,50,85,144
3405-000,2015,12,27,3,33,27,60,85
3405-000,2015,12,27,4,31,40,71,60
3405-000,2015,12,27,5,29,35,64,71
3405-000,2015,12,27,6,61,70,131,64
3405-000,2015,12,27,7,122,89,211,131
3405-000,2015,12,27,8,213,181,394,211
3405-000,2015,12,27,9,306,256,562,394
3405-000,2015,12,27,10,365,285,650,562
3405-000,2015,12,27,11,434,352,786,650
3405-000,2015,12,27,12,463,390,853,786
3405-000,2015,12,27,13,401,482,883,853
3405-000,2015,12,27,14,402,471,873,883
3405-000,2015,12,27,15,519,533,1052,873
3405-000,2015,12,27,16,566,601,1167,1052
3405-000,2015,12,27,17,500,635,1135,1167
3405-000,2015,12,27,18,510,599,1109,1135
3405-000,2015,12,27,19,400,430,830,1109
3405-000,2015,12,27,20,308,368,676,830
3405-000,2015,12,27,21,273,326,599,676
3405-000,2015,12,27,22,226,279,505,599
3405-000,2015,12,27,23,140,209,349,505
3405-000,2015,12,27,24,91,107,198,349
3405-000,2015,12,28,1,52,84,136,198
3405-000,2015,12,28,2,43,48,91,136
3405-000,2015,12,28,3,28,41,69,91
3405-000,2015,12,28,4,25,41,66,69
3405-000,2015,12,28,5,51,94,145,66
3405-000,2015,12,28,6,184,208,392,145
3405-000,2015,12,28,7,510,503,1013,392
3405-000,2015,12,28,8,953,1333,2286,1013
3405-000,2015,12,28,9,1239,1235,2474,2286
3405-000,2015,12,28,10,897,849,1746,2474
3405-000,2015,12,28,11,1010,943,1953,1746
3405-000,2015,12,28,12,909,941,1850,1953
3405-000,2015,12,28,13,814,839,1653,1850
3405-000,2015,12,28,14,882,882,1764,1653
3405-000,2015,12,28,15,1042,940,1982,1764
3405-000,2015,12,28,16,1009,927,1936,1982
3405-000,2015,12,28,17,1042,937,1979,1936
3405-000,2015,12,28,18,1106,922,2028,1979
3405-000,2015,12,28,19,867,847,1714,2028
3405-000,2015,12,28,20,587,550,1137,1714
3405-000,2015,12,28,21,448,490,938,1137
3405-000,2015,12,28,22,350,356,706,938
3405-000,2015,12,28,23,220,220,440,706
3405-000,2015,12,28,24,137,129,266,440
3405-000,2015,12,29,1,75,101,176,266
3405-000,2015,12,29,2,63,66,129,176
3405-000,2015,12,29,3,39,60,99,129
3405-000,2015,12,29,4,48,69,117,99
3405-000,2015,12,29,5,78,105,183,117
3405-000,2015,12,29,6,148,172,320,183
3405-000,2015,12,29,7,351,392,743,320
3405-000,2015,12,29,8,895,1154,2049,743
3405-000,2015,12,29,9,1124,1181,2305,2049
3405-000,2015,12,29,10,939,806,1745,2305
3405-000,2015,12,29,11,1094,925,2019,1745
3405-000,2015,12,29,12,948,1007,1955,2019
3405-000,2015,12,29,13,842,819,1661,1955
3405-000,2015,12,29,14,926,912,1838,1661
3405-000,2015,12,29,15,1073,986,2059,1838
3405-000,2015,12,29,16,1093,940,2033,2059
3405-000,2015,12,29,17,1040,889,1929,2033
3405-000,2015,12,29,18,1082,961,2043,1929
3405-000,2015,12,29,19,917,870,1787,2043
3405-000,2015,12,29,20,634,552,1186,1787
3405-000,2015,12,29,21,478,449,927,1186
3405-000,2015,12,29,22,321,332,653,927
3405-000,2015,12,29,23,225,211,436,653
3405-000,2015,12,29,24,116,155,271,436
3405-000,2015,12,30,1,90,109,199,271
3405-000,2015,12,30,2,57,76,133,199
3405-000,2015,12,30,3,38,68,106,133
3405-000,2015,12,30,4,55,60,115,106
3405-000,2015,12,30,5,94,107,201,115
3405-000,2015,12,30,6,197,159,356,201
3405-000,2015,12,30,7,427,352,779,356
3405-000,2015,12,30,8,872,1087,1959,779
3405-000,2015,12,30,9,1165,1117,2282,1959
3405-000,2015,12,30,10,1002,845,1847,2282
3405-000,2015,12,30,11,1020,906,1926,1847
3405-000,2015,12,30,12,964,915,1879,1926
3405-000,2015,12,30,13,803,790,1593,1879
3405-000,2015,12,30,14,905,900,1805,1593
3405-000,2015,12,30,15,1057,949,2006,1805
3405-000,2015,12,30,16,1045,980,2025,2006
3405-000,2015,12,30,17,1006,868,1874,2025
3405-000,2015,12,30,18,1180,976,2156,1874
3405-000,2015,12,30,19,1194,813,2007,2156
3405-000,2015,12,30,20,642,578,1220,2007
3405-000,2015,12,30,21,433,399,832,1220
3405-000,2015,12,30,22,329,322,651,832
3405-000,2015,12,30,23,231,227,458,651
3405-000,2015,12,30,24,123,151,274,458
3405-000,2015,12,31,1,111,122,233,274
3405-000,2015,12,31,2,81,80,161,233
3405-000,2015,12,31,3,52,77,129,161
3405-000,2015,12,31,4,56,82,138,129
3405-000,2015,12,31,5,77,77,154,138
3405-000,2015,12,31,6,152,118,270,154
3405-000,2015,12,31,7,333,326,659,270
3405-000,2015,12,31,8,808,889,1697,659
3405-000,2015,12,31,9,986,987,1973,1697
3405-000,2015,12,31,10,835,758,1593,1973
3405-000,2015,12,31,11,929,784,1713,1593
3405-000,2015,12,31,12,957,815,1772,1713
3405-000,2015,12,31,13,850,713,1563,1772
3405-000,2015,12,31,14,882,804,1686,1563
3405-000,2015,12,31,15,935,797,1732,1686
3405-000,2015,12,31,16,1107,908,2015,1732
3405-000,2015,12,31,17,1031,824,1855,2015
3405-000,2015,12,31,18,1157,944,2101,1855
3405-000,2015,12,31,19,1043,775,1818,2101
3405-000,2015,12,31,20,686,556,1242,1818
3405-000,2015,12,31,21,474,378,852,1242
3405-000,2015,12,31,22,323,279,602,852
3405-000,2015,12,31,23,276,198,474,602
3405-000,2015,12,31,24,139,127,266,474
3405-000,2016,1,1,1,122,100,222,266
3405-000,2016,1,1,2,116,69,185,222
3405-000,2016,1,1,3,84,68,152,185
3405-000,2016,1,1,4,70,49,119,152
3405-000,2016,1,1,5,61,62,123,119
3405-000,2016,1,1,6,119,78,197,123
3405-000,2016,1,1,7,197,111,308,197
3405-000,2016,1,1,8,263,166,429,308
3405-000,2016,1,1,9,357,242,599,429
3405-000,2016,1,1,10,451,282,733,599
3405-000,2016,1,1,11,557,399,956,733
3405-000,2016,1,1,12,550,523,1073,956
3405-000,2016,1,1,13,525,514,1039,1073
3405-000,2016,1,1,14,560,461,1021,1039
3405-000,2016,1,1,15,590,548,1138,1021
3405-000,2016,1,1,16,567,541,1108,1138
3405-000,2016,1,1,17,566,541,1107,1108
3405-000,2016,1,1,18,501,488,989,1107
3405-000,2016,1,1,19,394,370,764,989
3405-000,2016,1,1,20,304,324,628,764
3405-000,2016,1,1,21,221,287,508,628
3405-000,2016,1,1,22,181,208,389,508
3405-000,2016,1,1,23,140,158,298,389
3405-000,2016,1,1,24,73,109,182,298
3405-000,2016,1,2,1,53,69,122,182
3405-000,2016,1,2,2,29,57,86,122
3405-000,2016,1,2,3,45,34,79,86
3405-000,2016,1,2,4,25,32,57,79
3405-000,2016,1,2,5,59,38,97,57
3405-000,2016,1,2,6,80,79,159,97
3405-000,2016,1,2,7,176,141,317,159
3405-000,2016,1,2,8,295,234,529,317
3405-000,2016,1,2,9,436,340,776,529
3405-000,2016,1,2,10,466,367,833,776
3405-000,2016,1,2,11,579,472,1051,833
3405-000,2016,1,2,12,570,565,1135,1051
3405-000,2016,1,2,13,565,580,1145,1135
3405-000,2016,1,2,14,554,608,1162,1145
3405-000,2016,1,2,15,618,559,1177,1162
3405-000,2016,1,2,16,620,575,1195,1177
3405-000,2016,1,2,17,641,646,1287,1195
3405-000,2016,1,2,18,625,631,1256,1287
3405-000,2016,1,2,19,466,544,1010,1256
3405-000,2016,1,2,20,364,373,737,1010
3405-000,2016,1,2,21,280,339,619,737
3405-000,2016,1,2,22,213,261,474,619
3405-000,2016,1,2,23,119,187,306,474
3405-000,2016,1,2,24,90,138,228,306
3405-000,2016,1,3,1,60,95,155,228
3405-000,2016,1,3,2,39,42,81,155
3405-000,2016,1,3,3,25,33,58,81
3405-000,2016,1,3,4,28,35,63,58
3405-000,2016,1,3,5,31,37,68,63
3405-000,2016,1,3,6,62,65,127,68
3405-000,2016,1,3,7,110,118,228,127
3405-000,2016,1,3,8,204,164,368,228
3405-000,2016,1,3,9,320,223,543,368
3405-000,2016,1,3,10,358,278,636,543
3405-000,2016,1,3,11,474,308,782,636
3405-000,2016,1,3,12,432,416,848,782
3405-000,2016,1,3,13,465,458,923,848
3405-000,2016,1,3,14,491,518,1009,923
3405-000,2016,1,3,15,497,580,1077,1009
3405-000,2016,1,3,16,548,652,1200,1077
3405-000,2016,1,3,17,524,631,1155,1200
3405-000,2016,1,3,18,478,588,1066,1155
3405-000,2016,1,3,19,378,464,842,1066
3405-000,2016,1,3,20,284,369,653,842
3405-000,2016,1,3,21,278,322,600,653
3405-000,2016,1,3,22,235,275,510,600
3405-000,2016,1,3,23,164,231,395,510
3405-000,2016,1,3,24,88,161,249,395
3405-000,2016,1,4,1,53,99,152,249
3405-000,2016,1,4,2,39,74,113,152
3405-000,2016,1,4,3,34,41,75,113
3405-000,2016,1,4,4,38,62,100,75
3405-000,2016,1,4,5,73,93,166,100
3405-000,2016,1,4,6,222,221,443,166
3405-000,2016,1,4,7,530,521,1051,443
3405-000,2016,1,4,8,970,1376,2346,1051
3405-000,2016,1,4,9,1148,1143,2291,2346
3405-000,2016,1,4,10,912,777,1689,2291
3405-000,2016,1,4,11,923,864,1787,1689
3405-000,2016,1,4,12,903,881,1784,1787
3405-000,2016,1,4,13,785,740,1525,1784
3405-000,2016,1,4,14,862,918,1780,1525
3405-000,2016,1,4,15,1008,964,1972,1780
3405-000,2016,1,4,16,915,922,1837,1972
3405-000,2016,1,4,17,931,855,1786,1837
3405-000,2016,1,4,18,1027,841,1868,1786
3405-000,2016,1,4,19,916,892,1808,1868
3405-000,2016,1,4,20,650,528,1178,1808
3405-000,2016,1,4,21,450,463,913,1178
3405-000,2016,1,4,22,306,327,633,913
3405-000,2016,1,4,23,199,200,399,633
3405-000,2016,1,4,24,109,143,252,399
3405-000,2016,1,5,1,81,101,182,252
3405-000,2016,1,5,2,58,66,124,182
3405-000,2016,1,5,3,39,68,107,124
3405-000,2016,1,5,4,51,85,136,107
3405-000,2016,1,5,5,80,95,175,136
3405-000,2016,1,5,6,180,189,369,175
3405-000,2016,1,5,7,450,382,832,369
3405-000,2016,1,5,8,967,1132,2099,832
3405-000,2016,1,5,9,1228,1126,2354,2099
3405-000,2016,1,5,10,958,827,1785,2354
3405-000,2016,1,5,11,1033,885,1918,1785
3405-000,2016,1,5,12,954,930,1884,1918
3405-000,2016,1,5,13,831,751,1582,1884
3405-000,2016,1,5,14,943,872,1815,1582
3405-000,2016,1,5,15,1010,962,1972,1815
3405-000,2016,1,5,16,1094,860,1954,1972
3405-000,2016,1,5,17,1040,851,1891,1954
3405-000,2016,1,5,18,1049,916,1965,1891
3405-000,2016,1,5,19,889,872,1761,1965
3405-000,2016,1,5,20,632,540,1172,1761
3405-000,2016,1,5,21,442,498,940,1172
3405-000,2016,1,5,22,326,360,686,940
3405-000,2016,1,5,23,217,200,417,686
3405-000,2016,1,5,24,126,152,278,417
3405-000,2016,1,6,1,83,110,193,278
3405-000,2016,1,6,2,74,66,140,193
3405-000,2016,1,6,3,43,61,104,140
3405-000,2016,1,6,4,55,65,120,104
3405-000,2016,1,6,5,85,89,174,120
3405-000,2016,1,6,6,179,161,340,174
3405-000,2016,1,6,7,446,380,826,340
3405-000,2016,1,6,8,1003,1126,2129,826
3405-000,2016,1,6,9,1215,1120,2335,2129
3405-000,2016,1,6,10,1009,869,1878,2335
3405-000,2016,1,6,11,1044,917,1961,1878
3405-000,2016,1,6,12,926,935,1861,1961
3405-000,2016,1,6,13,861,744,1605,1861
3405-000,2016,1,6,14,878,877,1755,1605
3405-000,2016,1,6,15,1090,966,2056,1755
3405-000,2016,1,6,16,1070,863,1933,2056
3405-000,2016,1,6,17,995,855,1850,1933
3405-000,2016,1,6,18,1090,1036,2126,1850
3405-000,2016,1,6,19,1032,928,1960,2126
3405-000,2016,1,6,20,617,544,1161,1960
3405-000,2016,1,6,21,508,464,972,1161
3405-000,2016,1,6,22,313,315,628,972
3405-000,2016,1,6,23,192,173,365,628
3405-000,2016,1,6,24,118,146,264,365
3405-000,2016,1,7,1,66,104,170,264
3405-000,2016,1,7,2,54,61,115,170
3405-000,2016,1,7,3,44,53,97,115
3405-000,2016,1,7,4,37,66,103,97
3405-000,2016,1,7,5,81,88,169,103
3405-000,2016,1,7,6,190,168,358,169
3405-000,2016,1,7,7,440,380,820,358
3405-000,2016,1,7,8,912,1083,1995,820
3405-000,2016,1,7,9,1178,1122,2300,1995
3405-000,2016,1,7,10,976,813,1789,2300
3405-000,2016,1,7,11,1038,902,1940,1789
3405-000,2016,1,7,12,876,865,1741,1940
3405-000,2016,1,7,13,792,760,1552,1741
3405-000,2016,1,7,14,998,847,1845,1552
3405-000,2016,1,7,15,1048,967,2015,1845
3405-000,2016,1,7,16,1076,934,2010,2015
3405-000,2016,1,7,17,981,888,1869,2010
3405-000,2016,1,7,18,1014,914,1928,1869
3405-000,2016,1,7,19,932,839,1771,1928
3405-000,2016,1,7,20,602,511,1113,1771
3405-000,2016,1,7,21,489,476,965,1113
3405-000,2016,1,7,22,355,334,689,965
3405-000,2016,1,7,23,204,225,429,689
3405-000,2016,1,7,24,129,138,267,429
3405-000,2016,1,8,1,64,118,182,267
3405-000,2016,1,8,2,47,75,122,182
3405-000,2016,1,8,3,57,55,112,122
3405-000,2016,1,8,4,47,59,106,112
3405-000,2016,1,8,5,75,106,181,106
3405-000,2016,1,8,6,193,174,367,181
3405-000,2016,1,8,7,380,371,751,367
3405-000,2016,1,8,8,937,1097,2034,751
3405-000,2016,1,8,9,1186,1056,2242,2034
3405-000,2016,1,8,10,1021,893,1914,2242
3405-000,2016,1,8,11,1069,936,2005,1914
3405-000,2016,1,8,12,993,933,1926,2005
3405-000,2016,1,8,13,859,837,1696,1926
3405-000,2016,1,8,14,948,998,1946,1696
3405-000,2016,1,8,15,1083,988,2071,1946
3405-000,2016,1,8,16,1066,930,1996,2071
3405-000,2016,1,8,17,1089,904,1993,1996
3405-000,2016,1,8,18,1228,996,2224,1993
3405-000,2016,1,8,19,1210,954,2164,2224
3405-000,2016,1,8,20,743,626,1369,2164
3405-000,2016,1,8,21,571,497,1068,1369
3405-000,2016,1,8,22,368,320,688,1068
3405-000,2016,1,8,23,240,216,456,688
3405-000,2016,1,8,24,156,164,320,456
3405-000,2016,1,9,1,110,105,215,320
3405-000,2016,1,9,2,67,81,148,215
3405-000,2016,1,9,3,59,58,117,148
3405-000,2016,1,9,4,53,64,117,117
3405-000,2016,1,9,5,72,80,152,117
3405-000,2016,1,9,6,140,138,278,152
3405-000,2016,1,9,7,322,258,580,278
3405-000,2016,1,9,8,618,486,1104,580
3405-000,2016,1,9,9,780,584,1364,1104
3405-000,2016,1,9,10,713,633,1346,1364
3405-000,2016,1,9,11,808,649,1457,1346
3405-000,2016,1,9,12,726,673,1399,1457
3405-000,2016,1,9,13,668,628,1296,1399
3405-000,2016,1,9,14,653,629,1282,1296
3405-000,2016,1,9,15,740,660,1400,1282
3405-000,2016,1,9,16,745,609,1354,1400
3405-000,2016,1,9,17,768,652,1420,1354
3405-000,2016,1,9,18,829,789,1618,1420
3405-000,2016,1,9,19,622,528,1150,1618
3405-000,2016,1,9,20,400,371,771,1150
3405-000,2016,1,9,21,312,276,588,771
3405-000,2016,1,9,22,233,221,454,588
3405-000,2016,1,9,23,181,154,335,454
3405-000,2016,1,9,24,106,136,242,335
3405-000,2016,1,10,1,77,78,155,242
3405-000,2016,1,10,2,42,63,105,155
3405-000,2016,1,10,3,33,33,66,105
3405-000,2016,1,10,4,26,36,62,66
3405-000,2016,1,10,5,34,48,82,62
3405-000,2016,1,10,6,65,61,126,82
3405-000,2016,1,10,7,124,118,242,126
3405-000,2016,1,10,8,225,184,409,242
3405-000,2016,1,10,9,354,246,600,409
3405-000,2016,1,10,10,369,260,629,600
3405-000,2016,1,10,11,433,336,769,629
3405-000,2016,1,10,12,414,424,838,769
3405-000,2016,1,10,13,420,440,860,838
3405-000,2016,1,10,14,448,457,905,860
3405-000,2016,1,10,15,521,515,1036,905
3405-000,2016,1,10,16,497,626,1123,1036
3405-000,2016,1,10,17,500,599,1099,1123
3405-000,2016,1,10,18,517,592,1109,1099
3405-000,2016,1,10,19,424,460,884,1109
3405-000,2016,1,10,20,309,387,696,884
3405-000,2016,1,10,21,293,289,582,696
3405-000,2016,1,10,22,202,298,500,582
3405-000,2016,1,10,23,137,224,361,500
3405-000,2016,1,10,24,102,128,230,361
3405-000,2016,1,11,1,72,99,171,230
3405-000,2016,1,11,2,39,58,97,171
3405-000,2016,1,11,3,30,41,71,97
3405-000,2016,1,11,4,34,59,93,71
3405-000,2016,1,11,5,50,77,127,93
3405-000,2016,1,11,6,184,189,373,127
3405-000,2016,1,11,7,495,505,1000,373
3405-000,2016,1,11,8,1031,1327,2358,1000
3405-000,2016,1,11,9,1215,1191,2406,2358
3405-000,2016,1,11,10,919,822,1741,2406
3405-000,2016,1,11,11,938,919,1857,1741
3405-000,2016,1,11,12,903,835,1738,1857
3405-000,2016,1,11,13,796,765,1561,1738
3405-000,2016,1,11,14,833,935,1768,1561
3405-000,2016,1,11,15,992,935,1927,1768
3405-000,2016,1,11,16,995,911,1906,1927
3405-000,2016,1,11,17,968,867,1835,1906
3405-000,2016,1,11,18,1015,891,1906,1835
3405-000,2016,1,11,19,893,884,1777,1906
3405-000,2016,1,11,20,607,578,1185,1777
3405-000,2016,1,11,21,507,548,1055,1185
3405-000,2016,1,11,22,339,336,675,1055
3405-000,2016,1,11,23,202,209,411,675
3405-000,2016,1,11,24,114,141,255,411
3405-000,2016,1,12,1,77,75,152,255
3405-000,2016,1,12,2,49,65,114,152
3405-000,2016,1,12,3,41,56,97,114
3405-000,2016,1,12,4,51,66,117,97
3405-000,2016,1,12,5,85,86,171,117
3405-000,2016,1,12,6,190,163,353,171
3405-000,2016,1,12,7,451,379,830,353
3405-000,2016,1,12,8,985,1136,2121,830
3405-000,2016,1,12,9,1205,1194,2399,2121
3405-000,2016,1,12,10,984,910,1894,2399
3405-000,2016,1,12,11,1074,953,2027,1894
3405-000,2016,1,12,12,977,941,1918,2027
3405-000,2016,1,12,13,881,804,1685,1918
3405-000,2016,1,12,14,913,966,1879,1685
3405-000,2016,1,12,15,1043,1001,2044,1879
3405-000,2016,1,12,16,1041,913,1954,2044
3405-000,2016,1,12,17,993,873,1866,1954
3405-000,2016,1,12,18,1078,911,1989,1866
3405-000,2016,1,12,19,920,864,1784,1989
3405-000,2016,1,12,20,615,554,1169,1784
3405-000,2016,1,12,21,506,513,1019,1169
3405-000,2016,1,12,22,324,331,655,1019
3405-000,2016,1,12,23,233,238,471,655
3405-000,2016,1,12,24,123,164,287,471
3405-000,2016,1,13,1,77,108,185,287
3405-000,2016,1,13,2,53,89,142,185
3405-000,2016,1,13,3,31,35,66,142
3405-000,2016,1,13,4,45,68,113,66
3405-000,2016,1,13,5,47,73,120,113
3405-000,2016,1,13,6,92,155,247,120
3405-000,2016,1,13,7,243,339,582,247
3405-000,2016,1,13,8,581,970,1551,582
3405-000,2016,1,13,9,699,1143,1842,1551
3405-000,2016,1,13,10,686,800,1486,1842
3405-000,2016,1,13,11,958,799,1757,1486
3405-000,2016,1,13,12,911,817,1728,1757
3405-000,2016,1,13,13,754,721,1475,1728
3405-000,2016,1,13,14,897,825,1722,1475
3405-000,2016,1,13,15,1068,850,1918,1722
3405-000,2016,1,13,16,1026,888,1914,1918
3405-000,2016,1,13,17,948,800,1748,1914
3405-000,2016,1,13,18,1082,871,1953,1748
3405-000,2016,1,13,19,970,783,1753,1953
3405-000,2016,1,13,20,531,466,997,1753
3405-000,2016,1,13,21,388,397,785,997
3405-000,2016,1,13,22,258,294,552,785
3405-000,2016,1,13,23,160,169,329,552
3405-000,2016,1,13,24,99,123,222,329
3405-000,2016,1,14,1,77,90,167,222
3405-000,2016,1,14,2,48,63,111,167
3405-000,2016,1,14,3,41,46,87,111
3405-000,2016,1,14,4,49,67,116,87
3405-000,2016,1,14,5,87,70,157,116
3405-000,2016,1,14,6,144,122,266,157
3405-000,2016,1,14,7,422,322,744,266
3405-000,2016,1,14,8,850,965,1815,744
3405-000,2016,1,14,9,1091,1049,2140,1815
3405-000,2016,1,14,10,866,808,1674,2140
3405-000,2016,1,14,11,983,916,1899,1674
3405-000,2016,1,14,12,922,863,1785,1899
3405-000,2016,1,14,13,829,706,1535,1785
3405-000,2016,1,14,14,949,825,1774,1535
3405-000,2016,1,14,15,1061,879,1940,1774
3405-000,2016,1,14,16,1032,861,1893,1940
3405-000,2016,1,14,17,1004,810,1814,1893
3405-000,2016,1,14,18,1034,851,1885,1814
3405-000,2016,1,14,19,887,747,1634,1885
3405-000,2016,1,14,20,582,439,1021,1634
3405-000,2016,1,14,21,478,420,898,1021
3405-000,2016,1,14,22,347,314,661,898
3405-000,2016,1,14,23,232,172,404,661
3405-000,2016,1,14,24,116,137,253,404
3405-000,2016,1,15,1,76,89,165,253
3405-000,2016,1,15,2,41,64,105,165
3405-000,2016,1,15,3,39,37,76,105
3405-000,2016,1,15,4,45,59,104,76
3405-000,2016,1,15,5,85,92,177,104
3405-000,2016,1,15,6,167,117,284,177
3405-000,2016,1,15,7,408,281,689,284
3405-000,2016,1,15,8,909,1094,2003,689
3405-000,2016,1,15,9,1177,1178,2355,2003
3405-000,2016,1,15,10,1039,918,1957,2355
3405-000,2016,1,15,11,1043,986,2029,1957
3405-000,2016,1,15,12,894,972,1866,2029
3405-000,2016,1,15,13,793,885,1678,1866
3405-000,2016,1,15,14,908,983,1891,1678
3405-000,2016,1,15,15,1075,994,2069,1891
3405-000,2016,1,15,16,1124,958,2082,2069
3405-000,2016,1,15,17,1125,950,2075,2082
3405-000,2016,1,15,18,1305,1060,2365,2075
3405-000,2016,1,15,19,1222,951,2173,2365
3405-000,2016,1,15,20,798,648,1446,2173
3405-000,2016,1,15,21,589,508,1097,1446
3405-000,2016,1,15,22,368,341,709,1097
3405-000,2016,1,15,23,264,229,493,709
3405-000,2016,1,15,24,186,176,362,493
3405-000,2016,1,16,1,88,112,200,362
3405-000,2016,1,16,2,65,70,135,200
3405-000,2016,1,16,3,49,47,96,135
3405-000,2016,1,16,4,54,72,126,96
3405-000,2016,1,16,5,84,76,160,126
3405-000,2016,1,16,6,166,130,296,160
3405-000,2016,1,16,7,319,272,591,296
3405-000,2016,1,16,8,597,503,1100,591
3405-000,2016,1,16,9,827,640,1467,1100
3405-000,2016,1,16,10,779,629,1408,1467
3405-000,2016,1,16,11,823,654,1477,1408
3405-000,2016,1,16,12,945,720,1665,1477
3405-000,2016,1,16,13,735,678,1413,1665
3405-000,2016,1,16,14,729,667,1396,1413
3405-000,2016,1,16,15,729,688,1417,1396
3405-000,2016,1,16,16,728,636,1364,1417
3405-000,2016,1,16,17,806,678,1484,1364
3405-000,2016,1,16,18,870,818,1688,1484
3405-000,2016,1,16,19,671,568,1239,1688
3405-000,2016,1,16,20,441,390,831,1239
3405-000,2016,1,16,21,310,293,603,831
3405-000,2016,1,16,22,241,224,465,603
3405-000,2016,1,16,23,173,150,323,465
3405-000,2016,1,16,24,107,126,233,323
3405-000,2016,1,17,1,53,87,140,233
3405-000,2016,1,17,2,50,28,78,140
3405-000,2016,1,17,3,38,28,66,78
3405-000,2016,1,17,4,28,34,62,66
3405-000,2016,1,17,5,40,49,89,62
3405-000,2016,1,17,6,80,48,128,89
3405-000,2016,1,17,7,142,109,251,128
3405-000,2016,1,17,8,230,190,420,251
3405-000,2016,1,17,9,352,251,603,420
3405-000,2016,1,17,10,389,282,671,603
3405-000,2016,1,17,11,493,362,855,671
3405-000,2016,1,17,12,424,377,801,855
3405-000,2016,1,17,13,406,399,805,801
3405-000,2016,1,17,14,458,415,873,805
3405-000,2016,1,17,15,524,451,975,873
3405-000,2016,1,17,16,553,497,1050,975
3405-000,2016,1,17,17,535,462,997,1050
3405-000,2016,1,17,18,461,433,894,997
3405-000,2016,1,17,19,427,391,818,894
3405-000,2016,1,17,20,316,287,603,818
3405-000,2016,1,17,21,251,279,530,603
3405-000,2016,1,17,22,237,230,467,530
3405-000,2016,1,17,23,137,199,336,467
3405-000,2016,1,17,24,80,129,209,336
3405-000,2016,1,18,1,60,86,146,209
3405-000,2016,1,18,2,32,71,103,146
3405-000,2016,1,18,3,22,48,70,103
3405-000,2016,1,18,4,39,64,103,70
3405-000,2016,1,18,5,90,95,185,103
3405-000,2016,1,18,6,205,208,413,185
3405-000,2016,1,18,7,517,501,1018,413
3405-000,2016,1,18,8,953,1220,2173,1018
3405-000,2016,1,18,9,1081,1191,2272,2173
3405-000,2016,1,18,10,870,776,1646,2272
3405-000,2016,1,18,11,954,898,1852,1646
3405-000,2016,1,18,12,930,900,1830,1852
3405-000,2016,1,18,13,807,752,1559,1830
3405-000,2016,1,18,14,815,926,1741,1559
3405-000,2016,1,18,15,994,950,1944,1741
3405-000,2016,1,18,16,959,916,1875,1944
3405-000,2016,1,18,17,985,861,1846,1875
3405-000,2016,1,18,18,938,866,1804,1846
3405-000,2016,1,18,19,1034,888,1922,1804
3405-000,2016,1,18,20,817,551,1368,1922
3405-000,2016,1,18,21,407,436,843,1368
3405-000,2016,1,18,22,261,308,569,843
3405-000,2016,1,18,23,191,174,365,569
3405-000,2016,1,18,24,121,119,240,365
3405-000,2016,1,19,1,75,91,166,240
3405-000,2016,1,19,2,51,60,111,166
3405-000,2016,1,19,3,43,47,90,111
3405-000,2016,1,19,4,50,56,106,90
3405-000,2016,1,19,5,69,70,139,106
3405-000,2016,1,19,6,137,88,225,139
3405-000,2016,1,19,7,373,239,612,225
3405-000,2016,1,19,8,801,1134,1935,612
3405-000,2016,1,19,9,1003,1160,2163,1935
3405-000,2016,1,19,10,804,868,1672,2163
3405-000,2016,1,19,11,867,919,1786,1672
3405-000,2016,1,19,12,761,936,1697,1786
3405-000,2016,1,19,13,717,778,1495,1697
3405-000,2016,1,19,14,847,919,1766,1495
3405-000,2016,1,19,15,924,982,1906,1766
3405-000,2016,1,19,16,961,886,1847,1906
3405-000,2016,1,19,17,909,862,1771,1847
3405-000,2016,1,19,18,939,914,1853,1771
3405-000,2016,1,19,19,865,868,1733,1853
3405-000,2016,1,19,20,546,547,1093,1733
3405-000,2016,1,19,21,442,506,948,1093
3405-000,2016,1,19,22,271,242,513,948
3405-000,2016,1,19,23,178,165,343,513
3405-000,2016,1,19,24,111,113,224,343
3405-000,2016,1,20,1,73,77,150,224
3405-000,2016,1,20,2,58,54,112,150
3405-000,2016,1,20,3,51,38,89,112
3405-000,2016,1,20,4,33,43,76,89
3405-000,2016,1,20,5,74,56,130,76
3405-000,2016,1,20,6,150,101,251,130
3405-000,2016,1,20,7,360,257,617,251
3405-000,2016,1,20,8,821,1048,1869,617
3405-000,2016,1,20,9,1142,1132,2274,1869
3405-000,2016,1,20,10,995,834,1829,2274
3405-000,2016,1,20,11,952,858,1810,1829
3405-000,2016,1,20,12,931,876,1807,1810
3405-000,2016,1,20,13,828,732,1560,1807
3405-000,2016,1,20,14,864,851,1715,1560
3405-000,2016,1,20,15,1117,908,2025,1715
3405-000,2016,1,20,16,1030,876,1906,2025
3405-000,2016,1,20,17,1007,828,1835,1906
3405-000,2016,1,20,18,1053,954,2007,1835
3405-000,2016,1,20,19,979,856,1835,2007
3405-000,2016,1,20,20,601,543,1144,1835
3405-000,2016,1,20,21,417,410,827,1144
3405-000,2016,1,20,22,319,330,649,827
3405-000,2016,1,20,23,206,164,370,649
3405-000,2016,1,20,24,125,125,250,370
3405-000,2016,1,21,1,83,86,169,250
3405-000,2016,1,21,2,48,65,113,169
3405-000,2016,1,21,3,56,45,101,113
3405-000,2016,1,21,4,57,41,98,101
3405-000,2016,1,21,5,61,78,139,98
3405-000,2016,1,21,6,153,138,291,139
3405-000,2016,1,21,7,390,335,725,291
3405-000,2016,1,21,8,892,1021,1913,725
3405-000,2016,1,21,9,1241,1095,2336,1913
3405-000,2016,1,21,10,1001,853,1854,2336
3405-000,2016,1,21,11,1017,959,1976,1854
3405-000,2016,1,21,12,951,941,1892,1976
3405-000,2016,1,21,13,811,765,1576,1892
3405-000,2016,1,21,14,905,949,1854,1576
3405-000,2016,1,21,15,1038,915,1953,1854
3405-000,2016,1,21,16,975,926,1901,1953
3405-000,2016,1,21,17,1024,880,1904,1901
3405-000,2016,1,21,18,1062,974,2036,1904
3405-000,2016,1,21,19,1015,854,1869,2036
3405-000,2016,1,21,20,625,551,1176,1869
3405-000,2016,1,21,21,471,490,961,1176
3405-000,2016,1,21,22,314,330,644,961
3405-000,2016,1,21,23,240,216,456,644
3405-000,2016,1,21,24,161,127,288,456
3405-000,2016,1,22,1,103,103,206,288
3405-000,2016,1,22,2,56,68,124,206
3405-000,2016,1,22,3,46,41,87,124
3405-000,2016,1,22,4,41,45,86,87
3405-000,2016,1,22,5,80,94,174,86
3405-000,2016,1,22,6,179,161,340,174
3405-000,2016,1,22,7,410,331,741,340
3405-000,2016,1,22,8,945,1005,1950,741
3405-000,2016,1,22,9,1219,1054,2273,1950
3405-000,2016,1,22,10,1002,786,1788,2273
3405-000,2016,1,22,11,1060,933,1993,1788
3405-000,2016,1,22,12,980,897,1877,1993
3405-000,2016,1,22,13,900,822,1722,1877
3405-000,2016,1,22,14,978,908,1886,1722
3405-000,2016,1,22,15,1092,1012,2104,1886
3405-000,2016,1,22,16,1161,957,2118,2104
3405-000,2016,1,22,17,1074,928,2002,2118
3405-000,2016,1,22,18,1212,989,2201,2002
3405-000,2016,1,22,19,1216,933,2149,2201
3405-000,2016,1,22,20,796,671,1467,2149
3405-000,2016,1,22,21,578,502,1080,1467
3405-000,2016,1,22,22,382,373,755,1080
3405-000,2016,1,22,23,289,216,505,755
3405-000,2016,1,22,24,151,147,298,505
3405-000,2016,1,23,1,106,107,213,298
3405-000,2016,1,23,2,50,70,120,213
3405-000,2016,1,23,3,64,68,132,120
3405-000,2016,1,23,4,58,54,112,132
3405-000,2016,1,23,5,70,88,158,112
3405-000,2016,1,23,6,145,112,257,158
3405-000,2016,1,23,7,315,218,533,257
3405-000,2016,1,23,8,608,494,1102,533
3405-000,2016,1,23,9,778,612,1390,1102
3405-000,2016,1,23,10,746,631,1377,1390
3405-000,2016,1,23,11,824,652,1476,1377
3405-000,2016,1,23,12,817,696,1513,1476
3405-000,2016,1,23,13,720,653,1373,1513
3405-000,2016,1,23,14,667,648,1315,1373
3405-000,2016,1,23,15,773,674,1447,1315
3405-000,2016,1,23,16,743,622,1365,1447
3405-000,2016,1,23,17,722,665,1387,1365
3405-000,2016,1,23,18,760,804,1564,1387
3405-000,2016,1,23,19,522,510,1032,1564
3405-000,2016,1,23,20,351,293,644,1032
3405-000,2016,1,23,21,249,228,477,644
3405-000,2016,1,23,22,192,156,348,477
3405-000,2016,1,23,23,145,130,275,348
3405-000,2016,1,23,24,113,121,234,275
3405-000,2016,1,24,1,55,64,119,234
3405-000,2016,1,24,2,37,33,70,119
3405-000,2016,1,24,3,29,28,57,70
3405-000,2016,1,24,4,26,32,58,57
3405-000,2016,1,24,5,18,21,39,58
3405-000,2016,1,24,6,40,40,80,39
3405-000,2016,1,24,7,89,60,149,80
3405-000,2016,1,24,8,123,136,259,149
3405-000,2016,1,24,9,203,181,384,259
3405-000,2016,1,24,10,236,198,434,384
3405-000,2016,1,24,11,335,258,593,434
3405-000,2016,1,24,12,306,294,600,593
3405-000,2016,1,24,13,323,311,634,600
3405-000,2016,1,24,14,349,372,721,634
3405-000,2016,1,24,15,383,454,837,721
3405-000,2016,1,24,16,461,452,913,837
3405-000,2016,1,24,17,377,445,822,913
3405-000,2016,1,24,18,365,470,835,822
3405-000,2016,1,24,19,290,304,594,835
3405-000,2016,1,24,20,218,283,501,594
3405-000,2016,1,24,21,156,231,387,501
3405-000,2016,1,24,22,153,196,349,387
3405-000,2016,1,24,23,124,168,292,349
3405-000,2016,1,24,24,67,110,177,292
3405-000,2016,1,25,1,37,65,102,177
3405-000,2016,1,25,2,26,46,72,102
3405-000,2016,1,25,3,31,36,67,72
3405-000,2016,1,25,4,33,51,84,67
3405-000,2016,1,25,5,49,61,110,84
3405-000,2016,1,25,6,161,162,323,110
3405-000,2016,1,25,7,407,386,793,323
3405-000,2016,1,25,8,872,1037,1909,793
3405-000,2016,1,25,9,1012,1077,2089,1909
3405-000,2016,1,25,10,763,672,1435,2089
3405-000,2016,1,25,11,840,747,1587,1435
3405-000,2016,1,25,12,857,763,1620,1587
3405-000,2016,1,25,13,797,724,1521,1620
3405-000,2016,1,25,14,844,814,1658,1521
3405-000,2016,1,25,15,985,860,1845,1658
3405-000,2016,1,25,16,897,855,1752,1845
3405-000,2016,1,25,17,894,794,1688,1752
3405-000,2016,1,25,18,994,888,1882,1688
3405-000,2016,1,25,19,826,816,1642,1882
3405-000,2016,1,25,20,615,565,1180,1642
3405-000,2016,1,25,21,501,490,991,1180
3405-000,2016,1,25,22,325,322,647,991
3405-000,2016,1,25,23,203,196,399,647
3405-000,2016,1,25,24,105,135,240,399
3405-000,2016,1,26,1,85,102,187,240
3405-000,2016,1,26,2,54,72,126,187
3405-000,2016,1,26,3,37,60,97,126
3405-000,2016,1,26,4,57,65,122,97
3405-000,2016,1,26,5,77,84,161,122
3405-000,2016,1,26,6,178,152,330,161
3405-000,2016,1,26,7,364,304,668,330
3405-000,2016,1,26,8,844,1051,1895,668
3405-000,2016,1,26,9,1200,1118,2318,1895
3405-000,2016,1,26,10,929,808,1737,2318
3405-000,2016,1,26,11,905,878,1783,1737
3405-000,2016,1,26,12,955,860,1815,1783
3405-000,2016,1,26,13,798,737,1535,1815
3405-000,2016,1,26,14,905,905,1810,1535
3405-000,2016,1,26,15,1017,930,1947,1810
3405-000,2016,1,26,16,1052,914,1966,1947
3405-000,2016,1,26,17,1037,877,1914,1966
3405-000,2016,1,26,18,979,938,1917,1914
3405-000,2016,1,26,19,949,843,1792,1917
3405-000,2016,1,26,20,620,612,1232,1792
3405-000,2016,1,26,21,469,484,953,1232
3405-000,2016,1,26,22,339,340,679,953
3405-000,2016,1,26,23,236,205,441,679
3405-000,2016,1,26,24,118,140,258,441
3405-000,2016,1,27,1,100,96,196,258
3405-000,2016,1,27,2,61,103,164,196
3405-000,2016,1,27,3,38,65,103,164
3405-000,2016,1,27,4,46,64,110,103
3405-000,2016,1,27,5,82,70,152,110
3405-000,2016,1,27,6,173,175,348,152
3405-000,2016,1,27,7,442,365,807,348
3405-000,2016,1,27,8,949,1089,2038,807
3405-000,2016,1,27,9,1179,1112,2291,2038
3405-000,2016,1,27,10,1027,803,1830,2291
3405-000,2016,1,27,11,986,884,1870,1830
3405-000,2016,1,27,12,950,861,1811,1870
3405-000,2016,1,27,13,866,787,1653,1811
3405-000,2016,1,27,14,903,902,1805,1653
3405-000,2016,1,27,15,1071,999,2070,1805
3405-000,2016,1,27,16,1062,894,1956,2070
3405-000,2016,1,27,17,1017,958,1975,1956
3405-000,2016,1,27,18,1142,1004,2146,1975
3405-000,2016,1,27,19,1010,924,1934,2146
3405-000,2016,1,27,20,616,566,1182,1934
3405-000,2016,1,27,21,436,446,882,1182
3405-000,2016,1,27,22,331,292,623,882
3405-000,2016,1,27,23,247,206,453,623
3405-000,2016,1,27,24,127,141,268,453
3405-000,2016,1,28,1,104,88,192,268
3405-000,2016,1,28,2,66,89,155,192
3405-000,2016,1,28,3,37,62,99,155
3405-000,2016,1,28,4,53,71,124,99
3405-000,2016,1,28,5,85,90,175,124
3405-000,2016,1,28,6,178,177,355,175
3405-000,2016,1,28,7,438,399,837,355
3405-000,2016,1,28,8,996,1123,2119,837
3405-000,2016,1,28,9,1208,1044,2252,2119
3405-000,2016,1,28,10,1035,807,1842,2252
3405-000,2016,1,28,11,1024,939,1963,1842
3405-000,2016,1,28,12,1040,880,1920,1963
3405-000,2016,1,28,13,831,806,1637,1920
3405-000,2016,1,28,14,954,909,1863,1637
3405-000,2016,1,28,15,1096,962,2058,1863
3405-000,2016,1,28,16,1073,937,2010,2058
3405-000,2016,1,28,17,1037,890,1927,2010
3405-000,2016,1,28,18,1065,970,2035,1927
3405-000,2016,1,28,19,916,894,1810,2035
3405-000,2016,1,28,20,631,543,1174,1810
3405-000,2016,1,28,21,540,479,1019,1174
3405-000,2016,1,28,22,335,348,683,1019
3405-000,2016,1,28,23,259,185,444,683
3405-000,2016,1,28,24,129,146,275,444
3405-000,2016,1,29,1,99,115,214,275
3405-000,2016,1,29,2,70,83,153,214
3405-000,2016,1,29,3,48,51,99,153
3405-000,2016,1,29,4,50,59,109,99
3405-000,2016,1,29,5,98,76,174,109
3405-000,2016,1,29,6,191,151,342,174
3405-000,2016,1,29,7,432,372,804,342
3405-000,2016,1,29,8,929,1079,2008,804
3405-000,2016,1,29,9,1218,1085,2303,2008
3405-000,2016,1,29,10,956,838,1794,2303
3405-000,2016,1,29,11,1029,903,1932,1794
3405-000,2016,1,29,12,989,817,1806,1932
3405-000,2016,1,29,13,838,798,1636,1806
3405-000,2016,1,29,14,992,890,1882,1636
3405-000,2016,1,29,15,1050,907,1957,1882
3405-000,2016,1,29,16,1086,924,2010,1957
3405-000,2016,1,29,17,1100,913,2013,2010
3405-000,2016,1,29,18,1237,985,2222,2013
3405-000,2016,1,29,19,1204,1123,2327,2222
3405-000,2016,1,29,20,839,710,1549,2327
3405-000,2016,1,29,21,591,529,1120,1549
3405-000,2016,1,29,22,363,363,726,1120
3405-000,2016,1,29,23,268,220,488,726
3405-000,2016,1,29,24,162,149,311,488
3405-000,2016,1,30,1,106,113,219,311
3405-000,2016,1,30,2,71,75,146,219
3405-000,2016,1,30,3,63,58,121,146
3405-000,2016,1,30,4,57,74,131,121
3405-000,2016,1,30,5,87,86,173,131
3405-000,2016,1,30,6,153,129,282,173
3405-000,2016,1,30,7,304,255,559,282
3405-000,2016,1,30,8,649,525,1174,559
3405-000,2016,1,30,9,776,615,1391,1174
3405-000,2016,1,30,10,830,563,1393,1391
3405-000,2016,1,30,11,915,663,1578,1393
3405-000,2016,1,30,12,796,738,1534,1578
3405-000,2016,1,30,13,812,797,1609,1534
3405-000,2016,1,30,14,877,730,1607,1609
3405-000,2016,1,30,15,853,670,1523,1607
3405-000,2016,1,30,16,784,668,1452,1523
3405-000,2016,1,30,17,829,664,1493,1452
3405-000,2016,1,30,18,919,807,1726,1493
3405-000,2016,1,30,19,626,606,1232,1726
3405-000,2016,1,30,20,421,448,869,1232
3405-000,2016,1,30,21,329,293,622,869
3405-000,2016,1,30,22,255,270,525,622
3405-000,2016,1,30,23,191,178,369,525
3405-000,2016,1,30,24,109,132,241,369
3405-000,2016,1,31,1,69,80,149,241
3405-000,2016,1,31,2,45,53,98,149
3405-000,2016,1,31,3,47,27,74,98
3405-000,2016,1,31,4,28,33,61,74
3405-000,2016,1,31,5,39,42,81,61
3405-000,2016,1,31,6,99,75,174,81
3405-000,2016,1,31,7,159,131,290,174
3405-000,2016,1,31,8,283,217,500,290
3405-000,2016,1,31,9,347,297,644,500
3405-000,2016,1,31,10,452,310,762,644
3405-000,2016,1,31,11,501,386,887,762
3405-000,2016,1,31,12,466,487,953,887
3405-000,2016,1,31,13,472,497,969,953
3405-000,2016,1,31,14,513,532,1045,969
3405-000,2016,1,31,15,560,587,1147,1045
3405-000,2016,1,31,16,578,561,1139,1147
3405-000,2016,1,31,17,545,557,1102,1139
3405-000,2016,1,31,18,523,618,1141,1102
3405-000,2016,1,31,19,450,475,925,1141
3405-000,2016,1,31,20,352,368,720,925
3405-000,2016,1,31,21,269,303,572,720
3405-000,2016,1,31,22,215,280,495,572
3405-000,2016,1,31,23,158,211,369,495
3405-000,2016,1,31,24,99,147,246,369
3405-000,2016,2,1,1,62,80,142,246
3405-000,2016,2,1,2,48,49,97,142
3405-000,2016,2,1,3,42,49,91,97
3405-000,2016,2,1,4,44,55,99,91
3405-000,2016,2,1,5,84,84,168,99
3405-000,2016,2,1,6,218,208,426,168
3405-000,2016,2,1,7,527,477,1004,426
3405-000,2016,2,1,8,1056,1282,2338,1004
3405-000,2016,2,1,9,1189,1192,2381,2338
3405-000,2016,2,1,10,960,798,1758,2381
3405-000,2016,2,1,11,1104,853,1957,1758
3405-000,2016,2,1,12,973,917,1890,1957
3405-000,2016,2,1,13,809,765,1574,1890
3405-000,2016,2,1,14,959,931,1890,1574
3405-000,2016,2,1,15,1046,951,1997,1890
3405-000,2016,2,1,16,1017,937,1954,1997
3405-000,2016,2,1,17,1010,897,1907,1954
3405-000,2016,2,1,18,1068,874,1942,1907
3405-000,2016,2,1,19,941,854,1795,1942
3405-000,2016,2,1,20,630,547,1177,1795
3405-000,2016,2,1,21,538,495,1033,1177
3405-000,2016,2,1,22,331,317,648,1033
3405-000,2016,2,1,23,220,226,446,648
3405-000,2016,2,1,24,130,154,284,446
3405-000,2016,2,2,1,101,94,195,284
3405-000,2016,2,2,2,47,60,107,195
3405-000,2016,2,2,3,56,62,118,107
3405-000,2016,2,2,4,42,76,118,118
3405-000,2016,2,2,5,108,91,199,118
3405-000,2016,2,2,6,200,155,355,199
3405-000,2016,2,2,7,454,381,835,355
3405-000,2016,2,2,8,1043,1122,2165,835
3405-000,2016,2,2,9,1212,1128,2340,2165
3405-000,2016,2,2,10,1069,826,1895,2340
3405-000,2016,2,2,11,1080,934,2014,1895
3405-000,2016,2,2,12,1043,877,1920,2014
3405-000,2016,2,2,13,865,777,1642,1920
3405-000,2016,2,2,14,977,941,1918,1642
3405-000,2016,2,2,15,1149,1047,2196,1918
3405-000,2016,2,2,16,1131,997,2128,2196
3405-000,2016,2,2,17,1096,1019,2115,2128
3405-000,2016,2,2,18,1161,968,2129,2115
3405-000,2016,2,2,19,991,874,1865,2129
3405-000,2016,2,2,20,655,575,1230,1865
3405-000,2016,2,2,21,510,528,1038,1230
3405-000,2016,2,2,22,371,322,693,1038
3405-000,2016,2,2,23,284,219,503,693
3405-000,2016,2,2,24,110,167,277,503
3405-000,2016,2,3,1,80,123,203,277
3405-000,2016,2,3,2,74,76,150,203
3405-000,2016,2,3,3,54,58,112,150
3405-000,2016,2,3,4,47,56,103,112
3405-000,2016,2,3,5,76,82,158,103
3405-000,2016,2,3,6,203,169,372,158
3405-000,2016,2,3,7,434,346,780,372
3405-000,2016,2,3,8,973,1110,2083,780
3405-000,2016,2,3,9,1214,1066,2280,2083
3405-000,2016,2,3,10,967,872,1839,2280
3405-000,2016,2,3,11,1135,956,2091,1839
3405-000,2016,2,3,12,1033,972,2005,2091
3405-000,2016,2,3,13,929,837,1766,2005
3405-000,2016,2,3,14,956,1034,1990,1766
3405-000,2016,2,3,15,1178,1092,2270,1990
3405-000,2016,2,3,16,1095,1038,2133,2270
3405-000,2016,2,3,17,1146,994,2140,2133
3405-000,2016,2,3,18,1274,1040,2314,2140
3405-000,2016,2,3,19,1150,974,2124,2314
3405-000,2016,2,3,20,709,623,1332,2124
3405-000,2016,2,3,21,504,476,980,1332
3405-000,2016,2,3,22,389,384,773,980
3405-000,2016,2,3,23,267,213,480,773
3405-000,2016,2,3,24,134,149,283,480
3405-000,2016,2,4,1,97,115,212,283
3405-000,2016,2,4,2,66,65,131,212
3405-000,2016,2,4,3,51,56,107,131
3405-000,2016,2,4,4,48,75,123,107
3405-000,2016,2,4,5,75,98,173,123
3405-000,2016,2,4,6,192,186,378,173
3405-000,2016,2,4,7,399,389,788,378
3405-000,2016,2,4,8,980,1121,2101,788
3405-000,2016,2,4,9,1182,1263,2445,2101
3405-000,2016,2,4,10,1111,935,2046,2445
3405-000,2016,2,4,11,1092,1043,2135,2046
3405-000,2016,2,4,12,1038,1098,2136,2135
3405-000,2016,2,4,13,934,903,1837,2136
3405-000,2016,2,4,14,1049,1018,2067,1837
3405-000,2016,2,4,15,1250,1128,2378,2067
3405-000,2016,2,4,16,1216,1059,2275,2378
3405-000,2016,2,4,17,1194,1032,2226,2275
3405-000,2016,2,4,18,1215,1032,2247,2226
3405-000,2016,2,4,19,1026,888,1914,2247
3405-000,2016,2,4,20,715,576,1291,1914
3405-000,2016,2,4,21,576,496,1072,1291
3405-000,2016,2,4,22,434,349,783,1072
3405-000,2016,2,4,23,280,227,507,783
3405-000,2016,2,4,24,155,153,308,507
3405-000,2016,2,5,1,113,115,228,308
3405-000,2016,2,5,2,65,95,160,228
3405-000,2016,2,5,3,62,70,132,160
3405-000,2016,2,5,4,57,80,137,132
3405-000,2016,2,5,5,92,101,193,137
3405-000,2016,2,5,6,186,179,365,193
3405-000,2016,2,5,7,412,362,774,365
3405-000,2016,2,5,8,984,1075,2059,774
3405-000,2016,2,5,9,1230,1121,2351,2059
3405-000,2016,2,5,10,1033,863,1896,2351
3405-000,2016,2,5,11,1033,1086,2119,1896
3405-000,2016,2,5,12,1067,946,2013,2119
3405-000,2016,2,5,13,970,831,1801,2013
3405-000,2016,2,5,14,988,947,1935,1801
3405-000,2016,2,5,15,1223,1128,2351,1935
3405-000,2016,2,5,16,1117,1039,2156,2351
3405-000,2016,2,5,17,1237,1005,2242,2156
3405-000,2016,2,5,18,1230,1146,2376,2242
3405-000,2016,2,5,19,1072,944,2016,2376
3405-000,2016,2,5,20,662,622,1284,2016
3405-000,2016,2,5,21,469,412,881,1284
3405-000,2016,2,5,22,377,280,657,881
3405-000,2016,2,5,23,268,177,445,657
3405-000,2016,2,5,24,174,142,316,445
3405-000,2016,2,6,1,105,107,212,316
3405-000,2016,2,6,2,87,65,152,212
3405-000,2016,2,6,3,65,46,111,152
3405-000,2016,2,6,4,65,69,134,111
3405-000,2016,2,6,5,90,69,159,134
3405-000,2016,2,6,6,148,134,282,159
3405-000,2016,2,6,7,220,215,435,282
3405-000,2016,2,6,8,396,360,756,435
3405-000,2016,2,6,9,542,472,1014,756
3405-000,2016,2,6,10,566,566,1132,1014
3405-000,2016,2,6,11,674,717,1391,1132
3405-000,2016,2,6,12,663,841,1504,1391
3405-000,2016,2,6,13,595,603,1198,1504
3405-000,2016,2,6,14,639,604,1243,1198
3405-000,2016,2,6,15,664,690,1354,1243
3405-000,2016,2,6,16,607,708,1315,1354
3405-000,2016,2,6,17,609,535,1144,1315
3405-000,2016,2,6,18,589,537,1126,1144
3405-000,2016,2,6,19,425,380,805,1126
3405-000,2016,2,6,20,297,301,598,805
3405-000,2016,2,6,21,228,209,437,598
3405-000,2016,2,6,22,215,152,367,437
3405-000,2016,2,6,23,140,126,266,367
3405-000,2016,2,6,24,83,98,181,266
3405-000,2016,2,7,1,64,53,117,181
3405-000,2016,2,7,2,56,40,96,117
3405-000,2016,2,7,3,42,29,71,96
3405-000,2016,2,7,4,41,28,69,71
3405-000,2016,2,7,5,59,39,98,69
3405-000,2016,2,7,6,89,58,147,98
3405-000,2016,2,7,7,142,126,268,147
3405-000,2016,2,7,8,227,195,422,268
3405-000,2016,2,7,9,366,262,628,422
3405-000,2016,2,7,10,442,293,735,628
3405-000,2016,2,7,11,593,382,975,735
3405-000,2016,2,7,12,591,500,1091,975
3405-000,2016,2,7,13,543,486,1029,1091
3405-000,2016,2,7,14,507,381,888,1029
3405-000,2016,2,7,15,446,386,832,888
3405-000,2016,2,7,16,449,370,819,832
3405-000,2016,2,7,17,420,334,754,819
3405-000,2016,2,7,18,390,327,717,754
3405-000,2016,2,7,19,271,237,508,717
3405-000,2016,2,7,20,232,220,452,508
3405-000,2016,2,7,21,208,161,369,452
3405-000,2016,2,7,22,148,140,288,369
3405-000,2016,2,7,23,97,90,187,288
3405-000,2016,2,7,24,68,64,132,187
3405-000,2016,2,8,1,44,41,85,132
3405-000,2016,2,8,2,23,35,58,85
3405-000,2016,2,8,3,12,17,29,58
3405-000,2016,2,8,4,28,15,43,29
3405-000,2016,2,8,5,29,15,44,43
3405-000,2016,2,8,6,83,51,134,44
3405-000,2016,2,8,7,230,120,350,134
3405-000,2016,2,8,8,354,249,603,350
3405-000,2016,2,8,9,340,219,559,603
3405-000,2016,2,8,10,467,248,715,559
3405-000,2016,2,8,11,802,409,1211,715
3405-000,2016,2,8,12,1056,628,1684,1211
3405-000,2016,2,8,13,1017,682,1699,1684
3405-000,2016,2,8,14,1062,704,1766,1699
3405-000,2016,2,8,15,1282,777,2059,1766
3405-000,2016,2,8,16,1422,875,2297,2059
3405-000,2016,2,8,17,1338,961,2299,2297
3405-000,2016,2,8,18,1438,856,2294,2299
3405-000,2016,2,8,19,960,638,1598,2294
3405-000,2016,2,8,20,713,519,1232,1598
3405-000,2016,2,8,21,751,383,1134,1232
3405-000,2016,2,8,22,625,309,934,1134
3405-000,2016,2,8,23,385,211,596,934
3405-000,2016,2,8,24,181,141,322,596
3405-000,2016,2,9,1,86,133,219,322
3405-000,2016,2,9,2,50,88,138,219
3405-000,2016,2,9,3,36,33,69,138
3405-000,2016,2,9,4,23,23,46,69
3405-000,2016,2,9,5,38,32,70,46
3405-000,2016,2,9,6,39,39,78,70
3405-000,2016,2,9,7,81,80,161,78
3405-000,2016,2,9,8,302,124,426,161
3405-000,2016,2,9,9,678,201,879,426
3405-000,2016,2,9,10,367,287,654,879
3405-000,2016,2,9,11,509,402,911,654
3405-000,2016,2,9,12,653,497,1150,911
3405-000,2016,2,9,13,691,517,1208,1150
3405-000,2016,2,9,14,778,524,1302,1208
3405-000,2016,2,9,15,873,582,1455,1302
3405-000,2016,2,9,16,1357,539,1896,1455
3405-000,2016,2,9,17,1057,615,1672,1896
3405-000,2016,2,9,18,973,534,1507,1672
3405-000,2016,2,9,19,904,442,1346,1507
3405-000,2016,2,9,20,692,441,1133,1346
3405-000,2016,2,9,21,661,345,1006,1133
3405-000,2016,2,9,22,502,302,804,1006
3405-000,2016,2,9,23,419,226,645,804
3405-000,2016,2,9,24,269,138,407,645
3405-000,2016,2,10,1,86,114,200,407
3405-000,2016,2,10,2,49,78,127,200
3405-000,2016,2,10,3,42,37,79,127
3405-000,2016,2,10,4,34,32,66,79
3405-000,2016,2,10,5,43,37,80,66
3405-000,2016,2,10,6,64,58,122,80
3405-000,2016,2,10,7,176,115,291,122
3405-000,2016,2,10,8,325,272,597,291
3405-000,2016,2,10,9,426,309,735,597
3405-000,2016,2,10,10,423,302,725,735
3405-000,2016,2,10,11,497,378,875,725
3405-000,2016,2,10,12,484,509,993,875
3405-000,2016,2,10,13,491,488,979,993
3405-000,2016,2,10,14,501,568,1069,979
3405-000,2016,2,10,15,570,610,1180,1069
3405-000,2016,2,10,16,573,630,1203,1180
3405-000,2016,2,10,17,536,632,1168,1203
3405-000,2016,2,10,18,483,585,1068,1168
3405-000,2016,2,10,19,451,534,985,1068
3405-000,2016,2,10,20,334,384,718,985
3405-000,2016,2,10,21,279,365,644,718
3405-000,2016,2,10,22,219,273,492,644
3405-000,2016,2,10,23,161,228,389,492
3405-000,2016,2,10,24,93,134,227,389
3405-000,2016,2,11,1,60,102,162,227
3405-000,2016,2,11,2,59,64,123,162
3405-000,2016,2,11,3,47,40,87,123
3405-000,2016,2,11,4,38,65,103,87
3405-000,2016,2,11,5,62,89,151,103
3405-000,2016,2,11,6,205,176,381,151
3405-000,2016,2,11,7,444,441,885,381
3405-000,2016,2,11,8,970,1163,2133,885
3405-000,2016,2,11,9,1146,1119,2265,2133
3405-000,2016,2,11,10,887,766,1653,2265
3405-000,2016,2,11,11,956,808,1764,1653
3405-000,2016,2,11,12,824,800,1624,1764
3405-000,2016,2,11,13,728,742,1470,1624
3405-000,2016,2,11,14,862,873,1735,1470
3405-000,2016,2,11,15,980,856,1836,1735
3405-000,2016,2,11,16,977,893,1870,1836
3405-000,2016,2,11,17,890,789,1679,1870
3405-000,2016,2,11,18,943,904,1847,1679
3405-000,2016,2,11,19,883,865,1748,1847
3405-000,2016,2,11,20,569,539,1108,1748
3405-000,2016,2,11,21,463,461,924,1108
3405-000,2016,2,11,22,288,346,634,924
3405-000,2016,2,11,23,215,213,428,634
3405-000,2016,2,11,24,121,138,259,428
3405-000,2016,2,12,1,76,88,164,259
3405-000,2016,2,12,2,52,70,122,164
3405-000,2016,2,12,3,45,69,114,122
3405-000,2016,2,12,4,49,83,132,114
3405-000,2016,2,12,5,85,75,160,132
3405-000,2016,2,12,6,180,171,351,160
3405-000,2016,2,12,7,368,332,700,351
3405-000,2016,2,12,8,846,1000,1846,700
3405-000,2016,2,12,9,1104,1093,2197,1846
3405-000,2016,2,12,10,866,808,1674,2197
3405-000,2016,2,12,11,976,887,1863,1674
3405-000,2016,2,12,12,853,808,1661,1863
3405-000,2016,2,12,13,803,749,1552,1661
3405-000,2016,2,12,14,834,870,1704,1552
3405-000,2016,2,12,15,956,891,1847,1704
3405-000,2016,2,12,16,1025,852,1877,1847
3405-000,2016,2,12,17,976,791,1767,1877
3405-000,2016,2,12,18,1033,838,1871,1767
3405-000,2016,2,12,19,1051,862,1913,1871
3405-000,2016,2,12,20,731,623,1354,1913
3405-000,2016,2,12,21,521,430,951,1354
3405-000,2016,2,12,22,380,333,713,951
3405-000,2016,2,12,23,230,213,443,713
3405-000,2016,2,12,24,125,128,253,443
3405-000,2016,2,13,1,72,88,160,253
3405-000,2016,2,13,2,63,61,124,160
3405-000,2016,2,13,3,52,49,101,124
3405-000,2016,2,13,4,50,59,109,101
3405-000,2016,2,13,5,66,78,144,109
3405-000,2016,2,13,6,124,109,233,144
3405-000,2016,2,13,7,277,205,482,233
3405-000,2016,2,13,8,550,477,1027,482
3405-000,2016,2,13,9,721,621,1342,1027
3405-000,2016,2,13,10,714,597,1311,1342
3405-000,2016,2,13,11,829,611,1440,1311
3405-000,2016,2,13,12,670,604,1274,1440
3405-000,2016,2,13,13,673,571,1244,1274
3405-000,2016,2,13,14,650,631,1281,1244
3405-000,2016,2,13,15,733,616,1349,1281
3405-000,2016,2,13,16,639,616,1255,1349
3405-000,2016,2,13,17,681,602,1283,1255
3405-000,2016,2,13,18,699,688,1387,1283
3405-000,2016,2,13,19,570,491,1061,1387
3405-000,2016,2,13,20,363,338,701,1061
3405-000,2016,2,13,21,274,242,516,701
3405-000,2016,2,13,22,209,209,418,516
3405-000,2016,2,13,23,145,126,271,418
3405-000,2016,2,13,24,68,99,167,271
3405-000,2016,2,14,1,59,63,122,167
3405-000,2016,2,14,2,49,48,97,122
3405-000,2016,2,14,3,36,33,69,97
3405-000,2016,2,14,4,33,29,62,69
3405-000,2016,2,14,5,40,30,70,62
3405-000,2016,2,14,6,70,50,120,70
3405-000,2016,2,14,7,146,90,236,120
3405-000,2016,2,14,8,222,219,441,236
3405-000,2016,2,14,9,336,219,555,441
3405-000,2016,2,14,10,337,260,597,555
3405-000,2016,2,14,11,399,331,730,597
3405-000,2016,2,14,12,365,376,741,730
3405-000,2016,2,14,13,430,428,858,741
3405-000,2016,2,14,14,442,455,897,858
3405-000,2016,2,14,15,469,485,954,897
3405-000,2016,2,14,16,570,512,1082,954
3405-000,2016,2,14,17,493,496,989,1082
3405-000,2016,2,14,18,466,510,976,989
3405-000,2016,2,14,19,357,369,726,976
3405-000,2016,2,14,20,284,309,593,726
3405-000,2016,2,14,21,223,226,449,593
3405-000,2016,2,14,22,166,221,387,449
3405-000,2016,2,14,23,126,182,308,387
3405-000,2016,2,14,24,82,123,205,308
3405-000,2016,2,15,1,48,99,147,205
3405-000,2016,2,15,2,45,62,107,147
3405-000,2016,2,15,3,29,44,73,107
3405-000,2016,2,15,4,43,58,101,73
3405-000,2016,2,15,5,75,87,162,101
3405-000,2016,2,15,6,189,175,364,162
3405-000,2016,2,15,7,459,478,937,364
3405-000,2016,2,15,8,1065,1250,2315,937
3405-000,2016,2,15,9,1191,1227,2418,2315
3405-000,2016,2,15,10,952,889,1841,2418
3405-000,2016,2,15,11,1004,898,1902,1841
3405-000,2016,2,15,12,964,802,1766,1902
3405-000,2016,2,15,13,799,654,1453,1766
3405-000,2016,2,15,14,938,916,1854,1453
3405-000,2016,2,15,15,1088,957,2045,1854
3405-000,2016,2,15,16,1129,863,1992,2045
3405-000,2016,2,15,17,997,871,1868,1992
3405-000,2016,2,15,18,1032,901,1933,1868
3405-000,2016,2,15,19,930,876,1806,1933
3405-000,2016,2,15,20,636,605,1241,1806
3405-000,2016,2,15,21,527,502,1029,1241
3405-000,2016,2,15,22,400,336,736,1029
3405-000,2016,2,15,23,205,198,403,736
3405-000,2016,2,15,24,106,158,264,403
3405-000,2016,2,16,1,87,82,169,264
3405-000,2016,2,16,2,47,76,123,169
3405-000,2016,2,16,3,40,65,105,123
3405-000,2016,2,16,4,42,58,100,105
3405-000,2016,2,16,5,54,82,136,100
3405-000,2016,2,16,6,169,159,328,136
3405-000,2016,2,16,7,421,358,779,328
3405-000,2016,2,16,8,907,1036,1943,779
3405-000,2016,2,16,9,1147,1110,2257,1943
3405-000,2016,2,16,10,1002,860,1862,2257
3405-000,2016,2,16,11,970,839,1809,1862
3405-000,2016,2,16,12,962,799,1761,1809
3405-000,2016,2,16,13,809,742,1551,1761
3405-000,2016,2,16,14,940,899,1839,1551
3405-000,2016,2,16,15,1055,888,1943,1839
3405-000,2016,2,16,16,991,834,1825,1943
3405-000,2016,2,16,17,963,858,1821,1825
3405-000,2016,2,16,18,1062,868,1930,1821
3405-000,2016,2,16,19,896,816,1712,1930
3405-000,2016,2,16,20,560,561,1121,1712
3405-000,2016,2,16,21,482,448,930,1121
3405-000,2016,2,16,22,345,311,656,930
3405-000,2016,2,16,23,215,185,400,656
3405-000,2016,2,16,24,133,136,269,400
3405-000,2016,2,17,1,73,102,175,269
3405-000,2016,2,17,2,61,73,134,175
3405-000,2016,2,17,3,39,56,95,134
3405-000,2016,2,17,4,64,51,115,95
3405-000,2016,2,17,5,80,77,157,115
3405-000,2016,2,17,6,150,153,303,157
3405-000,2016,2,17,7,391,334,725,303
3405-000,2016,2,17,8,942,1107,2049,725
3405-000,2016,2,17,9,1184,1118,2302,2049
3405-000,2016,2,17,10,1030,855,1885,2302
3405-000,2016,2,17,11,1115,903,2018,1885
3405-000,2016,2,17,12,1047,879,1926,2018
3405-000,2016,2,17,13,855,783,1638,1926
3405-000,2016,2,17,14,993,916,1909,1638
3405-000,2016,2,17,15,1089,985,2074,1909
3405-000,2016,2,17,16,905,758,1663,2074
3405-000,2016,2,17,17,1093,914,2007,1663
3405-000,2016,2,17,18,1166,1018,2184,2007
3405-000,2016,2,17,19,1036,995,2031,2184
3405-000,2016,2,17,20,618,587,1205,2031
3405-000,2016,2,17,21,526,490,1016,1205
3405-000,2016,2,17,22,364,319,683,1016
3405-000,2016,2,17,23,237,186,423,683
3405-000,2016,2,17,24,136,166,302,423
3405-000,2016,2,18,1,102,120,222,302
3405-000,2016,2,18,2,61,72,133,222
3405-000,2016,2,18,3,46,61,107,133
3405-000,2016,2,18,4,67,70,137,107
3405-000,2016,2,18,5,90,74,164,137
3405-000,2016,2,18,6,179,185,364,164
3405-000,2016,2,18,7,459,384,843,364
3405-000,2016,2,18,8,1033,1138,2171,843
3405-000,2016,2,18,9,1262,1250,2512,2171
3405-000,2016,2,18,10,1118,896,2014,2512
3405-000,2016,2,18,11,1080,974,2054,2014
3405-000,2016,2,18,12,1036,900,1936,2054
3405-000,2016,2,18,13,873,847,1720,1936
3405-000,2016,2,18,14,968,979,1947,1720
3405-000,2016,2,18,15,1072,1006,2078,1947
3405-000,2016,2,18,16,1095,985,2080,2078
3405-000,2016,2,18,17,1079,911,1990,2080
3405-000,2016,2,18,18,1114,991,2105,1990
3405-000,2016,2,18,19,966,926,1892,2105
3405-000,2016,2,18,20,670,575,1245,1892
3405-000,2016,2,18,21,521,522,1043,1245
3405-000,2016,2,18,22,360,412,772,1043
3405-000,2016,2,18,23,233,227,460,772
3405-000,2016,2,18,24,133,167,300,460
3405-000,2016,2,19,1,90,133,223,300
3405-000,2016,2,19,2,61,76,137,223
3405-000,2016,2,19,3,55,54,109,137
3405-000,2016,2,19,4,62,53,115,109
3405-000,2016,2,19,5,84,89,173,115
3405-000,2016,2,19,6,187,151,338,173
3405-000,2016,2,19,7,448,405,853,338
3405-000,2016,2,19,8,980,1098,2078,853
3405-000,2016,2,19,9,1239,1109,2348,2078
3405-000,2016,2,19,10,989,939,1928,2348
3405-000,2016,2,19,11,1098,906,2004,1928
3405-000,2016,2,19,12,1018,843,1861,2004
3405-000,2016,2,19,13,828,806,1634,1861
3405-000,2016,2,19,14,941,918,1859,1634
3405-000,2016,2,19,15,1082,982,2064,1859
3405-000,2016,2,19,16,1119,1045,2164,2064
3405-000,2016,2,19,17,1158,962,2120,2164
3405-000,2016,2,19,18,1310,984,2294,2120
3405-000,2016,2,19,19,1254,966,2220,2294
3405-000,2016,2,19,20,801,663,1464,2220
3405-000,2016,2,19,21,647,563,1210,1464
3405-000,2016,2,19,22,404,340,744,1210
3405-000,2016,2,19,23,271,233,504,744
3405-000,2016,2,19,24,160,165,325,504
3405-000,2016,2,20,1,132,118,250,325
3405-000,2016,2,20,2,70,74,144,250
3405-000,2016,2,20,3,59,48,107,144
3405-000,2016,2,20,4,57,67,124,107
3405-000,2016,2,20,5,84,88,172,124
3405-000,2016,2,20,6,169,130,299,172
3405-000,2016,2,20,7,317,277,594,299
3405-000,2016,2,20,8,733,548,1281,594
3405-000,2016,2,20,9,874,687,1561,1281
3405-000,2016,2,20,10,842,717,1559,1561
3405-000,2016,2,20,11,938,708,1646,1559
3405-000,2016,2,20,12,841,715,1556,1646
3405-000,2016,2,20,13,775,666,1441,1556
3405-000,2016,2,20,14,790,699,1489,1441
3405-000,2016,2,20,15,797,651,1448,1489
3405-000,2016,2,20,16,797,810,1607,1448
3405-000,2016,2,20,17,868,711,1579,1607
3405-000,2016,2,20,18,977,829,1806,1579
3405-000,2016,2,20,19,762,594,1356,1806
3405-000,2016,2,20,20,484,413,897,1356
3405-000,2016,2,20,21,321,277,598,897
3405-000,2016,2,20,22,249,220,469,598
3405-000,2016,2,20,23,155,159,314,469
3405-000,2016,2,20,24,114,129,243,314
3405-000,2016,2,21,1,66,86,152,243
3405-000,2016,2,21,2,51,44,95,152
3405-000,2016,2,21,3,32,39,71,95
3405-000,2016,2,21,4,31,29,60,71
3405-000,2016,2,21,5,51,47,98,60
3405-000,2016,2,21,6,67,62,129,98
3405-000,2016,2,21,7,144,110,254,129
3405-000,2016,2,21,8,274,234,508,254
3405-000,2016,2,21,9,375,307,682,508
3405-000,2016,2,21,10,457,301,758,682
3405-000,2016,2,21,11,537,389,926,758
3405-000,2016,2,21,12,486,455,941,926
3405-000,2016,2,21,13,488,461,949,941
3405-000,2016,2,21,14,494,538,1032,949
3405-000,2016,2,21,15,534,556,1090,1032
3405-000,2016,2,21,16,531,589,1120,1090
3405-000,2016,2,21,17,607,571,1178,1120
3405-000,2016,2,21,18,608,620,1228,1178
3405-000,2016,2,21,19,470,534,1004,1228
3405-000,2016,2,21,20,382,393,775,1004
3405-000,2016,2,21,21,289,339,628,775
3405-000,2016,2,21,22,231,295,526,628
3405-000,2016,2,21,23,164,197,361,526
3405-000,2016,2,21,24,96,147,243,361
3405-000,2016,2,22,1,72,99,171,243
3405-000,2016,2,22,2,42,54,96,171
3405-000,2016,2,22,3,40,46,86,96
3405-000,2016,2,22,4,42,70,112,86
3405-000,2016,2,22,5,68,88,156,112
3405-000,2016,2,22,6,241,226,467,156
3405-000,2016,2,22,7,574,530,1104,467
3405-000,2016,2,22,8,1052,1427,2479,1104
3405-000,2016,2,22,9,1203,1297,2500,2479
3405-000,2016,2,22,10,1009,843,1852,2500
3405-000,2016,2,22,11,1044,882,1926,1852
3405-000,2016,2,22,12,1009,906,1915,1926
3405-000,2016,2,22,13,854,818,1672,1915
3405-000,2016,2,22,14,966,957,1923,1672
3405-000,2016,2,22,15,1068,1067,2135,1923
3405-000,2016,2,22,16,1095,1053,2148,2135
3405-000,2016,2,22,17,1032,918,1950,2148
3405-000,2016,2,22,18,1137,962,2099,1950
3405-000,2016,2,22,19,995,997,1992,2099
3405-000,2016,2,22,20,607,593,1200,1992
3405-000,2016,2,22,21,514,531,1045,1200
3405-000,2016,2,22,22,358,336,694,1045
3405-000,2016,2,22,23,200,210,410,694
3405-000,2016,2,22,24,107,153,260,410
3405-000,2016,2,23,1,89,107,196,260
3405-000,2016,2,23,2,42,71,113,196
3405-000,2016,2,23,3,40,66,106,113
3405-000,2016,2,23,4,52,55,107,106
3405-000,2016,2,23,5,101,80,181,107
3405-000,2016,2,23,6,193,177,370,181
3405-000,2016,2,23,7,422,393,815,370
3405-000,2016,2,23,8,1012,1160,2172,815
3405-000,2016,2,23,9,1315,1218,2533,2172
3405-000,2016,2,23,10,1084,921,2005,2533
3405-000,2016,2,23,11,1152,960,2112,2005
3405-000,2016,2,23,12,954,942,1896,2112
3405-000,2016,2,23,13,922,808,1730,1896
3405-000,2016,2,23,14,990,938,1928,1730
3405-000,2016,2,23,15,1151,1009,2160,1928
3405-000,2016,2,23,16,1107,996,2103,2160
3405-000,2016,2,23,17,1099,937,2036,2103
3405-000,2016,2,23,18,1133,1026,2159,2036
3405-000,2016,2,23,19,988,937,1925,2159
3405-000,2016,2,23,20,657,620,1277,1925
3405-000,2016,2,23,21,551,498,1049,1277
3405-000,2016,2,23,22,328,337,665,1049
3405-000,2016,2,23,23,235,228,463,665
3405-000,2016,2,23,24,123,166,289,463
3405-000,2016,2,24,1,64,91,155,289
3405-000,2016,2,24,2,57,77,134,155
3405-000,2016,2,24,3,45,60,105,134
3405-000,2016,2,24,4,65,45,110,105
3405-000,2016,2,24,5,83,82,165,110
3405-000,2016,2,24,6,205,167,372,165
3405-000,2016,2,24,7,432,403,835,372
3405-000,2016,2,24,8,996,1102,2098,835
3405-000,2016,2,24,9,1300,1219,2519,2098
3405-000,2016,2,24,10,1125,933,2058,2519
3405-000,2016,2,24,11,1050,1029,2079,2058
3405-000,2016,2,24,12,1039,957,1996,2079
3405-000,2016,2,24,13,903,915,1818,1996
3405-000,2016,2,24,14,1038,1013,2051,1818
3405-000,2016,2,24,15,1164,1034,2198,2051
3405-000,2016,2,24,16,1100,1038,2138,2198
3405-000,2016,2,24,17,1130,907,2037,2138
3405-000,2016,2,24,18,1210,1051,2261,2037
3405-000,2016,2,24,19,1019,924,1943,2261
3405-000,2016,2,24,20,667,633,1300,1943
3405-000,2016,2,24,21,500,472,972,1300
3405-000,2016,2,24,22,371,361,732,972
3405-000,2016,2,24,23,221,193,414,732
3405-000,2016,2,24,24,126,186,312,414
3405-000,2016,2,25,1,96,96,192,312
3405-000,2016,2,25,2,62,47,109,192
3405-000,2016,2,25,3,52,56,108,109
3405-000,2016,2,25,4,55,59,114,108
3405-000,2016,2,25,5,102,87,189,114
3405-000,2016,2,25,6,205,166,371,189
3405-000,2016,2,25,7,464,400,864,371
3405-000,2016,2,25,8,964,1135,2099,864
3405-000,2016,2,25,9,1323,1258,2581,2099
3405-000,2016,2,25,10,1173,962,2135,2581
3405-000,2016,2,25,11,1097,1028,2125,2135
3405-000,2016,2,25,12,1036,916,1952,2125
3405-000,2016,2,25,13,858,785,1643,1952
3405-000,2016,2,25,14,1012,1027,2039,1643
3405-000,2016,2,25,15,1183,1119,2302,2039
3405-000,2016,2,25,16,1149,957,2106,2302
3405-000,2016,2,25,17,1170,1004,2174,2106
3405-000,2016,2,25,18,1146,947,2093,2174
3405-000,2016,2,25,19,1047,1027,2074,2093
3405-000,2016,2,25,20,692,587,1279,2074
3405-000,2016,2,25,21,506,547,1053,1279
3405-000,2016,2,25,22,346,338,684,1053
3405-000,2016,2,25,23,240,252,492,684
3405-000,2016,2,25,24,156,175,331,492
3405-000,2016,2,26,1,109,103,212,331
3405-000,2016,2,26,2,65,71,136,212
3405-000,2016,2,26,3,60,46,106,136
3405-000,2016,2,26,4,64,69,133,106
3405-000,2016,2,26,5,87,81,168,133
3405-000,2016,2,26,6,179,172,351,168
3405-000,2016,2,26,7,455,376,831,351
3405-000,2016,2,26,8,1033,1101,2134,831
3405-000,2016,2,26,9,1267,1200,2467,2134
3405-000,2016,2,26,10,1131,940,2071,2467
3405-000,2016,2,26,11,1142,1020,2162,2071
3405-000,2016,2,26,12,1136,961,2097,2162
3405-000,2016,2,26,13,915,842,1757,2097
3405-000,2016,2,26,14,1057,1045,2102,1757
3405-000,2016,2,26,15,1178,1059,2237,2102
3405-000,2016,2,26,16,1176,981,2157,2237
3405-000,2016,2,26,17,1128,973,2101,2157
3405-000,2016,2,26,18,1319,1035,2354,2101
3405-000,2016,2,26,19,1300,1015,2315,2354
3405-000,2016,2,26,20,809,774,1583,2315
3405-000,2016,2,26,21,644,523,1167,1583
3405-000,2016,2,26,22,407,382,789,1167
3405-000,2016,2,26,23,266,248,514,789
3405-000,2016,2,26,24,150,168,318,514
3405-000,2016,2,27,1,111,98,209,318
3405-000,2016,2,27,2,69,64,133,209
3405-000,2016,2,27,3,44,55,99,133
3405-000,2016,2,27,4,65,68,133,99
3405-000,2016,2,27,5,75,72,147,133
3405-000,2016,2,27,6,155,119,274,147
3405-000,2016,2,27,7,337,282,619,274
3405-000,2016,2,27,8,630,550,1180,619
3405-000,2016,2,27,9,836,712,1548,1180
3405-000,2016,2,27,10,889,706,1595,1548
3405-000,2016,2,27,11,1010,774,1784,1595
3405-000,2016,2,27,12,952,719,1671,1784
3405-000,2016,2,27,13,761,744,1505,1671
3405-000,2016,2,27,14,772,736,1508,1505
3405-000,2016,2,27,15,783,761,1544,1508
3405-000,2016,2,27,16,807,739,1546,1544
3405-000,2016,2,27,17,897,786,1683,1546
3405-000,2016,2,27,18,885,886,1771,1683
3405-000,2016,2,27,19,716,686,1402,1771
3405-000,2016,2,27,20,506,456,962,1402
3405-000,2016,2,27,21,323,320,643,962
3405-000,2016,2,27,22,270,273,543,643
3405-000,2016,2,27,23,183,186,369,543
3405-000,2016,2,27,24,122,144,266,369
3405-000,2016,2,28,1,72,64,136,266
3405-000,2016,2,28,2,53,47,100,136
3405-000,2016,2,28,3,33,30,63,100
3405-000,2016,2,28,4,40,25,65,63
3405-000,2016,2,28,5,48,35,83,65
3405-000,2016,2,28,6,77,66,143,83
3405-000,2016,2,28,7,176,120,296,143
3405-000,2016,2,28,8,301,239,540,296
3405-000,2016,2,28,9,397,298,695,540
3405-000,2016,2,28,10,509,298,807,695
3405-000,2016,2,28,11,483,419,902,807
3405-000,2016,2,28,12,493,427,920,902
3405-000,2016,2,28,13,555,490,1045,920
3405-000,2016,2,28,14,525,468,993,1045
3405-000,2016,2,28,15,538,606,1144,993
3405-000,2016,2,28,16,500,541,1041,1144
3405-000,2016,2,28,17,550,534,1084,1041
3405-000,2016,2,28,18,537,565,1102,1084
3405-000,2016,2,28,19,414,452,866,1102
3405-000,2016,2,28,20,333,351,684,866
3405-000,2016,2,28,21,256,282,538,684
3405-000,2016,2,28,22,261,335,596,538
3405-000,2016,2,28,23,195,188,383,596
3405-000,2016,2,28,24,78,148,226,383
3405-000,2016,2,29,1,43,101,144,226
3405-000,2016,2,29,2,24,58,82,144
3405-000,2016,2,29,3,24,47,71,82
3405-000,2016,2,29,4,25,71,96,71
3405-000,2016,2,29,5,42,97,139,96
3405-000,2016,2,29,6,161,236,397,139
3405-000,2016,2,29,7,419,549,968,397
3405-000,2016,2,29,8,1058,1423,2481,968
3405-000,2016,2,29,9,1197,1318,2515,2481
3405-000,2016,2,29,10,980,857,1837,2515
3405-000,2016,2,29,11,1024,908,1932,1837
3405-000,2016,2,29,12,986,920,1906,1932
3405-000,2016,2,29,13,826,837,1663,1906
3405-000,2016,2,29,14,952,958,1910,1663
3405-000,2016,2,29,15,1078,1042,2120,1910
3405-000,2016,2,29,16,1112,1057,2169,2120
3405-000,2016,2,29,17,1014,928,1942,2169
3405-000,2016,2,29,18,1084,964,2048,1942
3405-000,2016,2,29,19,962,989,1951,2048
3405-000,2016,2,29,20,622,599,1221,1951
3405-000,2016,2,29,21,520,537,1057,1221
3405-000,2016,2,29,22,379,367,746,1057
3405-000,2016,2,29,23,202,221,423,746
3405-000,2016,2,29,24,106,148,254,423
3405-000,2016,3,1,1,88,84,172,254
3405-000,2016,3,1,2,52,69,121,172
3405-000,2016,3,1,3,49,43,92,121
3405-000,2016,3,1,4,45,44,89,92
3405-000,2016,3,1,5,58,71,129,89
3405-000,2016,3,1,6,129,118,247,129
3405-000,2016,3,1,7,252,210,462,247
3405-000,2016,3,1,8,518,447,965,462
3405-000,2016,3,1,9,645,520,1165,965
3405-000,2016,3,1,10,603,568,1171,1165
3405-000,2016,3,1,11,701,580,1281,1171
3405-000,2016,3,1,12,662,606,1268,1281
3405-000,2016,3,1,13,630,583,1213,1268
3405-000,2016,3,1,14,610,658,1268,1213
3405-000,2016,3,1,15,709,687,1396,1268
3405-000,2016,3,1,16,686,680,1366,1396
3405-000,2016,3,1,17,730,693,1423,1366
3405-000,2016,3,1,18,702,734,1436,1423
3405-000,2016,3,1,19,594,670,1264,1436
3405-000,2016,3,1,20,409,420,829,1264
3405-000,2016,3,1,21,317,333,650,829
3405-000,2016,3,1,22,219,252,471,650
3405-000,2016,3,1,23,192,193,385,471
3405-000,2016,3,1,24,78,128,206,385
3405-000,2016,3,2,1,64,84,148,206
3405-000,2016,3,2,2,42,51,93,148
3405-000,2016,3,2,3,37,52,89,93
3405-000,2016,3,2,4,41,55,96,89
3405-000,2016,3,2,5,87,89,176,96
3405-000,2016,3,2,6,221,185,406,176
3405-000,2016,3,2,7,489,479,968,406
3405-000,2016,3,2,8,1067,1329,2396,968
3405-000,2016,3,2,9,1267,1242,2509,2396
3405-000,2016,3,2,10,1006,967,1973,2509
3405-000,2016,3,2,11,1085,1010,2095,1973
3405-000,2016,3,2,12,1049,904,1953,2095
3405-000,2016,3,2,13,910,810,1720,1953
3405-000,2016,3,2,14,990,976,1966,1720
3405-000,2016,3,2,15,1118,976,2094,1966
3405-000,2016,3,2,16,1090,943,2033,2094
3405-000,2016,3,2,17,1074,935,2009,2033
3405-000,2016,3,2,18,1172,955,2127,2009
3405-000,2016,3,2,19,1089,936,2025,2127
3405-000,2016,3,2,20,686,595,1281,2025
3405-000,2016,3,2,21,480,516,996,1281
3405-000,2016,3,2,22,355,337,692,996
3405-000,2016,3,2,23,229,228,457,692
3405-000,2016,3,2,24,137,141,278,457
3405-000,2016,3,3,1,80,102,182,278
3405-000,2016,3,3,2,65,68,133,182
3405-000,2016,3,3,3,36,62,98,133
3405-000,2016,3,3,4,67,67,134,98
3405-000,2016,3,3,5,89,84,173,134
3405-000,2016,3,3,6,206,185,391,173
3405-000,2016,3,3,7,455,390,845,391
3405-000,2016,3,3,8,1017,1162,2179,845
3405-000,2016,3,3,9,1248,1205,2453,2179
3405-000,2016,3,3,10,1085,941,2026,2453
3405-000,2016,3,3,11,1085,982,2067,2026
3405-000,2016,3,3,12,1076,908,1984,2067
3405-000,2016,3,3,13,858,850,1708,1984
3405-000,2016,3,3,14,913,951,1864,1708
3405-000,2016,3,3,15,1113,939,2052,1864
3405-000,2016,3,3,16,1170,967,2137,2052
3405-000,2016,3,3,17,1146,988,2134,2137
3405-000,2016,3,3,18,1120,984,2104,2134
3405-000,2016,3,3,19,1054,971,2025,2104
3405-000,2016,3,3,20,691,667,1358,2025
3405-000,2016,3,3,21,565,555,1120,1358
3405-000,2016,3,3,22,579,411,990,1120
3405-000,2016,3,3,23,272,197,469,990
3405-000,2016,3,3,24,353,159,512,469
3405-000,2016,3,4,1,223,76,299,512
3405-000,2016,3,4,2,55,70,125,299
3405-000,2016,3,4,3,52,55,107,125
3405-000,2016,3,4,4,48,75,123,107
3405-000,2016,3,4,5,89,91,180,123
3405-000,2016,3,4,6,192,189,381,180
3405-000,2016,3,4,7,485,396,881,381
3405-000,2016,3,4,8,1037,1178,2215,881
3405-000,2016,3,4,9,1276,1194,2470,2215
3405-000,2016,3,4,10,1113,949,2062,2470
3405-000,2016,3,4,11,1140,1002,2142,2062
3405-000,2016,3,4,12,1098,921,2019,2142
3405-000,2016,3,4,13,905,857,1762,2019
3405-000,2016,3,4,14,1015,994,2009,1762
3405-000,2016,3,4,15,1163,987,2150,2009
3405-000,2016,3,4,16,1082,969,2051,2150
3405-000,2016,3,4,17,1071,978,2049,2051
3405-000,2016,3,4,18,1368,1040,2408,2049
3405-000,2016,3,4,19,1350,1040,2390,2408
3405-000,2016,3,4,20,821,683,1504,2390
3405-000,2016,3,4,21,609,548,1157,1504
3405-000,2016,3,4,22,375,343,718,1157
3405-000,2016,3,4,23,245,220,465,718
3405-000,2016,3,4,24,146,169,315,465
3405-000,2016,3,5,1,95,90,185,315
3405-000,2016,3,5,2,73,67,140,185
3405-000,2016,3,5,3,49,57,106,140
3405-000,2016,3,5,4,60,67,127,106
3405-000,2016,3,5,5,67,74,141,127
3405-000,2016,3,5,6,156,112,268,141
3405-000,2016,3,5,7,271,228,499,268
3405-000,2016,3,5,8,644,512,1156,499
3405-000,2016,3,5,9,783,639,1422,1156
3405-000,2016,3,5,10,735,604,1339,1422
3405-000,2016,3,5,11,817,620,1437,1339
3405-000,2016,3,5,12,829,722,1551,1437
3405-000,2016,3,5,13,738,646,1384,1551
3405-000,2016,3,5,14,687,624,1311,1384
3405-000,2016,3,5,15,694,640,1334,1311
3405-000,2016,3,5,16,736,664,1400,1334
3405-000,2016,3,5,17,770,593,1363,1400
3405-000,2016,3,5,18,869,753,1622,1363
3405-000,2016,3,5,19,739,554,1293,1622
3405-000,2016,3,5,20,495,386,881,1293
3405-000,2016,3,5,21,243,299,542,881
3405-000,2016,3,5,22,88,193,281,542
3405-000,2016,3,5,23,40,161,201,281
3405-000,2016,3,5,24,22,110,132,201
3405-000,2016,3,6,1,33,59,92,132
3405-000,2016,3,6,2,11,44,55,92
3405-000,2016,3,6,3,11,36,47,55
3405-000,2016,3,6,4,13,22,35,47
3405-000,2016,3,6,5,24,37,61,35
3405-000,2016,3,6,6,52,62,114,61
3405-000,2016,3,6,7,93,118,211,114
3405-000,2016,3,6,8,232,263,495,211
3405-000,2016,3,6,9,292,320,612,495
3405-000,2016,3,6,10,371,288,659,612
3405-000,2016,3,6,11,426,405,831,659
3405-000,2016,3,6,12,450,438,888,831
3405-000,2016,3,6,13,371,480,851,888
3405-000,2016,3,6,14,422,582,1004,851
3405-000,2016,3,6,15,439,583,1022,1004
3405-000,2016,3,6,16,533,646,1179,1022
3405-000,2016,3,6,17,569,605,1174,1179
3405-000,2016,3,6,18,523,612,1135,1174
3405-000,2016,3,6,19,392,513,905,1135
3405-000,2016,3,6,20,313,416,729,905
3405-000,2016,3,6,21,287,344,631,729
3405-000,2016,3,6,22,176,282,458,631
3405-000,2016,3,6,23,137,259,396,458
3405-000,2016,3,6,24,41,166,207,396
3405-000,2016,3,7,1,28,102,130,207
3405-000,2016,3,7,2,13,62,75,130
3405-000,2016,3,7,3,18,47,65,75
3405-000,2016,3,7,4,18,71,89,65
3405-000,2016,3,7,5,33,105,138,89
3405-000,2016,3,7,6,174,246,420,138
3405-000,2016,3,7,7,566,568,1134,420
3405-000,2016,3,7,8,1325,1419,2744,1134
3405-000,2016,3,7,9,1506,1339,2845,2744
3405-000,2016,3,7,10,989,870,1859,2845
3405-000,2016,3,7,11,1077,934,2011,1859
3405-000,2016,3,7,12,1075,933,2008,2011
3405-000,2016,3,7,13,750,856,1606,2008
3405-000,2016,3,7,14,863,959,1822,1606
3405-000,2016,3,7,15,1161,1016,2177,1822
3405-000,2016,3,7,16,1137,1061,2198,2177
3405-000,2016,3,7,17,1077,938,2015,2198
3405-000,2016,3,7,18,1148,965,2113,2015
3405-000,2016,3,7,19,1017,980,1997,2113
3405-000,2016,3,7,20,660,605,1265,1997
3405-000,2016,3,7,21,497,542,1039,1265
3405-000,2016,3,7,22,356,397,753,1039
3405-000,2016,3,7,23,180,231,411,753
3405-000,2016,3,7,24,93,143,236,411
3405-000,2016,3,8,1,33,97,130,236
3405-000,2016,3,8,2,30,56,86,130
3405-000,2016,3,8,3,20,65,85,86
3405-000,2016,3,8,4,13,76,89,85
3405-000,2016,3,8,5,24,97,121,89
3405-000,2016,3,8,6,120,205,325,121
3405-000,2016,3,8,7,407,473,880,325
3405-000,2016,3,8,8,1227,1231,2458,880
3405-000,2016,3,8,9,1571,1223,2794,2458
3405-000,2016,3,8,10,1152,965,2117,2794
3405-000,2016,3,8,11,1250,1046,2296,2117
3405-000,2016,3,8,12,1021,1000,2021,2296
3405-000,2016,3,8,13,792,821,1613,2021
3405-000,2016,3,8,14,906,993,1899,1613
3405-000,2016,3,8,15,1218,1070,2288,1899
3405-000,2016,3,8,16,1081,987,2068,2288
3405-000,2016,3,8,17,1049,916,1965,2068
3405-000,2016,3,8,18,1229,1012,2241,1965
3405-000,2016,3,8,19,1013,914,1927,2241
3405-000,2016,3,8,20,581,599,1180,1927
3405-000,2016,3,8,21,563,556,1119,1180
3405-000,2016,3,8,22,281,377,658,1119
3405-000,2016,3,8,23,152,239,391,658
3405-000,2016,3,8,24,99,141,240,391
3405-000,2016,3,9,1,54,82,136,240
3405-000,2016,3,9,2,26,67,93,136
3405-000,2016,3,9,3,26,45,71,93
3405-000,2016,3,9,4,13,59,72,71
3405-000,2016,3,9,5,43,109,152,72
3405-000,2016,3,9,6,131,199,330,152
3405-000,2016,3,9,7,506,408,914,330
3405-000,2016,3,9,8,1274,1186,2460,914
3405-000,2016,3,9,9,1479,1222,2701,2460
3405-000,2016,3,9,10,1126,954,2080,2701
3405-000,2016,3,9,11,1116,973,2089,2080
3405-000,2016,3,9,12,1058,918,1976,2089
3405-000,2016,3,9,13,835,859,1694,1976
3405-000,2016,3,9,14,889,1013,1902,1694
3405-000,2016,3,9,15,1073,965,2038,1902
3405-000,2016,3,9,16,1094,997,2091,2038
3405-000,2016,3,9,17,1049,952,2001,2091
3405-000,2016,3,9,18,1370,1014,2384,2001
3405-000,2016,3,9,19,1191,982,2173,2384
3405-000,2016,3,9,20,632,623,1255,2173
3405-000,2016,3,9,21,446,510,956,1255
3405-000,2016,3,9,22,285,390,675,956
3405-000,2016,3,9,23,165,231,396,675
3405-000,2016,3,9,24,103,149,252,396
3405-000,2016,3,10,1,33,102,135,252
3405-000,2016,3,10,2,26,72,98,135
3405-000,2016,3,10,3,20,63,83,98
3405-000,2016,3,10,4,24,59,83,83
3405-000,2016,3,10,5,26,92,118,83
3405-000,2016,3,10,6,122,193,315,118
3405-000,2016,3,10,7,435,395,830,315
3405-000,2016,3,10,8,1302,1289,2591,830
3405-000,2016,3,10,9,1524,1275,2799,2591
3405-000,2016,3,10,10,1118,980,2098,2799
3405-000,2016,3,10,11,1193,1037,2230,2098
3405-000,2016,3,10,12,1058,950,2008,2230
3405-000,2016,3,10,13,767,818,1585,2008
3405-000,2016,3,10,14,964,962,1926,1585
3405-000,2016,3,10,15,1092,999,2091,1926
3405-000,2016,3,10,16,1066,1010,2076,2091
3405-000,2016,3,10,17,1083,1004,2087,2076
3405-000,2016,3,10,18,1362,960,2322,2087
3405-000,2016,3,10,19,1049,961,2010,2322
3405-000,2016,3,10,20,638,643,1281,2010
3405-000,2016,3,10,21,491,539,1030,1281
3405-000,2016,3,10,22,294,389,683,1030
3405-000,2016,3,10,23,187,197,384,683
3405-000,2016,3,10,24,93,178,271,384
3405-000,2016,3,11,1,60,114,174,271
3405-000,2016,3,11,2,37,85,122,174
3405-000,2016,3,11,3,24,39,63,122
3405-000,2016,3,11,4,30,58,88,63
3405-000,2016,3,11,5,37,81,118,88
3405-000,2016,3,11,6,127,211,338,118
3405-000,2016,3,11,7,448,395,843,338
3405-000,2016,3,11,8,1235,1181,2416,843
3405-000,2016,3,11,9,1471,1172,2643,2416
3405-000,2016,3,11,10,1075,911,1986,2643
3405-000,2016,3,11,11,1133,962,2095,1986
3405-000,2016,3,11,12,1073,952,2025,2095
3405-000,2016,3,11,13,876,798,1674,2025
3405-000,2016,3,11,14,897,958,1855,1674
3405-000,2016,3,11,15,1154,925,2079,1855
3405-000,2016,3,11,16,1235,1017,2252,2079
3405-000,2016,3,11,17,1122,975,2097,2252
3405-000,2016,3,11,18,1625,1055,2680,2097
3405-000,2016,3,11,19,1670,1143,2813,2680
3405-000,2016,3,11,20,878,728,1606,2813
3405-000,2016,3,11,21,679,603,1282,1606
3405-000,2016,3,11,22,328,393,721,1282
3405-000,2016,3,11,23,236,254,490,721
3405-000,2016,3,11,24,103,182,285,490
3405-000,2016,3,12,1,88,97,185,285
3405-000,2016,3,12,2,33,70,103,185
3405-000,2016,3,12,3,22,41,63,103
3405-000,2016,3,12,4,28,56,84,63
3405-000,2016,3,12,5,33,77,110,84
3405-000,2016,3,12,6,110,141,251,110
3405-000,2016,3,12,7,328,295,623,251
3405-000,2016,3,12,8,839,595,1434,623
3405-000,2016,3,12,9,927,696,1623,1434
3405-000,2016,3,12,10,891,690,1581,1623
3405-000,2016,3,12,11,923,742,1665,1581
3405-000,2016,3,12,12,848,777,1625,1665
3405-000,2016,3,12,13,818,794,1612,1625
3405-000,2016,3,12,14,839,750,1589,1612
3405-000,2016,3,12,15,818,757,1575,1589
3405-000,2016,3,12,16,914,766,1680,1575
3405-000,2016,3,12,17,869,683,1552,1680
3405-000,2016,3,12,18,1015,798,1813,1552
3405-000,2016,3,12,19,775,627,1402,1813
3405-000,2016,3,12,20,448,449,897,1402
3405-000,2016,3,12,21,283,361,644,897
3405-000,2016,3,12,22,208,268,476,644
3405-000,2016,3,12,23,140,213,353,476
3405-000,2016,3,12,24,58,139,197,353
3405-000,2016,3,13,1,24,76,100,197
3405-000,2016,3,13,2,18,58,76,100
3405-000,2016,3,13,3,18,43,61,76
3405-000,2016,3,13,4,18,31,49,61
3405-000,2016,3,13,5,20,33,53,49
3405-000,2016,3,13,6,56,73,129,53
3405-000,2016,3,13,7,127,138,265,129
3405-000,2016,3,13,8,268,258,526,265
3405-000,2016,3,13,9,452,305,757,526
3405-000,2016,3,13,10,424,354,778,757
3405-000,2016,3,13,11,488,393,881,778
3405-000,2016,3,13,12,559,465,1024,881
3405-000,2016,3,13,13,463,498,961,1024
3405-000,2016,3,13,14,474,509,983,961
3405-000,2016,3,13,15,551,551,1102,983
3405-000,2016,3,13,16,499,561,1060,1102
3405-000,2016,3,13,17,568,647,1215,1060
3405-000,2016,3,13,18,581,683,1264,1215
3405-000,2016,3,13,19,484,608,1092,1264
3405-000,2016,3,13,20,283,503,786,1092
3405-000,2016,3,13,21,287,379,666,786
3405-000,2016,3,13,22,202,329,531,666
3405-000,2016,3,13,23,114,268,382,531
3405-000,2016,3,13,24,50,168,218,382
3405-000,2016,3,14,1,41,91,132,218
3405-000,2016,3,14,2,18,56,74,132
3405-000,2016,3,14,3,15,46,61,74
3405-000,2016,3,14,4,15,55,70,61
3405-000,2016,3,14,5,37,83,120,70
3405-000,2016,3,14,6,182,226,408,120
3405-000,2016,3,14,7,529,549,1078,408
3405-000,2016,3,14,8,1308,1441,2749,1078
3405-000,2016,3,14,9,1497,1393,2890,2749
3405-000,2016,3,14,10,1043,936,1979,2890
3405-000,2016,3,14,11,1066,1023,2089,1979
3405-000,2016,3,14,12,912,967,1879,2089
3405-000,2016,3,14,13,786,820,1606,1879
3405-000,2016,3,14,14,938,913,1851,1606
3405-000,2016,3,14,15,1064,987,2051,1851
3405-000,2016,3,14,16,1043,998,2041,2051
3405-000,2016,3,14,17,998,907,1905,2041
3405-000,2016,3,14,18,1163,963,2126,1905
3405-000,2016,3,14,19,1096,911,2007,2126
3405-000,2016,3,14,20,647,643,1290,2007
3405-000,2016,3,14,21,499,579,1078,1290
3405-000,2016,3,14,22,311,378,689,1078
3405-000,2016,3,14,23,176,235,411,689
3405-000,2016,3,14,24,78,172,250,411
3405-000,2016,3,15,1,18,94,112,250
3405-000,2016,3,15,2,9,60,69,112
3405-000,2016,3,15,3,13,55,68,69
3405-000,2016,3,15,4,7,64,71,68
3405-000,2016,3,15,5,14,84,98,71
3405-000,2016,3,15,6,65,178,243,98
3405-000,2016,3,15,7,200,402,602,243
3405-000,2016,3,15,8,872,1225,2097,602
3405-000,2016,3,15,9,1108,1266,2374,2097
3405-000,2016,3,15,10,878,930,1808,2374
3405-000,2016,3,15,11,976,983,1959,1808
3405-000,2016,3,15,12,842,933,1775,1959
3405-000,2016,3,15,13,711,863,1574,1775
3405-000,2016,3,15,14,758,970,1728,1574
3405-000,2016,3,15,15,964,1033,1997,1728
3405-000,2016,3,15,16,1186,988,2174,1997
3405-000,2016,3,15,17,1053,945,1998,2174
3405-000,2016,3,15,18,1340,936,2276,1998
3405-000,2016,3,15,19,1117,1038,2155,2276
3405-000,2016,3,15,20,700,605,1305,2155
3405-000,2016,3,15,21,588,574,1162,1305
3405-000,2016,3,15,22,340,380,720,1162
3405-000,2016,3,15,23,240,252,492,720
3405-000,2016,3,15,24,124,144,268,492
3405-000,2016,3,16,1,92,91,183,268
3405-000,2016,3,16,2,71,77,148,183
3405-000,2016,3,16,3,52,66,118,148
3405-000,2016,3,16,4,59,41,100,118
3405-000,2016,3,16,5,75,110,185,100
3405-000,2016,3,16,6,206,180,386,185
3405-000,2016,3,16,7,505,434,939,386
3405-000,2016,3,16,8,1170,1163,2333,939
3405-000,2016,3,16,9,1373,1221,2594,2333
3405-000,2016,3,16,10,1066,924,1990,2594
3405-000,2016,3,16,11,1100,987,2087,1990
3405-000,2016,3,16,12,1054,986,2040,2087
3405-000,2016,3,16,13,872,833,1705,2040
3405-000,2016,3,16,14,940,935,1875,1705
3405-000,2016,3,16,15,1096,1053,2149,1875
3405-000,2016,3,16,16,1092,998,2090,2149
3405-000,2016,3,16,17,1062,990,2052,2090
3405-000,2016,3,16,18,1271,1077,2348,2052
3405-000,2016,3,16,19,1186,1024,2210,2348
3405-000,2016,3,16,20,718,568,1286,2210
3405-000,2016,3,16,21,701,504,1205,1286
3405-000,2016,3,16,22,369,416,785,1205
3405-000,2016,3,16,23,197,231,428,785
3405-000,2016,3,16,24,120,161,281,428
3405-000,2016,3,17,1,104,87,191,281
3405-000,2016,3,17,2,65,61,126,191
3405-000,2016,3,17,3,95,50,145,126
3405-000,2016,3,17,4,61,63,124,145
3405-000,2016,3,17,5,85,98,183,124
3405-000,2016,3,17,6,190,203,393,183
3405-000,2016,3,17,7,470,446,916,393
3405-000,2016,3,17,8,1088,1220,2308,916
3405-000,2016,3,17,9,1317,1199,2516,2308
3405-000,2016,3,17,10,1101,993,2094,2516
3405-000,2016,3,17,11,1136,976,2112,2094
3405-000,2016,3,17,12,1086,884,1970,2112
3405-000,2016,3,17,13,900,827,1727,1970
3405-000,2016,3,17,14,959,994,1953,1727
3405-000,2016,3,17,15,1160,1004,2164,1953
3405-000,2016,3,17,16,1167,1026,2193,2164
3405-000,2016,3,17,17,1083,1000,2083,2193
3405-000,2016,3,17,18,1192,982,2174,2083
3405-000,2016,3,17,19,1033,1046,2079,2174
3405-000,2016,3,17,20,713,661,1374,2079
3405-000,2016,3,17,21,542,587,1129,1374
3405-000,2016,3,17,22,394,418,812,1129
3405-000,2016,3,17,23,226,231,457,812
3405-000,2016,3,17,24,144,168,312,457
3405-000,2016,3,18,1,106,117,223,312
3405-000,2016,3,18,2,58,58,116,223
3405-000,2016,3,18,3,47,57,104,116
3405-000,2016,3,18,4,48,57,105,104
3405-000,2016,3,18,5,87,83,170,105
3405-000,2016,3,18,6,182,185,367,170
3405-000,2016,3,18,7,490,391,881,367
3405-000,2016,3,18,8,1009,1103,2112,881
3405-000,2016,3,18,9,1257,1227,2484,2112
3405-000,2016,3,18,10,1099,938,2037,2484
3405-000,2016,3,18,11,1099,971,2070,2037
3405-000,2016,3,18,12,1057,876,1933,2070
3405-000,2016,3,18,13,912,854,1766,1933
3405-000,2016,3,18,14,998,982,1980,1766
3405-000,2016,3,18,15,1248,1002,2250,1980
3405-000,2016,3,18,16,1180,967,2147,2250
3405-000,2016,3,18,17,1093,1000,2093,2147
3405-000,2016,3,18,18,1349,1032,2381,2093
3405-000,2016,3,18,19,1419,1124,2543,2381
3405-000,2016,3,18,20,867,709,1576,2543
3405-000,2016,3,18,21,651,626,1277,1576
3405-000,2016,3,18,22,436,427,863,1277
3405-000,2016,3,18,23,345,226,571,863
3405-000,2016,3,18,24,218,161,379,571
3405-000,2016,3,19,1,133,110,243,379
3405-000,2016,3,19,2,68,73,141,243
3405-000,2016,3,19,3,120,61,181,141
3405-000,2016,3,19,4,94,74,168,181
3405-000,2016,3,19,5,148,79,227,168
3405-000,2016,3,19,6,273,158,431,227
3405-000,2016,3,19,7,452,288,740,431
3405-000,2016,3,19,8,711,608,1319,740
3405-000,2016,3,19,9,732,769,1501,1319
3405-000,2016,3,19,10,813,791,1604,1501
3405-000,2016,3,19,11,870,815,1685,1604
3405-000,2016,3,19,12,914,832,1746,1685
3405-000,2016,3,19,13,752,821,1573,1746
3405-000,2016,3,19,14,853,763,1616,1573
3405-000,2016,3,19,15,892,798,1690,1616
3405-000,2016,3,19,16,801,763,1564,1690
3405-000,2016,3,19,17,651,733,1384,1564
3405-000,2016,3,19,18,1024,871,1895,1384
3405-000,2016,3,19,19,874,690,1564,1895
3405-000,2016,3,19,20,608,499,1107,1564
3405-000,2016,3,19,21,418,412,830,1107
3405-000,2016,3,19,22,286,299,585,830
3405-000,2016,3,19,23,217,206,423,585
3405-000,2016,3,19,24,111,169,280,423
3405-000,2016,3,20,1,72,79,151,280
3405-000,2016,3,20,2,49,64,113,151
3405-000,2016,3,20,3,48,46,94,113
3405-000,2016,3,20,4,33,21,54,94
3405-000,2016,3,20,5,51,41,92,54
3405-000,2016,3,20,6,98,84,182,92
3405-000,2016,3,20,7,202,155,357,182
3405-000,2016,3,20,8,345,277,622,357
3405-000,2016,3,20,9,443,348,791,622
3405-000,2016,3,20,10,523,349,872,791
3405-000,2016,3,20,11,564,473,1037,872
3405-000,2016,3,20,12,610,555,1165,1037
3405-000,2016,3,20,13,525,521,1046,1165
3405-000,2016,3,20,14,566,540,1106,1046
3405-000,2016,3,20,15,614,639,1253,1106
3405-000,2016,3,20,16,650,653,1303,1253
3405-000,2016,3,20,17,749,738,1487,1303
3405-000,2016,3,20,18,765,733,1498,1487
3405-000,2016,3,20,19,509,603,1112,1498
3405-000,2016,3,20,20,460,474,934,1112
3405-000,2016,3,20,21,371,405,776,934
3405-000,2016,3,20,22,263,356,619,776
3405-000,2016,3,20,23,171,286,457,619
3405-000,2016,3,20,24,103,180,283,457
3405-000,2016,3,21,1,70,101,171,283
3405-000,2016,3,21,2,43,68,111,171
3405-000,2016,3,21,3,36,39,75,111
3405-000,2016,3,21,4,48,52,100,75
3405-000,2016,3,21,5,74,90,164,100
3405-000,2016,3,21,6,245,237,482,164
3405-000,2016,3,21,7,602,587,1189,482
3405-000,2016,3,21,8,1161,1388,2549,1189
3405-000,2016,3,21,9,1265,1380,2645,2549
3405-000,2016,3,21,10,1011,956,1967,2645
3405-000,2016,3,21,11,1124,982,2106,1967
3405-000,2016,3,21,12,1047,911,1958,2106
3405-000,2016,3,21,13,848,822,1670,1958
3405-000,2016,3,21,14,894,996,1890,1670
3405-000,2016,3,21,15,1116,986,2102,1890
3405-000,2016,3,21,16,1071,974,2045,2102
3405-000,2016,3,21,17,1086,1021,2107,2045
3405-000,2016,3,21,18,1145,988,2133,2107
3405-000,2016,3,21,19,1142,1015,2157,2133
3405-000,2016,3,21,20,694,700,1394,2157
3405-000,2016,3,21,21,567,526,1093,1394
3405-000,2016,3,21,22,377,413,790,1093
3405-000,2016,3,21,23,233,226,459,790
3405-000,2016,3,21,24,127,145,272,459
3405-000,2016,3,22,1,102,110,212,272
3405-000,2016,3,22,2,57,71,128,212
3405-000,2016,3,22,3,45,55,100,128
3405-000,2016,3,22,4,54,55,109,100
3405-000,2016,3,22,5,86,89,175,109
3405-000,2016,3,22,6,225,183,408,175
3405-000,2016,3,22,7,505,437,942,408
3405-000,2016,3,22,8,1073,1248,2321,942
3405-000,2016,3,22,9,1368,1287,2655,2321
3405-000,2016,3,22,10,1095,935,2030,2655
3405-000,2016,3,22,11,1145,997,2142,2030
3405-000,2016,3,22,12,1083,1019,2102,2142
3405-000,2016,3,22,13,902,910,1812,2102
3405-000,2016,3,22,14,939,1058,1997,1812
3405-000,2016,3,22,15,1232,1045,2277,1997
3405-000,2016,3,22,16,1103,1032,2135,2277
3405-000,2016,3,22,17,1099,980,2079,2135
3405-000,2016,3,22,18,1228,1001,2229,2079
3405-000,2016,3,22,19,1102,983,2085,2229
3405-000,2016,3,22,20,689,664,1353,2085
3405-000,2016,3,22,21,577,584,1161,1353
3405-000,2016,3,22,22,385,398,783,1161
3405-000,2016,3,22,23,265,209,474,783
3405-000,2016,3,22,24,111,165,276,474
3405-000,2016,3,23,1,87,107,194,276
3405-000,2016,3,23,2,66,68,134,194
3405-000,2016,3,23,3,48,43,91,134
3405-000,2016,3,23,4,62,63,125,91
3405-000,2016,3,23,5,98,97,195,125
3405-000,2016,3,23,6,212,202,414,195
3405-000,2016,3,23,7,492,430,922,414
3405-000,2016,3,23,8,1039,1205,2244,922
3405-000,2016,3,23,9,1346,1213,2559,2244
3405-000,2016,3,23,10,1169,973,2142,2559
3405-000,2016,3,23,11,1092,1013,2105,2142
3405-000,2016,3,23,12,1116,915,2031,2105
3405-000,2016,3,23,13,934,889,1823,2031
3405-000,2016,3,23,14,941,1027,1968,1823
3405-000,2016,3,23,15,1117,1073,2190,1968
3405-000,2016,3,23,16,1131,982,2113,2190
3405-000,2016,3,23,17,1115,959,2074,2113
3405-000,2016,3,23,18,1234,1049,2283,2074
3405-000,2016,3,23,19,1133,1020,2153,2283
3405-000,2016,3,23,20,702,637,1339,2153
3405-000,2016,3,23,21,553,539,1092,1339
3405-000,2016,3,23,22,357,344,701,1092
3405-000,2016,3,23,23,260,205,465,701
3405-000,2016,3,23,24,126,182,308,465
3405-000,2016,3,24,1,113,118,231,308
3405-000,2016,3,24,2,63,85,148,231
3405-000,2016,3,24,3,53,46,99,148
3405-000,2016,3,24,4,68,68,136,99
3405-000,2016,3,24,5,87,98,185,136
3405-000,2016,3,24,6,212,207,419,185
3405-000,2016,3,24,7,558,473,1031,419
3405-000,2016,3,24,8,1093,1201,2294,1031
3405-000,2016,3,24,9,1335,1320,2655,2294
3405-000,2016,3,24,10,1134,974,2108,2655
3405-000,2016,3,24,11,1150,985,2135,2108
3405-000,2016,3,24,12,1045,940,1985,2135
3405-000,2016,3,24,13,909,855,1764,1985
3405-000,2016,3,24,14,992,982,1974,1764
3405-000,2016,3,24,15,1148,993,2141,1974
3405-000,2016,3,24,16,1127,976,2103,2141
3405-000,2016,3,24,17,1140,1006,2146,2103
3405-000,2016,3,24,18,1195,972,2167,2146
3405-000,2016,3,24,19,1073,994,2067,2167
3405-000,2016,3,24,20,705,666,1371,2067
3405-000,2016,3,24,21,596,561,1157,1371
3405-000,2016,3,24,22,390,410,800,1157
3405-000,2016,3,24,23,220,210,430,800
3405-000,2016,3,24,24,130,168,298,430
3405-000,2016,3,25,1,99,108,207,298
3405-000,2016,3,25,2,66,65,131,207
3405-000,2016,3,25,3,57,68,125,131
3405-000,2016,3,25,4,63,64,127,125
3405-000,2016,3,25,5,97,94,191,127
3405-000,2016,3,25,6,195,187,382,191
3405-000,2016,3,25,7,533,450,983,382
3405-000,2016,3,25,8,1071,1202,2273,983
3405-000,2016,3,25,9,1329,1225,2554,2273
3405-000,2016,3,25,10,1124,952,2076,2554
3405-000,2016,3,25,11,1167,1033,2200,2076
3405-000,2016,3,25,12,1133,972,2105,2200
3405-000,2016,3,25,13,958,884,1842,2105
3405-000,2016,3,25,14,1021,1070,2091,1842
3405-000,2016,3,25,15,1135,1049,2184,2091
3405-000,2016,3,25,16,1228,1022,2250,2184
3405-000,2016,3,25,17,1215,1038,2253,2250
3405-000,2016,3,25,18,1327,1088,2415,2253
3405-000,2016,3,25,19,1418,1113,2531,2415
3405-000,2016,3,25,20,951,750,1701,2531
3405-000,2016,3,25,21,649,571,1220,1701
3405-000,2016,3,25,22,475,389,864,1220
3405-000,2016,3,25,23,325,241,566,864
3405-000,2016,3,25,24,167,166,333,566
3405-000,2016,3,26,1,107,85,192,333
3405-000,2016,3,26,2,64,82,146,192
3405-000,2016,3,26,3,59,61,120,146
3405-000,2016,3,26,4,58,59,117,120
3405-000,2016,3,26,5,95,90,185,117
3405-000,2016,3,26,6,196,156,352,185
3405-000,2016,3,26,7,433,393,826,352
3405-000,2016,3,26,8,775,616,1391,826
3405-000,2016,3,26,9,830,770,1600,1391
3405-000,2016,3,26,10,852,839,1691,1600
3405-000,2016,3,26,11,896,850,1746,1691
3405-000,2016,3,26,12,881,873,1754,1746
3405-000,2016,3,26,13,785,732,1517,1754
3405-000,2016,3,26,14,799,821,1620,1517
3405-000,2016,3,26,15,860,768,1628,1620
3405-000,2016,3,26,16,872,817,1689,1628
3405-000,2016,3,26,17,953,756,1709,1689
3405-000,2016,3,26,18,1009,886,1895,1709
3405-000,2016,3,26,19,764,625,1389,1895
3405-000,2016,3,26,20,524,419,943,1389
3405-000,2016,3,26,21,341,366,707,943
3405-000,2016,3,26,22,258,257,515,707
3405-000,2016,3,26,23,191,191,382,515
3405-000,2016,3,26,24,129,140,269,382
3405-000,2016,3,27,1,96,82,178,269
3405-000,2016,3,27,2,62,59,121,178
3405-000,2016,3,27,3,38,36,74,121
3405-000,2016,3,27,4,40,32,72,74
3405-000,2016,3,27,5,44,31,75,72
3405-000,2016,3,27,6,100,79,179,75
3405-000,2016,3,27,7,226,155,381,179
3405-000,2016,3,27,8,360,261,621,381
3405-000,2016,3,27,9,472,354,826,621
3405-000,2016,3,27,10,549,389,938,826
3405-000,2016,3,27,11,600,448,1048,938
3405-000,2016,3,27,12,557,497,1054,1048
3405-000,2016,3,27,13,498,521,1019,1054
3405-000,2016,3,27,14,556,569,1125,1019
3405-000,2016,3,27,15,631,624,1255,1125
3405-000,2016,3,27,16,692,687,1379,1255
3405-000,2016,3,27,17,710,635,1345,1379
3405-000,2016,3,27,18,709,674,1383,1345
3405-000,2016,3,27,19,533,583,1116,1383
3405-000,2016,3,27,20,422,490,912,1116
3405-000,2016,3,27,21,357,420,777,912
3405-000,2016,3,27,22,289,425,714,777
3405-000,2016,3,27,23,175,266,441,714
3405-000,2016,3,27,24,109,154,263,441
3405-000,2016,3,28,1,60,77,137,263
3405-000,2016,3,28,2,42,63,105,137
3405-000,2016,3,28,3,38,52,90,105
3405-000,2016,3,28,4,49,51,100,90
3405-000,2016,3,28,5,152,101,253,100
3405-000,2016,3,28,6,214,247,461,253
3405-000,2016,3,28,7,566,665,1231,461
3405-000,2016,3,28,8,1234,1496,2730,1231
3405-000,2016,3,28,9,1381,1185,2566,2730
3405-000,2016,3,28,10,1027,971,1998,2566
3405-000,2016,3,28,11,1095,988,2083,1998
3405-000,2016,3,28,12,980,890,1870,2083
3405-000,2016,3,28,13,839,835,1674,1870
3405-000,2016,3,28,14,983,962,1945,1674
3405-000,2016,3,28,15,1113,946,2059,1945
3405-000,2016,3,28,16,1206,909,2115,2059
3405-000,2016,3,28,17,1421,1049,2470,2115
3405-000,2016,3,28,18,1454,1072,2526,2470
3405-000,2016,3,28,19,1080,987,2067,2526
3405-000,2016,3,28,20,798,656,1454,2067
3405-000,2016,3,28,21,654,590,1244,1454
3405-000,2016,3,28,22,347,378,725,1244
3405-000,2016,3,28,23,301,241,542,725
3405-000,2016,3,28,24,151,146,297,542
3405-000,2016,3,29,1,103,92,195,297
3405-000,2016,3,29,2,76,75,151,195
3405-000,2016,3,29,3,48,73,121,151
3405-000,2016,3,29,4,60,73,133,121
3405-000,2016,3,29,5,103,101,204,133
3405-000,2016,3,29,6,233,214,447,204
3405-000,2016,3,29,7,504,496,1000,447
3405-000,2016,3,29,8,1106,1280,2386,1000
3405-000,2016,3,29,9,1339,1218,2557,2386
3405-000,2016,3,29,10,1105,933,2038,2557
3405-000,2016,3,29,11,1111,1012,2123,2038
3405-000,2016,3,29,12,987,968,1955,2123
3405-000,2016,3,29,13,847,902,1749,1955
3405-000,2016,3,29,14,962,944,1906,1749
3405-000,2016,3,29,15,1115,1053,2168,1906
3405-000,2016,3,29,16,1062,913,1975,2168
3405-000,2016,3,29,17,1098,956,2054,1975
3405-000,2016,3,29,18,1148,1006,2154,2054
3405-000,2016,3,29,19,1079,1021,2100,2154
3405-000,2016,3,29,20,698,616,1314,2100
3405-000,2016,3,29,21,562,532,1094,1314
3405-000,2016,3,29,22,386,405,791,1094
3405-000,2016,3,29,23,216,208,424,791
3405-000,2016,3,29,24,136,171,307,424
3405-000,2016,3,30,1,82,92,174,307
3405-000,2016,3,30,2,63,80,143,174
3405-000,2016,3,30,3,56,67,123,143
3405-000,2016,3,30,4,61,58,119,123
3405-000,2016,3,30,5,89,89,178,119
3405-000,2016,3,30,6,221,228,449,178
3405-000,2016,3,30,7,506,484,990,449
3405-000,2016,3,30,8,1074,1277,2351,990
3405-000,2016,3,30,9,1305,1194,2499,2351
3405-000,2016,3,30,10,1157,1004,2161,2499
3405-000,2016,3,30,11,1129,1037,2166,2161
3405-000,2016,3,30,12,1107,950,2057,2166
3405-000,2016,3,30,13,967,895,1862,2057
3405-000,2016,3,30,14,1045,1051,2096,1862
3405-000,2016,3,30,15,1211,1069,2280,2096
3405-000,2016,3,30,16,1121,1035,2156,2280
3405-000,2016,3,30,17,1147,963,2110,2156
3405-000,2016,3,30,18,1240,1031,2271,2110
3405-000,2016,3,30,19,1166,1027,2193,2271
3405-000,2016,3,30,20,716,662,1378,2193
3405-000,2016,3,30,21,539,518,1057,1378
3405-000,2016,3,30,22,378,375,753,1057
3405-000,2016,3,30,23,255,230,485,753
3405-000,2016,3,30,24,134,150,284,485
3405-000,2016,3,31,1,128,95,223,284
3405-000,2016,3,31,2,60,81,141,223
3405-000,2016,3,31,3,48,51,99,141
3405-000,2016,3,31,4,67,55,122,99
3405-000,2016,3,31,5,104,98,202,122
3405-000,2016,3,31,6,237,213,450,202
3405-000,2016,3,31,7,534,498,1032,450
3405-000,2016,3,31,8,1099,1287,2386,1032
3405-000,2016,3,31,9,1292,1245,2537,2386
3405-000,2016,3,31,10,1189,939,2128,2537
3405-000,2016,3,31,11,1088,941,2029,2128
3405-000,2016,3,31,12,1060,947,2007,2029
3405-000,2016,3,31,13,859,826,1685,2007
3405-000,2016,3,31,14,982,1000,1982,1685
3405-000,2016,3,31,15,1137,1052,2189,1982
3405-000,2016,3,31,16,1148,924,2072,2189
3405-000,2016,3,31,17,1080,954,2034,2072
3405-000,2016,3,31,18,1156,1026,2182,2034
3405-000,2016,3,31,19,1080,984,2064,2182
3405-000,2016,3,31,20,739,675,1414,2064
3405-000,2016,3,31,21,559,566,1125,1414
3405-000,2016,3,31,22,385,382,767,1125
3405-000,2016,3,31,23,253,261,514,767
3405-000,2016,3,31,24,119,162,281,514
3405-000,2016,4,1,1,98,105,203,281
3405-000,2016,4,1,2,76,82,158,203
3405-000,2016,4,1,3,60,68,128,158
3405-000,2016,4,1,4,73,70,143,128
3405-000,2016,4,1,5,94,88,182,143
3405-000,2016,4,1,6,240,187,427,182
3405-000,2016,4,1,7,559,490,1049,427
3405-000,2016,4,1,8,1194,1225,2419,1049
3405-000,2016,4,1,9,1303,1185,2488,2419
3405-000,2016,4,1,10,1174,983,2157,2488
3405-000,2016,4,1,11,1214,1009,2223,2157
3405-000,2016,4,1,12,1094,996,2090,2223
3405-000,2016,4,1,13,938,906,1844,2090
3405-000,2016,4,1,14,1023,1040,2063,1844
3405-000,2016,4,1,15,1196,1042,2238,2063
3405-000,2016,4,1,16,1175,1046,2221,2238
3405-000,2016,4,1,17,1178,934,2112,2221
3405-000,2016,4,1,18,1372,1072,2444,2112
3405-000,2016,4,1,19,1467,1119,2586,2444
3405-000,2016,4,1,20,926,747,1673,2586
3405-000,2016,4,1,21,667,554,1221,1673
3405-000,2016,4,1,22,459,439,898,1221
3405-000,2016,4,1,23,301,248,549,898
3405-000,2016,4,1,24,186,191,377,549
3405-000,2016,4,2,1,131,114,245,377
3405-000,2016,4,2,2,69,80,149,245
3405-000,2016,4,2,3,72,67,139,149
3405-000,2016,4,2,4,62,59,121,139
3405-000,2016,4,2,5,87,73,160,121
3405-000,2016,4,2,6,227,153,380,160
3405-000,2016,4,2,7,397,360,757,380
3405-000,2016,4,2,8,811,602,1413,757
3405-000,2016,4,2,9,1001,747,1748,1413
3405-000,2016,4,2,10,890,857,1747,1748
3405-000,2016,4,2,11,958,917,1875,1747
3405-000,2016,4,2,12,937,821,1758,1875
3405-000,2016,4,2,13,910,759,1669,1758
3405-000,2016,4,2,14,862,869,1731,1669
3405-000,2016,4,2,15,898,835,1733,1731
3405-000,2016,4,2,16,870,811,1681,1733
3405-000,2016,4,2,17,862,789,1651,1681
3405-000,2016,4,2,18,968,945,1913,1651
3405-000,2016,4,2,19,805,709,1514,1913
3405-000,2016,4,2,20,528,523,1051,1514
3405-000,2016,4,2,21,402,396,798,1051
3405-000,2016,4,2,22,287,279,566,798
3405-000,2016,4,2,23,197,203,400,566
3405-000,2016,4,2,24,134,134,268,400
3405-000,2016,4,3,1,81,85,166,268
3405-000,2016,4,3,2,47,59,106,166
3405-000,2016,4,3,3,53,37,90,106
3405-000,2016,4,3,4,33,31,64,90
3405-000,2016,4,3,5,46,50,96,64
3405-000,2016,4,3,6,106,66,172,96
3405-000,2016,4,3,7,201,169,370,172
3405-000,2016,4,3,8,351,256,607,370
3405-000,2016,4,3,9,444,332,776,607
3405-000,2016,4,3,10,599,350,949,776
3405-000,2016,4,3,11,585,532,1117,949
3405-000,2016,4,3,12,554,561,1115,1117
3405-000,2016,4,3,13,542,567,1109,1115
3405-000,2016,4,3,14,520,608,1128,1109
3405-000,2016,4,3,15,655,614,1269,1128
3405-000,2016,4,3,16,648,586,1234,1269
3405-000,2016,4,3,17,646,674,1320,1234
3405-000,2016,4,3,18,691,652,1343,1320
3405-000,2016,4,3,19,607,631,1238,1343
3405-000,2016,4,3,20,491,494,985,1238
3405-000,2016,4,3,21,431,418,849,985
3405-000,2016,4,3,22,320,425,745,849
3405-000,2016,4,3,23,209,293,502,745
3405-000,2016,4,3,24,97,176,273,502
3405-000,2016,4,4,1,68,112,180,273
3405-000,2016,4,4,2,48,64,112,180
3405-000,2016,4,4,3,31,43,74,112
3405-000,2016,4,4,4,46,74,120,74
3405-000,2016,4,4,5,101,100,201,120
3405-000,2016,4,4,6,276,259,535,201
3405-000,2016,4,4,7,651,617,1268,535
3405-000,2016,4,4,8,1168,1442,2610,1268
3405-000,2016,4,4,9,1275,1352,2627,2610
3405-000,2016,4,4,10,1072,1004,2076,2627
3405-000,2016,4,4,11,1096,979,2075,2076
3405-000,2016,4,4,12,1027,950,1977,2075
3405-000,2016,4,4,13,890,879,1769,1977
3405-000,2016,4,4,14,1029,1039,2068,1769
3405-000,2016,4,4,15,1115,1074,2189,2068
3405-000,2016,4,4,16,1237,1051,2288,2189
3405-000,2016,4,4,17,1091,1066,2157,2288
3405-000,2016,4,4,18,1218,1002,2220,2157
3405-000,2016,4,4,19,1095,1054,2149,2220
3405-000,2016,4,4,20,744,681,1425,2149
3405-000,2016,4,4,21,571,626,1197,1425
3405-000,2016,4,4,22,380,413,793,1197
3405-000,2016,4,4,23,241,237,478,793
3405-000,2016,4,4,24,156,180,336,478
3405-000,2016,4,5,1,81,107,188,336
3405-000,2016,4,5,2,52,86,138,188
3405-000,2016,4,5,3,32,72,104,138
3405-000,2016,4,5,4,57,66,123,104
3405-000,2016,4,5,5,122,98,220,123
3405-000,2016,4,5,6,246,202,448,220
3405-000,2016,4,5,7,563,569,1132,448
3405-000,2016,4,5,8,1124,1321,2445,1132
3405-000,2016,4,5,9,1344,1237,2581,2445
3405-000,2016,4,5,10,1180,959,2139,2581
3405-000,2016,4,5,11,1175,992,2167,2139
3405-000,2016,4,5,12,1050,959,2009,2167
3405-000,2016,4,5,13,912,829,1741,2009
3405-000,2016,4,5,14,1011,1027,2038,1741
3405-000,2016,4,5,15,1188,1102,2290,2038
3405-000,2016,4,5,16,1210,1062,2272,2290
3405-000,2016,4,5,17,1128,975,2103,2272
3405-000,2016,4,5,18,1209,1065,2274,2103
3405-000,2016,4,5,19,1055,1016,2071,2274
3405-000,2016,4,5,20,728,682,1410,2071
3405-000,2016,4,5,21,593,558,1151,1410
3405-000,2016,4,5,22,353,396,749,1151
3405-000,2016,4,5,23,257,225,482,749
3405-000,2016,4,5,24,145,172,317,482
3405-000,2016,4,6,1,89,89,178,317
3405-000,2016,4,6,2,59,88,147,178
3405-000,2016,4,6,3,45,50,95,147
3405-000,2016,4,6,4,51,69,120,95
3405-000,2016,4,6,5,95,98,193,120
3405-000,2016,4,6,6,247,210,457,193
3405-000,2016,4,6,7,589,503,1092,457
3405-000,2016,4,6,8,1083,1284,2367,1092
3405-000,2016,4,6,9,1312,1256,2568,2367
3405-000,2016,4,6,10,1149,944,2093,2568
3405-000,2016,4,6,11,1149,1191,2340,2093
3405-000,2016,4,6,12,1128,1104,2232,2340
3405-000,2016,4,6,13,951,795,1746,2232
3405-000,2016,4,6,14,978,1043,2021,1746
3405-000,2016,4,6,15,1215,1060,2275,2021
3405-000,2016,4,6,16,1140,1064,2204,2275
3405-000,2016,4,6,17,1210,917,2127,2204
3405-000,2016,4,6,18,1225,1070,2295,2127
3405-000,2016,4,6,19,1146,1044,2190,2295
3405-000,2016,4,6,20,721,668,1389,2190
3405-000,2016,4,6,21,509,511,1020,1389
3405-000,2016,4,6,22,369,355,724,1020
3405-000,2016,4,6,23,242,209,451,724
3405-000,2016,4,6,24,120,166,286,451
3405-000,2016,4,7,1,97,79,176,286
3405-000,2016,4,7,2,63,58,121,176
3405-000,2016,4,7,3,41,59,100,121
3405-000,2016,4,7,4,56,78,134,100
3405-000,2016,4,7,5,75,86,161,134
3405-000,2016,4,7,6,178,176,354,161
3405-000,2016,4,7,7,503,404,907,354
3405-000,2016,4,7,8,999,1234,2233,907
3405-000,2016,4,7,9,1277,1154,2431,2233
3405-000,2016,4,7,10,1116,930,2046,2431
3405-000,2016,4,7,11,1020,953,1973,2046
3405-000,2016,4,7,12,1043,876,1919,1973
3405-000,2016,4,7,13,857,818,1675,1919
3405-000,2016,4,7,14,974,930,1904,1675
3405-000,2016,4,7,15,1059,1015,2074,1904
3405-000,2016,4,7,16,1015,969,1984,2074
3405-000,2016,4,7,17,1035,918,1953,1984
3405-000,2016,4,7,18,1116,975,2091,1953
3405-000,2016,4,7,19,1031,1035,2066,2091
3405-000,2016,4,7,20,716,674,1390,2066
3405-000,2016,4,7,21,568,529,1097,1390
3405-000,2016,4,7,22,408,395,803,1097
3405-000,2016,4,7,23,217,215,432,803
3405-000,2016,4,7,24,146,158,304,432
3405-000,2016,4,8,1,96,111,207,304
3405-000,2016,4,8,2,66,72,138,207
3405-000,2016,4,8,3,42,72,114,138
3405-000,2016,4,8,4,53,71,124,114
3405-000,2016,4,8,5,114,98,212,124
3405-000,2016,4,8,6,229,212,441,212
3405-000,2016,4,8,7,553,506,1059,441
3405-000,2016,4,8,8,1085,1265,2350,1059
3405-000,2016,4,8,9,1347,1229,2576,2350
3405-000,2016,4,8,10,1103,959,2062,2576
3405-000,2016,4,8,11,1126,947,2073,2062
3405-000,2016,4,8,12,1101,958,2059,2073
3405-000,2016,4,8,13,941,849,1790,2059
3405-000,2016,4,8,14,1022,1041,2063,1790
3405-000,2016,4,8,15,1151,1088,2239,2063
3405-000,2016,4,8,16,1256,996,2252,2239
3405-000,2016,4,8,17,1204,1002,2206,2252
3405-000,2016,4,8,18,1398,1075,2473,2206
3405-000,2016,4,8,19,1440,1110,2550,2473
3405-000,2016,4,8,20,939,770,1709,2550
3405-000,2016,4,8,21,722,674,1396,1709
3405-000,2016,4,8,22,463,451,914,1396
3405-000,2016,4,8,23,265,239,504,914
3405-000,2016,4,8,24,169,184,353,504
3405-000,2016,4,9,1,114,126,240,353
3405-000,2016,4,9,2,93,82,175,240
3405-000,2016,4,9,3,76,61,137,175
3405-000,2016,4,9,4,57,66,123,137
3405-000,2016,4,9,5,81,92,173,123
3405-000,2016,4,9,6,220,167,387,173
3405-000,2016,4,9,7,467,360,827,387
3405-000,2016,4,9,8,771,624,1395,827
3405-000,2016,4,9,9,913,754,1667,1395
3405-000,2016,4,9,10,912,864,1776,1667
3405-000,2016,4,9,11,1072,1059,2131,1776
3405-000,2016,4,9,12,1047,1050,2097,2131
3405-000,2016,4,9,13,1014,768,1782,2097
3405-000,2016,4,9,14,807,1015,1822,1782
3405-000,2016,4,9,15,925,895,1820,1822
3405-000,2016,4,9,16,875,811,1686,1820
3405-000,2016,4,9,17,886,790,1676,1686
3405-000,2016,4,9,18,1055,917,1972,1676
3405-000,2016,4,9,19,790,681,1471,1972
3405-000,2016,4,9,20,545,510,1055,1471
3405-000,2016,4,9,21,387,382,769,1055
3405-000,2016,4,9,22,311,274,585,769
3405-000,2016,4,9,23,206,189,395,585
3405-000,2016,4,9,24,124,163,287,395
3405-000,2016,4,10,1,83,88,171,287
3405-000,2016,4,10,2,50,61,111,171
3405-000,2016,4,10,3,35,14,49,111
3405-000,2016,4,10,4,31,29,60,49
3405-000,2016,4,10,5,51,35,86,60
3405-000,2016,4,10,6,112,66,178,86
3405-000,2016,4,10,7,214,178,392,178
3405-000,2016,4,10,8,348,303,651,392
3405-000,2016,4,10,9,482,349,831,651
3405-000,2016,4,10,10,513,393,906,831
3405-000,2016,4,10,11,584,480,1064,906
3405-000,2016,4,10,12,631,483,1114,1064
3405-000,2016,4,10,13,579,534,1113,1114
3405-000,2016,4,10,14,532,525,1057,1113
3405-000,2016,4,10,15,673,630,1303,1057
3405-000,2016,4,10,16,665,661,1326,1303
3405-000,2016,4,10,17,765,692,1457,1326
3405-000,2016,4,10,18,797,759,1556,1457
3405-000,2016,4,10,19,592,615,1207,1556
3405-000,2016,4,10,20,464,477,941,1207
3405-000,2016,4,10,21,392,483,875,941
3405-000,2016,4,10,22,295,372,667,875
3405-000,2016,4,10,23,206,288,494,667
3405-000,2016,4,10,24,124,148,272,494
3405-000,2016,4,11,1,68,97,165,272
3405-000,2016,4,11,2,37,63,100,165
3405-000,2016,4,11,3,43,60,103,100
3405-000,2016,4,11,4,39,62,101,103
3405-000,2016,4,11,5,93,92,185,101
3405-000,2016,4,11,6,313,296,609,185
3405-000,2016,4,11,7,629,683,1312,609
3405-000,2016,4,11,8,1182,1580,2762,1312
3405-000,2016,4,11,9,1284,1319,2603,2762
3405-000,2016,4,11,10,1120,998,2118,2603
3405-000,2016,4,11,11,1045,1054,2099,2118
3405-000,2016,4,11,12,1178,978,2156,2099
3405-000,2016,4,11,13,914,883,1797,2156
3405-000,2016,4,11,14,996,1035,2031,1797
3405-000,2016,4,11,15,1189,1050,2239,2031
3405-000,2016,4,11,16,1126,1058,2184,2239
3405-000,2016,4,11,17,1117,1024,2141,2184
3405-000,2016,4,11,18,1160,1047,2207,2141
3405-000,2016,4,11,19,1169,1039,2208,2207
3405-000,2016,4,11,20,863,697,1560,2208
3405-000,2016,4,11,21,636,592,1228,1560
3405-000,2016,4,11,22,392,435,827,1228
3405-000,2016,4,11,23,283,268,551,827
3405-000,2016,4,11,24,136,168,304,551
3405-000,2016,4,12,1,91,90,181,304
3405-000,2016,4,12,2,76,58,134,181
3405-000,2016,4,12,3,55,81,136,134
3405-000,2016,4,12,4,71,70,141,136
3405-000,2016,4,12,5,97,84,181,141
3405-000,2016,4,12,6,281,231,512,181
3405-000,2016,4,12,7,621,525,1146,512
3405-000,2016,4,12,8,1190,1316,2506,1146
3405-000,2016,4,12,9,1349,1302,2651,2506
3405-000,2016,4,12,10,1144,1061,2205,2651
3405-000,2016,4,12,11,1195,1081,2276,2205
3405-000,2016,4,12,12,1112,947,2059,2276
3405-000,2016,4,12,13,984,949,1933,2059
3405-000,2016,4,12,14,1090,1004,2094,1933
3405-000,2016,4,12,15,1195,1133,2328,2094
3405-000,2016,4,12,16,1300,1083,2383,2328
3405-000,2016,4,12,17,1225,1072,2297,2383
3405-000,2016,4,12,18,1295,1427,2722,2297
3405-000,2016,4,12,19,1439,1239,2678,2722
3405-000,2016,4,12,20,955,824,1779,2678
3405-000,2016,4,12,21,852,626,1478,1779
3405-000,2016,4,12,22,511,449,960,1478
3405-000,2016,4,12,23,334,233,567,960
3405-000,2016,4,12,24,220,163,383,567
3405-000,2016,4,13,1,133,104,237,383
3405-000,2016,4,13,2,104,56,160,237
3405-000,2016,4,13,3,58,56,114,160
3405-000,2016,4,13,4,106,71,177,114
3405-000,2016,4,13,5,119,67,186,177
3405-000,2016,4,13,6,203,136,339,186
3405-000,2016,4,13,7,354,255,609,339
3405-000,2016,4,13,8,630,581,1211,609
3405-000,2016,4,13,9,792,673,1465,1211
3405-000,2016,4,13,10,808,674,1482,1465
3405-000,2016,4,13,11,852,734,1586,1482
3405-000,2016,4,13,12,784,690,1474,1586
3405-000,2016,4,13,13,717,659,1376,1474
3405-000,2016,4,13,14,831,720,1551,1376
3405-000,2016,4,13,15,823,736,1559,1551
3405-000,2016,4,13,16,790,754,1544,1559
3405-000,2016,4,13,17,778,703,1481,1544
3405-000,2016,4,13,18,792,787,1579,1481
3405-000,2016,4,13,19,662,653,1315,1579
3405-000,2016,4,13,20,532,530,1062,1315
3405-000,2016,4,13,21,343,378,721,1062
3405-000,2016,4,13,22,309,295,604,721
3405-000,2016,4,13,23,198,202,400,604
3405-000,2016,4,13,24,111,154,265,400
3405-000,2016,4,14,1,87,101,188,265
3405-000,2016,4,14,2,44,69,113,188
3405-000,2016,4,14,3,34,50,84,113
3405-000,2016,4,14,4,81,56,137,84
3405-000,2016,4,14,5,152,100,252,137
3405-000,2016,4,14,6,277,250,527,252
3405-000,2016,4,14,7,634,584,1218,527
3405-000,2016,4,14,8,1170,1373,2543,1218
3405-000,2016,4,14,9,1385,1331,2716,2543
3405-000,2016,4,14,10,1164,921,2085,2716
3405-000,2016,4,14,11,1126,1042,2168,2085
3405-000,2016,4,14,12,1095,968,2063,2168
3405-000,2016,4,14,13,951,891,1842,2063
3405-000,2016,4,14,14,984,1043,2027,1842
3405-000,2016,4,14,15,1105,1110,2215,2027
3405-000,2016,4,14,16,1186,1064,2250,2215
3405-000,2016,4,14,17,1131,927,2058,2250
3405-000,2016,4,14,18,1291,1025,2316,2058
3405-000,2016,4,14,19,1212,1060,2272,2316
3405-000,2016,4,14,20,644,647,1291,2272
3405-000,2016,4,14,21,586,633,1219,1291
3405-000,2016,4,14,22,422,442,864,1219
3405-000,2016,4,14,23,246,208,454,864
3405-000,2016,4,14,24,168,155,323,454
3405-000,2016,4,15,1,81,106,187,323
3405-000,2016,4,15,2,66,76,142,187
3405-000,2016,4,15,3,52,53,105,142
3405-000,2016,4,15,4,57,74,131,105
3405-000,2016,4,15,5,91,83,174,131
3405-000,2016,4,15,6,224,199,423,174
3405-000,2016,4,15,7,558,535,1093,423
3405-000,2016,4,15,8,1150,1313,2463,1093
3405-000,2016,4,15,9,1359,1268,2627,2463
3405-000,2016,4,15,10,1171,998,2169,2627
3405-000,2016,4,15,11,1206,1032,2238,2169
3405-000,2016,4,15,12,1146,961,2107,2238
3405-000,2016,4,15,13,982,994,1976,2107
3405-000,2016,4,15,14,1065,995,2060,1976
3405-000,2016,4,15,15,1253,1094,2347,2060
3405-000,2016,4,15,16,1227,1075,2302,2347
3405-000,2016,4,15,17,1209,1046,2255,2302
3405-000,2016,4,15,18,1548,1125,2673,2255
3405-000,2016,4,15,19,1530,1195,2725,2673
3405-000,2016,4,15,20,1034,819,1853,2725
3405-000,2016,4,15,21,733,632,1365,1853
3405-000,2016,4,15,22,480,440,920,1365
3405-000,2016,4,15,23,351,270,621,920
3405-000,2016,4,15,24,182,185,367,621
3405-000,2016,4,16,1,116,104,220,367
3405-000,2016,4,16,2,90,88,178,220
3405-000,2016,4,16,3,59,57,116,178
3405-000,2016,4,16,4,79,77,156,116
3405-000,2016,4,16,5,84,94,178,156
3405-000,2016,4,16,6,209,175,384,178
3405-000,2016,4,16,7,439,386,825,384
3405-000,2016,4,16,8,774,695,1469,825
3405-000,2016,4,16,9,963,734,1697,1469
3405-000,2016,4,16,10,898,779,1677,1697
3405-000,2016,4,16,11,958,893,1851,1677
3405-000,2016,4,16,12,866,866,1732,1851
3405-000,2016,4,16,13,753,792,1545,1732
3405-000,2016,4,16,14,803,796,1599,1545
3405-000,2016,4,16,15,829,709,1538,1599
3405-000,2016,4,16,16,874,705,1579,1538
3405-000,2016,4,16,17,917,746,1663,1579
3405-000,2016,4,16,18,906,818,1724,1663
3405-000,2016,4,16,19,726,579,1305,1724
3405-000,2016,4,16,20,441,495,936,1305
3405-000,2016,4,16,21,351,322,673,936
3405-000,2016,4,16,22,229,229,458,673
3405-000,2016,4,16,23,237,185,422,458
3405-000,2016,4,16,24,135,111,246,422
3405-000,2016,4,17,1,67,76,143,246
3405-000,2016,4,17,2,43,44,87,143
3405-000,2016,4,17,3,31,42,73,87
3405-000,2016,4,17,4,48,21,69,73
3405-000,2016,4,17,5,39,41,80,69
3405-000,2016,4,17,6,106,82,188,80
3405-000,2016,4,17,7,191,134,325,188
3405-000,2016,4,17,8,292,243,535,325
3405-000,2016,4,17,9,390,348,738,535
3405-000,2016,4,17,10,442,314,756,738
3405-000,2016,4,17,11,574,421,995,756
3405-000,2016,4,17,12,522,478,1000,995
3405-000,2016,4,17,13,538,492,1030,1000
3405-000,2016,4,17,14,556,503,1059,1030
3405-000,2016,4,17,15,575,572,1147,1059
3405-000,2016,4,17,16,631,631,1262,1147
3405-000,2016,4,17,17,668,572,1240,1262
3405-000,2016,4,17,18,617,620,1237,1240
3405-000,2016,4,17,19,559,565,1124,1237
3405-000,2016,4,17,20,459,512,971,1124
3405-000,2016,4,17,21,364,440,804,971
3405-000,2016,4,17,22,264,338,602,804
3405-000,2016,4,17,23,205,250,455,602
3405-000,2016,4,17,24,120,174,294,455
3405-000,2016,4,18,1,75,104,179,294
3405-000,2016,4,18,2,38,69,107,179
3405-000,2016,4,18,3,27,42,69,107
3405-000,2016,4,18,4,40,61,101,69
3405-000,2016,4,18,5,106,127,233,101
3405-000,2016,4,18,6,285,283,568,233
3405-000,2016,4,18,7,663,720,1383,568
3405-000,2016,4,18,8,1149,1493,2642,1383
3405-000,2016,4,18,9,1304,1284,2588,2642
3405-000,2016,4,18,10,1104,913,2017,2588
3405-000,2016,4,18,11,1090,1052,2142,2017
3405-000,2016,4,18,12,1087,1007,2094,2142
3405-000,2016,4,18,13,953,909,1862,2094
3405-000,2016,4,18,14,1002,989,1991,1862
3405-000,2016,4,18,15,1184,1052,2236,1991
3405-000,2016,4,18,16,1099,1067,2166,2236
3405-000,2016,4,18,17,1155,996,2151,2166
3405-000,2016,4,18,18,1182,975,2157,2151
3405-000,2016,4,18,19,1050,993,2043,2157
3405-000,2016,4,18,20,717,632,1349,2043
3405-000,2016,4,18,21,571,543,1114,1349
3405-000,2016,4,18,22,328,405,733,1114
3405-000,2016,4,18,23,220,193,413,733
3405-000,2016,4,18,24,108,175,283,413
3405-000,2016,4,19,1,80,107,187,283
3405-000,2016,4,19,2,68,80,148,187
3405-000,2016,4,19,3,54,64,118,148
3405-000,2016,4,19,4,62,62,124,118
3405-000,2016,4,19,5,107,87,194,124
3405-000,2016,4,19,6,225,212,437,194
3405-000,2016,4,19,7,527,524,1051,437
3405-000,2016,4,19,8,1121,1286,2407,1051
3405-000,2016,4,19,9,1349,1218,2567,2407
3405-000,2016,4,19,10,1163,989,2152,2567
3405-000,2016,4,19,11,1202,1041,2243,2152
3405-000,2016,4,19,12,1049,970,2019,2243
3405-000,2016,4,19,13,911,932,1843,2019
3405-000,2016,4,19,14,1034,1039,2073,1843
3405-000,2016,4,19,15,1131,1124,2255,2073
3405-000,2016,4,19,16,1191,1021,2212,2255
3405-000,2016,4,19,17,1092,1053,2145,2212
3405-000,2016,4,19,18,1303,976,2279,2145
3405-000,2016,4,19,19,1129,1063,2192,2279
3405-000,2016,4,19,20,713,723,1436,2192
3405-000,2016,4,19,21,548,617,1165,1436
3405-000,2016,4,19,22,390,383,773,1165
3405-000,2016,4,19,23,257,251,508,773
3405-000,2016,4,19,24,163,180,343,508
3405-000,2016,4,20,1,99,122,221,343
3405-000,2016,4,20,2,75,76,151,221
3405-000,2016,4,20,3,55,56,111,151
3405-000,2016,4,20,4,68,68,136,111
3405-000,2016,4,20,5,100,102,202,136
3405-000,2016,4,20,6,233,204,437,202
3405-000,2016,4,20,7,578,522,1100,437
3405-000,2016,4,20,8,1115,1265,2380,1100
3405-000,2016,4,20,9,1345,1278,2623,2380
3405-000,2016,4,20,10,1179,1017,2196,2623
3405-000,2016,4,20,11,1134,1024,2158,2196
3405-000,2016,4,20,12,1044,1000,2044,2158
3405-000,2016,4,20,13,893,920,1813,2044
3405-000,2016,4,20,14,1086,1097,2183,1813
3405-000,2016,4,20,15,1209,1035,2244,2183
3405-000,2016,4,20,16,1113,1043,2156,2244
3405-000,2016,4,20,17,1109,954,2063,2156
3405-000,2016,4,20,18,1347,1042,2389,2063
3405-000,2016,4,20,19,1110,984,2094,2389
3405-000,2016,4,20,20,700,614,1314,2094
3405-000,2016,4,20,21,563,529,1092,1314
3405-000,2016,4,20,22,346,363,709,1092
3405-000,2016,4,20,23,246,224,470,709
3405-000,2016,4,20,24,133,172,305,470
3405-000,2016,4,21,1,97,99,196,305
3405-000,2016,4,21,2,57,73,130,196
3405-000,2016,4,21,3,41,62,103,130
3405-000,2016,4,21,4,58,65,123,103
3405-000,2016,4,21,5,74,88,162,123
3405-000,2016,4,21,6,196,173,369,162
3405-000,2016,4,21,7,485,441,926,369
3405-000,2016,4,21,8,943,1154,2097,926
3405-000,2016,4,21,9,1310,1163,2473,2097
3405-000,2016,4,21,10,1016,891,1907,2473
3405-000,2016,4,21,11,1018,882,1900,1907
3405-000,2016,4,21,12,992,865,1857,1900
3405-000,2016,4,21,13,863,803,1666,1857
3405-000,2016,4,21,14,1000,924,1924,1666
3405-000,2016,4,21,15,1079,1014,2093,1924
3405-000,2016,4,21,16,1113,924,2037,2093
3405-000,2016,4,21,17,1069,975,2044,2037
3405-000,2016,4,21,18,1196,937,2133,2044
3405-000,2016,4,21,19,1001,997,1998,2133
3405-000,2016,4,21,20,740,645,1385,1998
3405-000,2016,4,21,21,554,557,1111,1385
3405-000,2016,4,21,22,405,396,801,1111
3405-000,2016,4,21,23,265,257,522,801
3405-000,2016,4,21,24,146,180,326,522
3405-000,2016,4,22,1,90,99,189,326
3405-000,2016,4,22,2,73,78,151,189
3405-000,2016,4,22,3,57,71,128,151
3405-000,2016,4,22,4,70,67,137,128
3405-000,2016,4,22,5,110,116,226,137
3405-000,2016,4,22,6,262,214,476,226
3405-000,2016,4,22,7,615,529,1144,476
3405-000,2016,4,22,8,1071,1251,2322,1144
3405-000,2016,4,22,9,1335,1245,2580,2322
3405-000,2016,4,22,10,1167,978,2145,2580
3405-000,2016,4,22,11,1122,980,2102,2145
3405-000,2016,4,22,12,1111,918,2029,2102
3405-000,2016,4,22,13,918,931,1849,2029
3405-000,2016,4,22,14,1065,1007,2072,1849
3405-000,2016,4,22,15,1211,1117,2328,2072
3405-000,2016,4,22,16,1250,1088,2338,2328
3405-000,2016,4,22,17,1243,1010,2253,2338
3405-000,2016,4,22,18,1512,1188,2700,2253
3405-000,2016,4,22,19,1469,1279,2748,2700
3405-000,2016,4,22,20,949,841,1790,2748
3405-000,2016,4,22,21,769,594,1363,1790
3405-000,2016,4,22,22,424,389,813,1363
3405-000,2016,4,22,23,280,262,542,813
3405-000,2016,4,22,24,171,176,347,542
3405-000,2016,4,23,1,107,90,197,347
3405-000,2016,4,23,2,78,74,152,197
3405-000,2016,4,23,3,50,60,110,152
3405-000,2016,4,23,4,54,75,129,110
3405-000,2016,4,23,5,103,91,194,129
3405-000,2016,4,23,6,231,172,403,194
3405-000,2016,4,23,7,449,394,843,403
3405-000,2016,4,23,8,763,649,1412,843
3405-000,2016,4,23,9,981,816,1797,1412
3405-000,2016,4,23,10,860,831,1691,1797
3405-000,2016,4,23,11,941,898,1839,1691
3405-000,2016,4,23,12,885,970,1855,1839
3405-000,2016,4,23,13,808,862,1670,1855
3405-000,2016,4,23,14,791,867,1658,1670
3405-000,2016,4,23,15,807,786,1593,1658
3405-000,2016,4,23,16,925,776,1701,1593
3405-000,2016,4,23,17,885,754,1639,1701
3405-000,2016,4,23,18,1034,893,1927,1639
3405-000,2016,4,23,19,892,788,1680,1927
3405-000,2016,4,23,20,596,564,1160,1680
3405-000,2016,4,23,21,417,364,781,1160
3405-000,2016,4,23,22,285,295,580,781
3405-000,2016,4,23,23,192,213,405,580
3405-000,2016,4,23,24,122,131,253,405
3405-000,2016,4,24,1,86,81,167,253
3405-000,2016,4,24,2,52,51,103,167
3405-000,2016,4,24,3,46,39,85,103
3405-000,2016,4,24,4,33,37,70,85
3405-000,2016,4,24,5,47,43,90,70
3405-000,2016,4,24,6,127,84,211,90
3405-000,2016,4,24,7,252,177,429,211
3405-000,2016,4,24,8,379,308,687,429
3405-000,2016,4,24,9,470,338,808,687
3405-000,2016,4,24,10,541,413,954,808
3405-000,2016,4,24,11,582,466,1048,954
3405-000,2016,4,24,12,510,518,1028,1048
3405-000,2016,4,24,13,541,549,1090,1028
3405-000,2016,4,24,14,567,501,1068,1090
3405-000,2016,4,24,15,621,626,1247,1068
3405-000,2016,4,24,16,654,611,1265,1247
3405-000,2016,4,24,17,807,607,1414,1265
3405-000,2016,4,24,18,781,636,1417,1414
3405-000,2016,4,24,19,755,610,1365,1417
3405-000,2016,4,24,20,604,567,1171,1365
3405-000,2016,4,24,21,430,529,959,1171
3405-000,2016,4,24,22,399,396,795,959
3405-000,2016,4,24,23,227,330,557,795
3405-000,2016,4,24,24,94,186,280,557
3405-000,2016,4,25,1,65,99,164,280
3405-000,2016,4,25,2,42,59,101,164
3405-000,2016,4,25,3,49,51,100,101
3405-000,2016,4,25,4,129,60,189,100
3405-000,2016,4,25,5,20,107,127,189
3405-000,2016,4,25,6,86,257,343,127
3405-000,2016,4,25,7,333,724,1057,343
3405-000,2016,4,25,8,664,1513,2177,1057
3405-000,2016,4,25,9,946,1427,2373,2177
3405-000,2016,4,25,10,1089,954,2043,2373
3405-000,2016,4,25,11,1113,986,2099,2043
3405-000,2016,4,25,12,1032,934,1966,2099
3405-000,2016,4,25,13,922,857,1779,1966
3405-000,2016,4,25,14,1047,960,2007,1779
3405-000,2016,4,25,15,1177,1073,2250,2007
3405-000,2016,4,25,16,1092,1061,2153,2250
3405-000,2016,4,25,17,1160,939,2099,2153
3405-000,2016,4,25,18,1136,1026,2162,2099
3405-000,2016,4,25,19,1107,1034,2141,2162
3405-000,2016,4,25,20,682,708,1390,2141
3405-000,2016,4,25,21,578,653,1231,1390
3405-000,2016,4,25,22,368,475,843,1231
3405-000,2016,4,25,23,292,246,538,843
3405-000,2016,4,25,24,128,174,302,538
3405-000,2016,4,26,1,108,114,222,302
3405-000,2016,4,26,2,61,88,149,222
3405-000,2016,4,26,3,57,75,132,149
3405-000,2016,4,26,4,59,62,121,132
3405-000,2016,4,26,5,110,124,234,121
3405-000,2016,4,26,6,257,228,485,234
3405-000,2016,4,26,7,589,543,1132,485
3405-000,2016,4,26,8,1077,1296,2373,1132
3405-000,2016,4,26,9,1373,1304,2677,2373
3405-000,2016,4,26,10,1206,1017,2223,2677
3405-000,2016,4,26,11,1257,1014,2271,2223
3405-000,2016,4,26,12,1213,883,2096,2271
3405-000,2016,4,26,13,1018,758,1776,2096
3405-000,2016,4,26,14,1014,978,1992,1776
3405-000,2016,4,26,15,1152,1088,2240,1992
3405-000,2016,4,26,16,1135,974,2109,2240
3405-000,2016,4,26,17,1124,1014,2138,2109
3405-000,2016,4,26,18,1202,1060,2262,2138
3405-000,2016,4,26,19,1138,1012,2150,2262
3405-000,2016,4,26,20,764,690,1454,2150
3405-000,2016,4,26,21,630,590,1220,1454
3405-000,2016,4,26,22,407,461,868,1220
3405-000,2016,4,26,23,239,273,512,868
3405-000,2016,4,26,24,162,182,344,512
3405-000,2016,4,27,1,84,111,195,344
3405-000,2016,4,27,2,63,78,141,195
3405-000,2016,4,27,3,57,69,126,141
3405-000,2016,4,27,4,62,83,145,126
3405-000,2016,4,27,5,114,89,203,145
3405-000,2016,4,27,6,264,209,473,203
3405-000,2016,4,27,7,567,527,1094,473
3405-000,2016,4,27,8,1046,1221,2267,1094
3405-000,2016,4,27,9,1292,1311,2603,2267
3405-000,2016,4,27,10,1150,953,2103,2603
3405-000,2016,4,27,11,1140,1066,2206,2103
3405-000,2016,4,27,12,1068,906,1974,2206
3405-000,2016,4,27,13,900,887,1787,1974
3405-000,2016,4,27,14,1026,939,1965,1787
3405-000,2016,4,27,15,1135,1059,2194,1965
3405-000,2016,4,27,16,1133,980,2113,2194
3405-000,2016,4,27,17,1125,960,2085,2113
3405-000,2016,4,27,18,1229,966,2195,2085
3405-000,2016,4,27,19,1154,1017,2171,2195
3405-000,2016,4,27,20,677,632,1309,2171
3405-000,2016,4,27,21,509,501,1010,1309
3405-000,2016,4,27,22,379,384,763,1010
3405-000,2016,4,27,23,242,224,466,763
3405-000,2016,4,27,24,171,170,341,466
3405-000,2016,4,28,1,90,79,169,341
3405-000,2016,4,28,2,73,94,167,169
3405-000,2016,4,28,3,53,67,120,167
3405-000,2016,4,28,4,67,57,124,120
3405-000,2016,4,28,5,102,97,199,124
3405-000,2016,4,28,6,248,218,466,199
3405-000,2016,4,28,7,582,528,1110,466
3405-000,2016,4,28,8,1042,1235,2277,1110
3405-000,2016,4,28,9,1356,1325,2681,2277
3405-000,2016,4,28,10,1148,976,2124,2681
3405-000,2016,4,28,11,1135,995,2130,2124
3405-000,2016,4,28,12,1027,1010,2037,2130
3405-000,2016,4,28,13,940,826,1766,2037
3405-000,2016,4,28,14,976,976,1952,1766
3405-000,2016,4,28,15,1079,1056,2135,1952
3405-000,2016,4,28,16,1081,1064,2145,2135
3405-000,2016,4,28,17,1143,956,2099,2145
3405-000,2016,4,28,18,1165,1032,2197,2099
3405-000,2016,4,28,19,1035,1021,2056,2197
3405-000,2016,4,28,20,710,710,1420,2056
3405-000,2016,4,28,21,646,616,1262,1420
3405-000,2016,4,28,22,427,433,860,1262
3405-000,2016,4,28,23,288,224,512,860
3405-000,2016,4,28,24,181,192,373,512
3405-000,2016,4,29,1,113,133,246,373
3405-000,2016,4,29,2,70,60,130,246
3405-000,2016,4,29,3,71,73,144,130
3405-000,2016,4,29,4,64,78,142,144
3405-000,2016,4,29,5,97,92,189,142
3405-000,2016,4,29,6,256,232,488,189
3405-000,2016,4,29,7,585,505,1090,488
3405-000,2016,4,29,8,1082,1214,2296,1090
3405-000,2016,4,29,9,1367,1168,2535,2296
3405-000,2016,4,29,10,1164,962,2126,2535
3405-000,2016,4,29,11,1158,1012,2170,2126
3405-000,2016,4,29,12,1159,905,2064,2170
3405-000,2016,4,29,13,927,798,1725,2064
3405-000,2016,4,29,14,993,954,1947,1725
3405-000,2016,4,29,15,1189,1012,2201,1947
3405-000,2016,4,29,16,1191,1011,2202,2201
3405-000,2016,4,29,17,1265,1111,2376,2202
3405-000,2016,4,29,18,1661,1211,2872,2376
3405-000,2016,4,29,19,1716,1369,3085,2872
3405-000,2016,4,29,20,1337,878,2215,3085
3405-000,2016,4,29,21,789,640,1429,2215
3405-000,2016,4,29,22,538,420,958,1429
3405-000,2016,4,29,23,315,302,617,958
3405-000,2016,4,29,24,184,172,356,617
3405-000,2016,4,30,1,145,127,272,356
3405-000,2016,4,30,2,78,92,170,272
3405-000,2016,4,30,3,70,72,142,170
3405-000,2016,4,30,4,80,80,160,142
3405-000,2016,4,30,5,86,81,167,160
3405-000,2016,4,30,6,233,185,418,167
3405-000,2016,4,30,7,440,411,851,418
3405-000,2016,4,30,8,724,611,1335,851
3405-000,2016,4,30,9,941,754,1695,1335
3405-000,2016,4,30,10,917,800,1717,1695
3405-000,2016,4,30,11,970,824,1794,1717
3405-000,2016,4,30,12,946,803,1749,1794
3405-000,2016,4,30,13,807,759,1566,1749
3405-000,2016,4,30,14,875,756,1631,1566
3405-000,2016,4,30,15,817,900,1717,1631
3405-000,2016,4,30,16,802,771,1573,1717
3405-000,2016,4,30,17,908,713,1621,1573
3405-000,2016,4,30,18,986,839,1825,1621
3405-000,2016,4,30,19,823,675,1498,1825
3405-000,2016,4,30,20,526,599,1125,1498
3405-000,2016,4,30,21,371,392,763,1125
3405-000,2016,4,30,22,328,296,624,763
3405-000,2016,4,30,23,239,207,446,624
3405-000,2016,4,30,24,121,137,258,446
3405-000,2016,5,1,1,74,93,167,258
3405-000,2016,5,1,2,62,61,123,167
3405-000,2016,5,1,3,55,39,94,123
3405-000,2016,5,1,4,43,28,71,94
3405-000,2016,5,1,5,51,51,102,71
3405-000,2016,5,1,6,132,89,221,102
3405-000,2016,5,1,7,237,173,410,221
3405-000,2016,5,1,8,386,288,674,410
3405-000,2016,5,1,9,502,353,855,674
3405-000,2016,5,1,10,554,385,939,855
3405-000,2016,5,1,11,592,441,1033,939
3405-000,2016,5,1,12,535,483,1018,1033
3405-000,2016,5,1,13,588,493,1081,1018
3405-000,2016,5,1,14,548,582,1130,1081
3405-000,2016,5,1,15,590,617,1207,1130
3405-000,2016,5,1,16,583,617,1200,1207
3405-000,2016,5,1,17,639,637,1276,1200
3405-000,2016,5,1,18,636,688,1324,1276
3405-000,2016,5,1,19,527,711,1238,1324
3405-000,2016,5,1,20,474,535,1009,1238
3405-000,2016,5,1,21,377,510,887,1009
3405-000,2016,5,1,22,351,411,762,887
3405-000,2016,5,1,23,223,271,494,762
3405-000,2016,5,1,24,119,202,321,494
3405-000,2016,5,2,1,83,121,204,321
3405-000,2016,5,2,2,55,66,121,204
3405-000,2016,5,2,3,33,47,80,121
3405-000,2016,5,2,4,54,76,130,80
3405-000,2016,5,2,5,102,96,198,130
3405-000,2016,5,2,6,287,280,567,198
3405-000,2016,5,2,7,642,708,1350,567
3405-000,2016,5,2,8,1078,1484,2562,1350
3405-000,2016,5,2,9,1271,1333,2604,2562
3405-000,2016,5,2,10,967,985,1952,2604
3405-000,2016,5,2,11,1086,1098,2184,1952
3405-000,2016,5,2,12,1063,938,2001,2184
3405-000,2016,5,2,13,824,839,1663,2001
3405-000,2016,5,2,14,956,1016,1972,1663
3405-000,2016,5,2,15,1070,1076,2146,1972
3405-000,2016,5,2,16,1144,1003,2147,2146
3405-000,2016,5,2,17,1050,983,2033,2147
3405-000,2016,5,2,18,1121,953,2074,2033
3405-000,2016,5,2,19,988,1006,1994,2074
3405-000,2016,5,2,20,662,606,1268,1994
3405-000,2016,5,2,21,506,593,1099,1268
3405-000,2016,5,2,22,368,390,758,1099
3405-000,2016,5,2,23,225,229,454,758
3405-000,2016,5,2,24,134,149,283,454
3405-000,2016,5,3,1,68,103,171,283
3405-000,2016,5,3,2,44,68,112,171
3405-000,2016,5,3,3,44,48,92,112
3405-000,2016,5,3,4,47,74,121,92
3405-000,2016,5,3,5,89,83,172,121
3405-000,2016,5,3,6,202,188,390,172
3405-000,2016,5,3,7,452,395,847,390
3405-000,2016,5,3,8,922,1125,2047,847
3405-000,2016,5,3,9,1185,1128,2313,2047
3405-000,2016,5,3,10,968,857,1825,2313
3405-000,2016,5,3,11,930,833,1763,1825
3405-000,2016,5,3,12,987,819,1806,1763
3405-000,2016,5,3,13,861,790,1651,1806
3405-000,2016,5,3,14,870,914,1784,1651
3405-000,2016,5,3,15,1017,952,1969,1784
3405-000,2016,5,3,16,1065,978,2043,1969
3405-000,2016,5,3,17,1079,837,1916,2043
3405-000,2016,5,3,18,1084,865,1949,1916
3405-000,2016,5,3,19,957,917,1874,1949
3405-000,2016,5,3,20,671,570,1241,1874
3405-000,2016,5,3,21,539,542,1081,1241
3405-000,2016,5,3,22,375,366,741,1081
3405-000,2016,5,3,23,277,211,488,741
3405-000,2016,5,3,24,151,154,305,488
3405-000,2016,5,4,1,110,103,213,305
3405-000,2016,5,4,2,80,76,156,213
3405-000,2016,5,4,3,58,62,120,156
3405-000,2016,5,4,4,64,84,148,120
3405-000,2016,5,4,5,107,112,219,148
3405-000,2016,5,4,6,261,250,511,219
3405-000,2016,5,4,7,539,557,1096,511
3405-000,2016,5,4,8,1052,1297,2349,1096
3405-000,2016,5,4,9,1286,1224,2510,2349
3405-000,2016,5,4,10,1133,996,2129,2510
3405-000,2016,5,4,11,1112,1055,2167,2129
3405-000,2016,5,4,12,1144,947,2091,2167
3405-000,2016,5,4,13,948,895,1843,2091
3405-000,2016,5,4,14,1050,945,1995,1843
3405-000,2016,5,4,15,1177,1051,2228,1995
3405-000,2016,5,4,16,1195,997,2192,2228
3405-000,2016,5,4,17,1262,961,2223,2192
3405-000,2016,5,4,18,1423,1192,2615,2223
3405-000,2016,5,4,19,1426,1231,2657,2615
3405-000,2016,5,4,20,1022,990,2012,2657
3405-000,2016,5,4,21,798,667,1465,2012
3405-000,2016,5,4,22,536,525,1061,1465
3405-000,2016,5,4,23,405,306,711,1061
3405-000,2016,5,4,24,256,223,479,711
3405-000,2016,5,5,1,142,129,271,479
3405-000,2016,5,5,2,86,82,168,271
3405-000,2016,5,5,3,69,90,159,168
3405-000,2016,5,5,4,64,61,125,159
3405-000,2016,5,5,5,103,82,185,125
3405-000,2016,5,5,6,266,187,453,185
3405-000,2016,5,5,7,495,388,883,453
3405-000,2016,5,5,8,723,593,1316,883
3405-000,2016,5,5,9,872,657,1529,1316
3405-000,2016,5,5,10,856,722,1578,1529
3405-000,2016,5,5,11,939,825,1764,1578
3405-000,2016,5,5,12,909,797,1706,1764
3405-000,2016,5,5,13,994,840,1834,1706
3405-000,2016,5,5,14,806,718,1524,1834
3405-000,2016,5,5,15,781,831,1612,1524
3405-000,2016,5,5,16,734,847,1581,1612
3405-000,2016,5,5,17,687,710,1397,1581
3405-000,2016,5,5,18,802,781,1583,1397
3405-000,2016,5,5,19,661,621,1282,1583
3405-000,2016,5,5,20,456,454,910,1282
3405-000,2016,5,5,21,404,423,827,910
3405-000,2016,5,5,22,317,313,630,827
3405-000,2016,5,5,23,217,240,457,630
3405-000,2016,5,5,24,136,126,262,457
3405-000,2016,5,6,1,80,87,167,262
3405-000,2016,5,6,2,55,60,115,167
3405-000,2016,5,6,3,60,54,114,115
3405-000,2016,5,6,4,47,71,118,114
3405-000,2016,5,6,5,83,89,172,118
3405-000,2016,5,6,6,200,171,371,172
3405-000,2016,5,6,7,426,380,806,371
3405-000,2016,5,6,8,757,822,1579,806
3405-000,2016,5,6,9,905,802,1707,1579
3405-000,2016,5,6,10,865,710,1575,1707
3405-000,2016,5,6,11,983,878,1861,1575
3405-000,2016,5,6,12,846,861,1707,1861
3405-000,2016,5,6,13,771,814,1585,1707
3405-000,2016,5,6,14,833,793,1626,1585
3405-000,2016,5,6,15,891,798,1689,1626
3405-000,2016,5,6,16,893,876,1769,1689
3405-000,2016,5,6,17,952,785,1737,1769
3405-000,2016,5,6,18,1101,819,1920,1737
3405-000,2016,5,6,19,941,865,1806,1920
3405-000,2016,5,6,20,598,745,1343,1806
3405-000,2016,5,6,21,474,519,993,1343
3405-000,2016,5,6,22,358,379,737,993
3405-000,2016,5,6,23,242,256,498,737
3405-000,2016,5,6,24,141,172,313,498
3405-000,2016,5,7,1,81,116,197,313
3405-000,2016,5,7,2,67,59,126,197
3405-000,2016,5,7,3,48,46,94,126
3405-000,2016,5,7,4,43,58,101,94
3405-000,2016,5,7,5,80,63,143,101
3405-000,2016,5,7,6,189,142,331,143
3405-000,2016,5,7,7,423,358,781,331
3405-000,2016,5,7,8,625,531,1156,781
3405-000,2016,5,7,9,801,648,1449,1156
3405-000,2016,5,7,10,802,690,1492,1449
3405-000,2016,5,7,11,882,768,1650,1492
3405-000,2016,5,7,12,844,679,1523,1650
3405-000,2016,5,7,13,896,660,1556,1523
3405-000,2016,5,7,14,797,661,1458,1556
3405-000,2016,5,7,15,835,717,1552,1458
3405-000,2016,5,7,16,892,702,1594,1552
3405-000,2016,5,7,17,967,637,1604,1594
3405-000,2016,5,7,18,1064,823,1887,1604
3405-000,2016,5,7,19,971,673,1644,1887
3405-000,2016,5,7,20,859,478,1337,1644
3405-000,2016,5,7,21,582,441,1023,1337
3405-000,2016,5,7,22,460,379,839,1023
3405-000,2016,5,7,23,265,288,553,839
3405-000,2016,5,7,24,138,213,351,553
3405-000,2016,5,8,1,110,120,230,351
3405-000,2016,5,8,2,53,66,119,230
3405-000,2016,5,8,3,38,33,71,119
3405-000,2016,5,8,4,16,29,45,71
3405-000,2016,5,8,5,53,46,99,45
3405-000,2016,5,8,6,95,81,176,99
3405-000,2016,5,8,7,265,182,447,176
3405-000,2016,5,8,8,292,296,588,447
3405-000,2016,5,8,9,502,348,850,588
3405-000,2016,5,8,10,550,366,916,850
3405-000,2016,5,8,11,777,481,1258,916
3405-000,2016,5,8,12,757,519,1276,1258
3405-000,2016,5,8,13,686,513,1199,1276
3405-000,2016,5,8,14,712,558,1270,1199
3405-000,2016,5,8,15,890,594,1484,1270
3405-000,2016,5,8,16,819,687,1506,1484
3405-000,2016,5,8,17,815,771,1586,1506
3405-000,2016,5,8,18,752,720,1472,1586
3405-000,2016,5,8,19,649,734,1383,1472
3405-000,2016,5,8,20,473,710,1183,1383
3405-000,2016,5,8,21,496,575,1071,1183
3405-000,2016,5,8,22,371,547,918,1071
3405-000,2016,5,8,23,226,400,626,918
3405-000,2016,5,8,24,128,297,425,626
3405-000,2016,5,9,1,80,136,216,425
3405-000,2016,5,9,2,44,69,113,216
3405-000,2016,5,9,3,35,60,95,113
3405-000,2016,5,9,4,48,55,103,95
3405-000,2016,5,9,5,88,117,205,103
3405-000,2016,5,9,6,286,296,582,205
3405-000,2016,5,9,7,670,783,1453,582
3405-000,2016,5,9,8,1115,1529,2644,1453
3405-000,2016,5,9,9,1298,1404,2702,2644
3405-000,2016,5,9,10,1114,914,2028,2702
3405-000,2016,5,9,11,1088,979,2067,2028
3405-000,2016,5,9,12,1042,966,2008,2067
3405-000,2016,5,9,13,922,921,1843,2008
3405-000,2016,5,9,14,995,1038,2033,1843
3405-000,2016,5,9,15,1110,1079,2189,2033
3405-000,2016,5,9,16,1121,1049,2170,2189
3405-000,2016,5,9,17,1120,951,2071,2170
3405-000,2016,5,9,18,1241,1047,2288,2071
3405-000,2016,5,9,19,1198,1001,2199,2288
3405-000,2016,5,9,20,746,696,1442,2199
3405-000,2016,5,9,21,608,600,1208,1442
3405-000,2016,5,9,22,403,423,826,1208
3405-000,2016,5,9,23,295,234,529,826
3405-000,2016,5,9,24,162,164,326,529
3405-000,2016,5,10,1,102,118,220,326
3405-000,2016,5,10,2,58,77,135,220
3405-000,2016,5,10,3,67,83,150,135
3405-000,2016,5,10,4,49,89,138,150
3405-000,2016,5,10,5,94,126,220,138
3405-000,2016,5,10,6,236,217,453,220
3405-000,2016,5,10,7,551,510,1061,453
3405-000,2016,5,10,8,981,1194,2175,1061
3405-000,2016,5,10,9,1228,1200,2428,2175
3405-000,2016,5,10,10,971,924,1895,2428
3405-000,2016,5,10,11,1032,922,1954,1895
3405-000,2016,5,10,12,1047,861,1908,1954
3405-000,2016,5,10,13,878,753,1631,1908
3405-000,2016,5,10,14,925,898,1823,1631
3405-000,2016,5,10,15,1057,986,2043,1823
3405-000,2016,5,10,16,1039,920,1959,2043
3405-000,2016,5,10,17,1084,1050,2134,1959
3405-000,2016,5,10,18,1157,899,2056,2134
3405-000,2016,5,10,19,999,914,1913,2056
3405-000,2016,5,10,20,688,626,1314,1913
3405-000,2016,5,10,21,522,531,1053,1314
3405-000,2016,5,10,22,396,382,778,1053
3405-000,2016,5,10,23,274,227,501,778
3405-000,2016,5,10,24,151,170,321,501
3405-000,2016,5,11,1,89,107,196,321
3405-000,2016,5,11,2,72,57,129,196
3405-000,2016,5,11,3,54,53,107,129
3405-000,2016,5,11,4,68,87,155,107
3405-000,2016,5,11,5,102,108,210,155
3405-000,2016,5,11,6,285,219,504,210
3405-000,2016,5,11,7,605,556,1161,504
3405-000,2016,5,11,8,1076,1249,2325,1161
3405-000,2016,5,11,9,1253,1280,2533,2325
3405-000,2016,5,11,10,1043,986,2029,2533
3405-000,2016,5,11,11,1155,1025,2180,2029
3405-000,2016,5,11,12,1088,994,2082,2180
3405-000,2016,5,11,13,952,814,1766,2082
3405-000,2016,5,11,14,974,943,1917,1766
3405-000,2016,5,11,15,1122,1102,2224,1917
3405-000,2016,5,11,16,1154,1069,2223,2224
3405-000,2016,5,11,17,1141,1001,2142,2223
3405-000,2016,5,11,18,1253,1077,2330,2142
3405-000,2016,5,11,19,1189,1233,2422,2330
3405-000,2016,5,11,20,780,701,1481,2422
3405-000,2016,5,11,21,583,533,1116,1481
3405-000,2016,5,11,22,391,430,821,1116
3405-000,2016,5,11,23,301,260,561,821
3405-000,2016,5,11,24,176,200,376,561
3405-000,2016,5,12,1,120,118,238,376
3405-000,2016,5,12,2,61,93,154,238
3405-000,2016,5,12,3,59,63,122,154
3405-000,2016,5,12,4,58,72,130,122
3405-000,2016,5,12,5,115,100,215,130
3405-000,2016,5,12,6,269,233,502,215
3405-000,2016,5,12,7,611,566,1177,502
3405-000,2016,5,12,8,1042,1308,2350,1177
3405-000,2016,5,12,9,1311,1292,2603,2350
3405-000,2016,5,12,10,1067,995,2062,2603
3405-000,2016,5,12,11,1087,1005,2092,2062
3405-000,2016,5,12,12,1078,896,1974,2092
3405-000,2016,5,12,13,971,800,1771,1974
3405-000,2016,5,12,14,987,983,1970,1771
3405-000,2016,5,12,15,1039,1052,2091,1970
3405-000,2016,5,12,16,1084,985,2069,2091
3405-000,2016,5,12,17,1078,1029,2107,2069
3405-000,2016,5,12,18,1188,993,2181,2107
3405-000,2016,5,12,19,1105,995,2100,2181
3405-000,2016,5,12,20,812,656,1468,2100
3405-000,2016,5,12,21,642,615,1257,1468
3405-000,2016,5,12,22,419,461,880,1257
3405-000,2016,5,12,23,268,239,507,880
3405-000,2016,5,12,24,173,163,336,507
3405-000,2016,5,13,1,109,119,228,336
3405-000,2016,5,13,2,84,89,173,228
3405-000,2016,5,13,3,64,63,127,173
3405-000,2016,5,13,4,68,79,147,127
3405-000,2016,5,13,5,111,91,202,147
3405-000,2016,5,13,6,245,232,477,202
3405-000,2016,5,13,7,570,523,1093,477
3405-000,2016,5,13,8,1043,1303,2346,1093
3405-000,2016,5,13,9,1317,1404,2721,2346
3405-000,2016,5,13,10,1095,959,2054,2721
3405-000,2016,5,13,11,1175,1004,2179,2054
3405-000,2016,5,13,12,1077,938,2015,2179
3405-000,2016,5,13,13,953,906,1859,2015
3405-000,2016,5,13,14,1044,985,2029,1859
3405-000,2016,5,13,15,1160,1112,2272,2029
3405-000,2016,5,13,16,1312,1108,2420,2272
3405-000,2016,5,13,17,1232,1048,2280,2420
3405-000,2016,5,13,18,1419,1161,2580,2280
3405-000,2016,5,13,19,1421,1209,2630,2580
3405-000,2016,5,13,20,1034,834,1868,2630
3405-000,2016,5,13,21,727,615,1342,1868
3405-000,2016,5,13,22,518,441,959,1342
3405-000,2016,5,13,23,335,298,633,959
3405-000,2016,5,13,24,161,200,361,633
3405-000,2016,5,14,1,140,122,262,361
3405-000,2016,5,14,2,85,69,154,262
3405-000,2016,5,14,3,81,59,140,154
3405-000,2016,5,14,4,73,78,151,140
3405-000,2016,5,14,5,115,96,211,151
3405-000,2016,5,14,6,233,194,427,211
3405-000,2016,5,14,7,518,371,889,427
3405-000,2016,5,14,8,719,657,1376,889
3405-000,2016,5,14,9,900,736,1636,1376
3405-000,2016,5,14,10,899,755,1654,1636
3405-000,2016,5,14,11,1028,907,1935,1654
3405-000,2016,5,14,12,1060,751,1811,1935
3405-000,2016,5,14,13,821,738,1559,1811
3405-000,2016,5,14,14,842,716,1558,1559
3405-000,2016,5,14,15,841,630,1471,1558
3405-000,2016,5,14,16,995,793,1788,1471
3405-000,2016,5,14,17,917,703,1620,1788
3405-000,2016,5,14,18,949,777,1726,1620
3405-000,2016,5,14,19,823,718,1541,1726
3405-000,2016,5,14,20,582,526,1108,1541
3405-000,2016,5,14,21,398,344,742,1108
3405-000,2016,5,14,22,323,299,622,742
3405-000,2016,5,14,23,236,244,480,622
3405-000,2016,5,14,24,151,165,316,480
3405-000,2016,5,15,1,82,99,181,316
3405-000,2016,5,15,2,55,58,113,181
3405-000,2016,5,15,3,40,27,67,113
3405-000,2016,5,15,4,29,45,74,67
3405-000,2016,5,15,5,48,47,95,74
3405-000,2016,5,15,6,142,91,233,95
3405-000,2016,5,15,7,261,198,459,233
3405-000,2016,5,15,8,383,281,664,459
3405-000,2016,5,15,9,460,327,787,664
3405-000,2016,5,15,10,513,371,884,787
3405-000,2016,5,15,11,583,452,1035,884
3405-000,2016,5,15,12,620,489,1109,1035
3405-000,2016,5,15,13,527,529,1056,1109
3405-000,2016,5,15,14,603,569,1172,1056
3405-000,2016,5,15,15,664,664,1328,1172
3405-000,2016,5,15,16,667,620,1287,1328
3405-000,2016,5,15,17,712,697,1409,1287
3405-000,2016,5,15,18,627,726,1353,1409
3405-000,2016,5,15,19,559,601,1160,1353
3405-000,2016,5,15,20,413,546,959,1160
3405-000,2016,5,15,21,329,467,796,959
3405-000,2016,5,15,22,282,327,609,796
3405-000,2016,5,15,23,192,277,469,609
3405-000,2016,5,15,24,114,190,304,469
3405-000,2016,5,16,1,80,125,205,304
3405-000,2016,5,16,2,60,83,143,205
3405-000,2016,5,16,3,39,60,99,143
3405-000,2016,5,16,4,46,55,101,99
3405-000,2016,5,16,5,94,120,214,101
3405-000,2016,5,16,6,256,255,511,214
3405-000,2016,5,16,7,613,683,1296,511
3405-000,2016,5,16,8,1092,1521,2613,1296
3405-000,2016,5,16,9,1335,1326,2661,2613
3405-000,2016,5,16,10,1050,927,1977,2661
3405-000,2016,5,16,11,1115,967,2082,1977
3405-000,2016,5,16,12,1015,915,1930,2082
3405-000,2016,5,16,13,887,870,1757,1930
3405-000,2016,5,16,14,1006,996,2002,1757
3405-000,2016,5,16,15,1106,1020,2126,2002
3405-000,2016,5,16,16,1084,989,2073,2126
3405-000,2016,5,16,17,1120,916,2036,2073
3405-000,2016,5,16,18,1179,938,2117,2036
3405-000,2016,5,16,19,1025,1013,2038,2117
3405-000,2016,5,16,20,737,707,1444,2038
3405-000,2016,5,16,21,608,625,1233,1444
3405-000,2016,5,16,22,421,393,814,1233
3405-000,2016,5,16,23,259,281,540,814
3405-000,2016,5,16,24,144,200,344,540
3405-000,2016,5,17,1,88,120,208,344
3405-000,2016,5,17,2,62,74,136,208
3405-000,2016,5,17,3,54,77,131,136
3405-000,2016,5,17,4,71,83,154,131
3405-000,2016,5,17,5,98,116,214,154
3405-000,2016,5,17,6,297,220,517,214
3405-000,2016,5,17,7,587,551,1138,517
3405-000,2016,5,17,8,1061,1302,2363,1138
3405-000,2016,5,17,9,1271,1272,2543,2363
3405-000,2016,5,17,10,1119,955,2074,2543
3405-000,2016,5,17,11,1148,1002,2150,2074
3405-000,2016,5,17,12,1030,995,2025,2150
3405-000,2016,5,17,13,913,789,1702,2025
3405-000,2016,5,17,14,924,940,1864,1702
3405-000,2016,5,17,15,1134,1014,2148,1864
3405-000,2016,5,17,16,1153,996,2149,2148
3405-000,2016,5,17,17,1137,942,2079,2149
3405-000,2016,5,17,18,1231,985,2216,2079
3405-000,2016,5,17,19,1068,1060,2128,2216
3405-000,2016,5,17,20,720,686,1406,2128
3405-000,2016,5,17,21,627,612,1239,1406
3405-000,2016,5,17,22,435,442,877,1239
3405-000,2016,5,17,23,292,255,547,877
3405-000,2016,5,17,24,148,198,346,547
3405-000,2016,5,18,1,99,111,210,346
3405-000,2016,5,18,2,70,78,148,210
3405-000,2016,5,18,3,58,79,137,148
3405-000,2016,5,18,4,53,76,129,137
3405-000,2016,5,18,5,102,98,200,129
3405-000,2016,5,18,6,279,248,527,200
3405-000,2016,5,18,7,562,543,1105,527
3405-000,2016,5,18,8,1067,1038,2105,1105
3405-000,2016,5,18,9,1320,1252,2572,2105
3405-000,2016,5,18,10,1060,991,2051,2572
3405-000,2016,5,18,11,1123,1040,2163,2051
3405-000,2016,5,18,12,1090,970,2060,2163
3405-000,2016,5,18,13,889,843,1732,2060
3405-000,2016,5,18,14,1018,960,1978,1732
3405-000,2016,5,18,15,1103,1086,2189,1978
3405-000,2016,5,18,16,1144,936,2080,2189
3405-000,2016,5,18,17,1099,1042,2141,2080
3405-000,2016,5,18,18,1288,1016,2304,2141
3405-000,2016,5,18,19,1134,1072,2206,2304
3405-000,2016,5,18,20,749,660,1409,2206
3405-000,2016,5,18,21,551,515,1066,1409
3405-000,2016,5,18,22,403,439,842,1066
3405-000,2016,5,18,23,301,257,558,842
3405-000,2016,5,18,24,159,198,357,558
3405-000,2016,5,19,1,109,98,207,357
3405-000,2016,5,19,2,62,74,136,207
3405-000,2016,5,19,3,52,70,122,136
3405-000,2016,5,19,4,72,70,142,122
3405-000,2016,5,19,5,92,117,209,142
3405-000,2016,5,19,6,301,252,553,209
3405-000,2016,5,19,7,577,571,1148,553
3405-000,2016,5,19,8,1010,1271,2281,1148
3405-000,2016,5,19,9,1385,1240,2625,2281
3405-000,2016,5,19,10,1041,929,1970,2625
3405-000,2016,5,19,11,1142,1011,2153,1970
3405-000,2016,5,19,12,1024,891,1915,2153
3405-000,2016,5,19,13,885,816,1701,1915
3405-000,2016,5,19,14,1050,964,2014,1701
3405-000,2016,5,19,15,1117,991,2108,2014
3405-000,2016,5,19,16,1185,1046,2231,2108
3405-000,2016,5,19,17,1176,1017,2193,2231
3405-000,2016,5,19,18,1310,1011,2321,2193
3405-000,2016,5,19,19,1140,1024,2164,2321
3405-000,2016,5,19,20,764,679,1443,2164
3405-000,2016,5,19,21,575,633,1208,1443
3405-000,2016,5,19,22,436,419,855,1208
3405-000,2016,5,19,23,273,289,562,855
3405-000,2016,5,19,24,160,193,353,562
3405-000,2016,5,20,1,112,120,232,353
3405-000,2016,5,20,2,76,75,151,232
3405-000,2016,5,20,3,61,62,123,151
3405-000,2016,5,20,4,76,84,160,123
3405-000,2016,5,20,5,115,104,219,160
3405-000,2016,5,20,6,276,253,529,219
3405-000,2016,5,20,7,573,564,1137,529
3405-000,2016,5,20,8,1051,1296,2347,1137
3405-000,2016,5,20,9,1329,1245,2574,2347
3405-000,2016,5,20,10,1101,976,2077,2574
3405-000,2016,5,20,11,1192,974,2166,2077
3405-000,2016,5,20,12,1112,948,2060,2166
3405-000,2016,5,20,13,965,894,1859,2060
3405-000,2016,5,20,14,989,959,1948,1859
3405-000,2016,5,20,15,1126,1038,2164,1948
3405-000,2016,5,20,16,1250,957,2207,2164
3405-000,2016,5,20,17,1242,998,2240,2207
3405-000,2016,5,20,18,1459,1113,2572,2240
3405-000,2016,5,20,19,1378,1114,2492,2572
3405-000,2016,5,20,20,1004,792,1796,2492
3405-000,2016,5,20,21,731,606,1337,1796
3405-000,2016,5,20,22,526,427,953,1337
3405-000,2016,5,20,23,352,257,609,953
3405-000,2016,5,20,24,189,200,389,609
3405-000,2016,5,21,1,130,126,256,389
3405-000,2016,5,21,2,92,104,196,256
3405-000,2016,5,21,3,94,68,162,196
3405-000,2016,5,21,4,68,74,142,162
3405-000,2016,5,21,5,94,96,190,142
3405-000,2016,5,21,6,278,229,507,190
3405-000,2016,5,21,7,536,433,969,507
3405-000,2016,5,21,8,750,676,1426,969
3405-000,2016,5,21,9,975,765,1740,1426
3405-000,2016,5,21,10,948,779,1727,1740
3405-000,2016,5,21,11,974,726,1700,1727
3405-000,2016,5,21,12,1141,795,1936,1700
3405-000,2016,5,21,13,822,688,1510,1936
3405-000,2016,5,21,14,735,690,1425,1510
3405-000,2016,5,21,15,803,689,1492,1425
3405-000,2016,5,21,16,860,697,1557,1492
3405-000,2016,5,21,17,879,769,1648,1557
3405-000,2016,5,21,18,1007,765,1772,1648
3405-000,2016,5,21,19,807,706,1513,1772
3405-000,2016,5,21,20,563,510,1073,1513
3405-000,2016,5,21,21,402,407,809,1073
3405-000,2016,5,21,22,325,346,671,809
3405-000,2016,5,21,23,263,258,521,671
3405-000,2016,5,21,24,159,138,297,521
3405-000,2016,5,22,1,103,90,193,297
3405-000,2016,5,22,2,61,56,117,193
3405-000,2016,5,22,3,46,32,78,117
3405-000,2016,5,22,4,43,45,88,78
3405-000,2016,5,22,5,63,41,104,88
3405-000,2016,5,22,6,178,99,277,104
3405-000,2016,5,22,7,306,185,491,277
3405-000,2016,5,22,8,373,295,668,491
3405-000,2016,5,22,9,434,339,773,668
3405-000,2016,5,22,10,494,363,857,773
3405-000,2016,5,22,11,600,459,1059,857
3405-000,2016,5,22,12,566,443,1009,1059
3405-000,2016,5,22,13,529,478,1007,1009
3405-000,2016,5,22,14,540,539,1079,1007
3405-000,2016,5,22,15,592,506,1098,1079
3405-000,2016,5,22,16,662,554,1216,1098
3405-000,2016,5,22,17,724,579,1303,1216
3405-000,2016,5,22,18,690,605,1295,1303
3405-000,2016,5,22,19,598,649,1247,1295
3405-000,2016,5,22,20,478,530,1008,1247
3405-000,2016,5,22,21,382,522,904,1008
3405-000,2016,5,22,22,284,407,691,904
3405-000,2016,5,22,23,212,301,513,691
3405-000,2016,5,22,24,133,219,352,513
3405-000,2016,5,23,1,68,127,195,352
3405-000,2016,5,23,2,57,83,140,195
3405-000,2016,5,23,3,44,55,99,140
3405-000,2016,5,23,4,54,74,128,99
3405-000,2016,5,23,5,105,115,220,128
3405-000,2016,5,23,6,336,306,642,220
3405-000,2016,5,23,7,635,765,1400,642
3405-000,2016,5,23,8,1131,1571,2702,1400
3405-000,2016,5,23,9,1281,1341,2622,2702
3405-000,2016,5,23,10,1026,921,1947,2622
3405-000,2016,5,23,11,1036,1033,2069,1947
3405-000,2016,5,23,12,1090,926,2016,2069
3405-000,2016,5,23,13,858,859,1717,2016
3405-000,2016,5,23,14,963,1023,1986,1717
3405-000,2016,5,23,15,1147,1056,2203,1986
3405-000,2016,5,23,16,1171,990,2161,2203
3405-000,2016,5,23,17,1089,992,2081,2161
3405-000,2016,5,23,18,1174,1022,2196,2081
3405-000,2016,5,23,19,1121,1083,2204,2196
3405-000,2016,5,23,20,730,694,1424,2204
3405-000,2016,5,23,21,609,532,1141,1424
3405-000,2016,5,23,22,434,421,855,1141
3405-000,2016,5,23,23,290,261,551,855
3405-000,2016,5,23,24,144,166,310,551
3405-000,2016,5,24,1,98,108,206,310
3405-000,2016,5,24,2,57,76,133,206
3405-000,2016,5,24,3,63,76,139,133
3405-000,2016,5,24,4,63,81,144,139
3405-000,2016,5,24,5,113,85,198,144
3405-000,2016,5,24,6,213,203,416,198
3405-000,2016,5,24,7,497,394,891,416
3405-000,2016,5,24,8,937,1118,2055,891
3405-000,2016,5,24,9,1215,1220,2435,2055
3405-000,2016,5,24,10,971,852,1823,2435
3405-000,2016,5,24,11,962,907,1869,1823
3405-000,2016,5,24,12,981,843,1824,1869
3405-000,2016,5,24,13,858,709,1567,1824
3405-000,2016,5,24,14,905,849,1754,1567
3405-000,2016,5,24,15,1094,973,2067,1754
3405-000,2016,5,24,16,1039,966,2005,2067
3405-000,2016,5,24,17,1074,907,1981,2005
3405-000,2016,5,24,18,1137,938,2075,1981
3405-000,2016,5,24,19,1034,979,2013,2075
3405-000,2016,5,24,20,710,657,1367,2013
3405-000,2016,5,24,21,623,581,1204,1367
3405-000,2016,5,24,22,390,383,773,1204
3405-000,2016,5,24,23,295,236,531,773
3405-000,2016,5,24,24,165,190,355,531
3405-000,2016,5,25,1,114,111,225,355
3405-000,2016,5,25,2,65,63,128,225
3405-000,2016,5,25,3,53,81,134,128
3405-000,2016,5,25,4,62,71,133,134
3405-000,2016,5,25,5,116,100,216,133
3405-000,2016,5,25,6,307,227,534,216
3405-000,2016,5,25,7,562,588,1150,534
3405-000,2016,5,25,8,1066,1259,2325,1150
3405-000,2016,5,25,9,1368,1323,2691,2325
3405-000,2016,5,25,10,1086,997,2083,2691
3405-000,2016,5,25,11,1175,1008,2183,2083
3405-000,2016,5,25,12,1133,984,2117,2183
3405-000,2016,5,25,13,938,824,1762,2117
3405-000,2016,5,25,14,1053,1054,2107,1762
3405-000,2016,5,25,15,1281,1164,2445,2107
3405-000,2016,5,25,16,1126,1026,2152,2445
3405-000,2016,5,25,17,1146,960,2106,2152
3405-000,2016,5,25,18,1225,1044,2269,2106
3405-000,2016,5,25,19,1231,1012,2243,2269
3405-000,2016,5,25,20,692,654,1346,2243
3405-000,2016,5,25,21,557,561,1118,1346
3405-000,2016,5,25,22,440,360,800,1118
3405-000,2016,5,25,23,262,256,518,800
3405-000,2016,5,25,24,163,201,364,518
3405-000,2016,5,26,1,122,117,239,364
3405-000,2016,5,26,2,85,73,158,239
3405-000,2016,5,26,3,47,59,106,158
3405-000,2016,5,26,4,84,82,166,106
3405-000,2016,5,26,5,109,113,222,166
3405-000,2016,5,26,6,289,243,532,222
3405-000,2016,5,26,7,561,538,1099,532
3405-000,2016,5,26,8,1066,1316,2382,1099
3405-000,2016,5,26,9,1311,1292,2603,2382
3405-000,2016,5,26,10,1148,956,2104,2603
3405-000,2016,5,26,11,1095,956,2051,2104
3405-000,2016,5,26,12,1060,878,1938,2051
3405-000,2016,5,26,13,907,819,1726,1938
3405-000,2016,5,26,14,1003,996,1999,1726
3405-000,2016,5,26,15,1146,937,2083,1999
3405-000,2016,5,26,16,1139,953,2092,2083
3405-000,2016,5,26,17,1174,974,2148,2092
3405-000,2016,5,26,18,1218,982,2200,2148
3405-000,2016,5,26,19,1122,991,2113,2200
3405-000,2016,5,26,20,738,660,1398,2113
3405-000,2016,5,26,21,558,594,1152,1398
3405-000,2016,5,26,22,419,399,818,1152
3405-000,2016,5,26,23,286,280,566,818
3405-000,2016,5,26,24,166,189,355,566
3405-000,2016,5,27,1,111,103,214,355
3405-000,2016,5,27,2,60,73,133,214
3405-000,2016,5,27,3,66,78,144,133
3405-000,2016,5,27,4,77,88,165,144
3405-000,2016,5,27,5,130,103,233,165
3405-000,2016,5,27,6,284,249,533,233
3405-000,2016,5,27,7,606,562,1168,533
3405-000,2016,5,27,8,1038,1276,2314,1168
3405-000,2016,5,27,9,1392,1323,2715,2314
3405-000,2016,5,27,10,1039,930,1969,2715
3405-000,2016,5,27,11,1100,970,2070,1969
3405-000,2016,5,27,12,1062,912,1974,2070
3405-000,2016,5,27,13,967,819,1786,1974
3405-000,2016,5,27,14,1057,901,1958,1786
3405-000,2016,5,27,15,1135,977,2112,1958
3405-000,2016,5,27,16,1180,975,2155,2112
3405-000,2016,5,27,17,1217,987,2204,2155
3405-000,2016,5,27,18,1430,1107,2537,2204
3405-000,2016,5,27,19,1478,1183,2661,2537
3405-000,2016,5,27,20,920,730,1650,2661
3405-000,2016,5,27,21,763,614,1377,1650
3405-000,2016,5,27,22,520,396,916,1377
3405-000,2016,5,27,23,320,268,588,916
3405-000,2016,5,27,24,174,164,338,588
3405-000,2016,5,28,1,118,114,232,338
3405-000,2016,5,28,2,91,98,189,232
3405-000,2016,5,28,3,70,69,139,189
3405-000,2016,5,28,4,67,80,147,139
3405-000,2016,5,28,5,101,107,208,147
3405-000,2016,5,28,6,241,190,431,208
3405-000,2016,5,28,7,500,367,867,431
3405-000,2016,5,28,8,818,607,1425,867
3405-000,2016,5,28,9,933,717,1650,1425
3405-000,2016,5,28,10,884,800,1684,1650
3405-000,2016,5,28,11,939,776,1715,1684
3405-000,2016,5,28,12,925,775,1700,1715
3405-000,2016,5,28,13,775,757,1532,1700
3405-000,2016,5,28,14,789,693,1482,1532
3405-000,2016,5,28,15,904,770,1674,1482
3405-000,2016,5,28,16,816,686,1502,1674
3405-000,2016,5,28,17,828,737,1565,1502
3405-000,2016,5,28,18,1001,849,1850,1565
3405-000,2016,5,28,19,877,708,1585,1850
3405-000,2016,5,28,20,569,507,1076,1585
3405-000,2016,5,28,21,444,356,800,1076
3405-000,2016,5,28,22,347,343,690,800
3405-000,2016,5,28,23,231,246,477,690
3405-000,2016,5,28,24,136,184,320,477
3405-000,2016,5,29,1,90,94,184,320
3405-000,2016,5,29,2,59,68,127,184
3405-000,2016,5,29,3,56,51,107,127
3405-000,2016,5,29,4,54,45,99,107
3405-000,2016,5,29,5,66,45,111,99
3405-000,2016,5,29,6,149,102,251,111
3405-000,2016,5,29,7,263,216,479,251
3405-000,2016,5,29,8,395,301,696,479
3405-000,2016,5,29,9,473,305,778,696
3405-000,2016,5,29,10,479,381,860,778
3405-000,2016,5,29,11,556,458,1014,860
3405-000,2016,5,29,12,551,498,1049,1014
3405-000,2016,5,29,13,550,433,983,1049
3405-000,2016,5,29,14,501,533,1034,983
3405-000,2016,5,29,15,648,558,1206,1034
3405-000,2016,5,29,16,689,562,1251,1206
3405-000,2016,5,29,17,686,560,1246,1251
3405-000,2016,5,29,18,671,703,1374,1246
3405-000,2016,5,29,19,582,623,1205,1374
3405-000,2016,5,29,20,440,534,974,1205
3405-000,2016,5,29,21,424,472,896,974
3405-000,2016,5,29,22,362,393,755,896
3405-000,2016,5,29,23,238,318,556,755
3405-000,2016,5,29,24,138,197,335,556
3405-000,2016,5,30,1,79,126,205,335
3405-000,2016,5,30,2,46,72,118,205
3405-000,2016,5,30,3,46,50,96,118
3405-000,2016,5,30,4,52,83,135,96
3405-000,2016,5,30,5,106,101,207,135
3405-000,2016,5,30,6,299,250,549,207
3405-000,2016,5,30,7,674,769,1443,549
3405-000,2016,5,30,8,1152,1525,2677,1443
3405-000,2016,5,30,9,1284,1339,2623,2677
3405-000,2016,5,30,10,1039,931,1970,2623
3405-000,2016,5,30,11,1065,971,2036,1970
3405-000,2016,5,30,12,991,921,1912,2036
3405-000,2016,5,30,13,933,783,1716,1912
3405-000,2016,5,30,14,967,913,1880,1716
3405-000,2016,5,30,15,1106,1023,2129,1880
3405-000,2016,5,30,16,1092,1019,2111,2129
3405-000,2016,5,30,17,1134,964,2098,2111
3405-000,2016,5,30,18,1197,1044,2241,2098
3405-000,2016,5,30,19,1126,984,2110,2241
3405-000,2016,5,30,20,762,699,1461,2110
3405-000,2016,5,30,21,611,583,1194,1461
3405-000,2016,5,30,22,426,474,900,1194
3405-000,2016,5,30,23,270,223,493,900
3405-000,2016,5,30,24,150,159,309,493
3405-000,2016,5,31,1,104,123,227,309
3405-000,2016,5,31,2,66,66,132,227
3405-000,2016,5,31,3,57,77,134,132
3405-000,2016,5,31,4,58,79,137,134
3405-000,2016,5,31,5,131,109,240,137
3405-000,2016,5,31,6,251,211,462,240
3405-000,2016,5,31,7,579,530,1109,462
3405-000,2016,5,31,8,1051,1266,2317,1109
3405-000,2016,5,31,9,1341,1340,2681,2317
3405-000,2016,5,31,10,1023,973,1996,2681
3405-000,2016,5,31,11,1051,956,2007,1996
3405-000,2016,5,31,12,1086,905,1991,2007
3405-000,2016,5,31,13,936,808,1744,1991
3405-000,2016,5,31,14,939,980,1919,1744
3405-000,2016,5,31,15,1172,896,2068,1919
3405-000,2016,5,31,16,1134,915,2049,2068
3405-000,2016,5,31,17,1074,912,1986,2049
3405-000,2016,5,31,18,1235,1032,2267,1986
3405-000,2016,5,31,19,1073,996,2069,2267
3405-000,2016,5,31,20,775,672,1447,2069
3405-000,2016,5,31,21,610,586,1196,1447
3405-000,2016,5,31,22,474,427,901,1196
3405-000,2016,5,31,23,285,258,543,901
3405-000,2016,5,31,24,143,161,304,543
3405-000,2016,6,1,1,98,96,194,304
3405-000,2016,6,1,2,71,69,140,194
3405-000,2016,6,1,3,56,81,137,140
3405-000,2016,6,1,4,52,80,132,137
3405-000,2016,6,1,5,112,104,216,132
3405-000,2016,6,1,6,280,221,501,216
3405-000,2016,6,1,7,569,543,1112,501
3405-000,2016,6,1,8,1054,1244,2298,1112
3405-000,2016,6,1,9,1328,1211,2539,2298
3405-000,2016,6,1,10,1081,906,1987,2539
3405-000,2016,6,1,11,1043,965,2008,1987
3405-000,2016,6,1,12,1040,913,1953,2008
3405-000,2016,6,1,13,881,793,1674,1953
3405-000,2016,6,1,14,945,949,1894,1674
3405-000,2016,6,1,15,1160,1051,2211,1894
3405-000,2016,6,1,16,1181,953,2134,2211
3405-000,2016,6,1,17,1107,906,2013,2134
3405-000,2016,6,1,18,1334,1093,2427,2013
3405-000,2016,6,1,19,1203,1056,2259,2427
3405-000,2016,6,1,20,743,681,1424,2259
3405-000,2016,6,1,21,569,522,1091,1424
3405-000,2016,6,1,22,395,382,777,1091
3405-000,2016,6,1,23,304,246,550,777
3405-000,2016,6,1,24,159,217,376,550
3405-000,2016,6,2,1,114,105,219,376
3405-000,2016,6,2,2,60,65,125,219
3405-000,2016,6,2,3,52,57,109,125
3405-000,2016,6,2,4,53,81,134,109
3405-000,2016,6,2,5,120,110,230,134
3405-000,2016,6,2,6,310,246,556,230
3405-000,2016,6,2,7,596,556,1152,556
3405-000,2016,6,2,8,1090,1232,2322,1152
3405-000,2016,6,2,9,1369,1180,2549,2322
3405-000,2016,6,2,10,1098,977,2075,2549
3405-000,2016,6,2,11,1097,1002,2099,2075
3405-000,2016,6,2,12,1074,907,1981,2099
3405-000,2016,6,2,13,900,813,1713,1981
3405-000,2016,6,2,14,1051,953,2004,1713
3405-000,2016,6,2,15,1126,1028,2154,2004
3405-000,2016,6,2,16,1254,984,2238,2154
3405-000,2016,6,2,17,1168,980,2148,2238
3405-000,2016,6,2,18,1238,1026,2264,2148
3405-000,2016,6,2,19,1151,1015,2166,2264
3405-000,2016,6,2,20,725,724,1449,2166
3405-000,2016,6,2,21,646,659,1305,1449
3405-000,2016,6,2,22,459,478,937,1305
3405-000,2016,6,2,23,318,266,584,937
3405-000,2016,6,2,24,179,206,385,584
3405-000,2016,6,3,1,102,105,207,385
3405-000,2016,6,3,2,80,81,161,207
3405-000,2016,6,3,3,54,72,126,161
3405-000,2016,6,3,4,57,71,128,126
3405-000,2016,6,3,5,131,120,251,128
3405-000,2016,6,3,6,280,243,523,251
3405-000,2016,6,3,7,592,507,1099,523
3405-000,2016,6,3,8,1090,1256,2346,1099
3405-000,2016,6,3,9,1298,1268,2566,2346
3405-000,2016,6,3,10,1074,1008,2082,2566
3405-000,2016,6,3,11,1157,1010,2167,2082
3405-000,2016,6,3,12,1180,904,2084,2167
3405-000,2016,6,3,13,1041,824,1865,2084
3405-000,2016,6,3,14,1054,1020,2074,1865
3405-000,2016,6,3,15,1273,952,2225,2074
3405-000,2016,6,3,16,1296,1012,2308,2225
3405-000,2016,6,3,17,1412,998,2410,2308
3405-000,2016,6,3,18,1500,1088,2588,2410
3405-000,2016,6,3,19,1560,1161,2721,2588
3405-000,2016,6,3,20,1052,771,1823,2721
3405-000,2016,6,3,21,836,633,1469,1823
3405-000,2016,6,3,22,501,458,959,1469
3405-000,2016,6,3,23,335,313,648,959
3405-000,2016,6,3,24,182,202,384,648
3405-000,2016,6,4,1,147,134,281,384
3405-000,2016,6,4,2,75,91,166,281
3405-000,2016,6,4,3,68,65,133,166
3405-000,2016,6,4,4,67,90,157,133
3405-000,2016,6,4,5,113,110,223,157
3405-000,2016,6,4,6,301,197,498,223
3405-000,2016,6,4,7,541,408,949,498
3405-000,2016,6,4,8,784,641,1425,949
3405-000,2016,6,4,9,976,760,1736,1425
3405-000,2016,6,4,10,1049,911,1960,1736
3405-000,2016,6,4,11,1259,869,2128,1960
3405-000,2016,6,4,12,1235,1003,2238,2128
3405-000,2016,6,4,13,998,1077,2075,2238
3405-000,2016,6,4,14,1095,969,2064,2075
3405-000,2016,6,4,15,1020,972,1992,2064
3405-000,2016,6,4,16,989,1042,2031,1992
3405-000,2016,6,4,17,968,960,1928,2031
3405-000,2016,6,4,18,1071,989,2060,1928
3405-000,2016,6,4,19,1043,802,1845,2060
3405-000,2016,6,4,20,537,667,1204,1845
3405-000,2016,6,4,21,419,500,919,1204
3405-000,2016,6,4,22,342,343,685,919
3405-000,2016,6,4,23,249,220,469,685
3405-000,2016,6,4,24,117,191,308,469
3405-000,2016,6,5,1,93,86,179,308
3405-000,2016,6,5,2,73,57,130,179
3405-000,2016,6,5,3,54,49,103,130
3405-000,2016,6,5,4,53,38,91,103
3405-000,2016,6,5,5,69,53,122,91
3405-000,2016,6,5,6,151,103,254,122
3405-000,2016,6,5,7,285,211,496,254
3405-000,2016,6,5,8,426,304,730,496
3405-000,2016,6,5,9,501,340,841,730
3405-000,2016,6,5,10,578,431,1009,841
3405-000,2016,6,5,11,647,553,1200,1009
3405-000,2016,6,5,12,640,575,1215,1200
3405-000,2016,6,5,13,575,532,1107,1215
3405-000,2016,6,5,14,562,515,1077,1107
3405-000,2016,6,5,15,703,597,1300,1077
3405-000,2016,6,5,16,875,582,1457,1300
3405-000,2016,6,5,17,852,586,1438,1457
3405-000,2016,6,5,18,826,627,1453,1438
3405-000,2016,6,5,19,676,574,1250,1453
3405-000,2016,6,5,20,603,513,1116,1250
3405-000,2016,6,5,21,440,445,885,1116
3405-000,2016,6,5,22,436,365,801,885
3405-000,2016,6,5,23,268,311,579,801
3405-000,2016,6,5,24,173,214,387,579
3405-000,2016,6,6,1,119,122,241,387
3405-000,2016,6,6,2,67,90,157,241
3405-000,2016,6,6,3,43,58,101,157
3405-000,2016,6,6,4,43,54,97,101
3405-000,2016,6,6,5,93,81,174,97
3405-000,2016,6,6,6,205,185,390,174
3405-000,2016,6,6,7,428,381,809,390
3405-000,2016,6,6,8,588,526,1114,809
3405-000,2016,6,6,9,696,510,1206,1114
3405-000,2016,6,6,10,679,524,1203,1206
3405-000,2016,6,6,11,752,648,1400,1203
3405-000,2016,6,6,12,724,611,1335,1400
3405-000,2016,6,6,13,700,614,1314,1335
3405-000,2016,6,6,14,692,642,1334,1314
3405-000,2016,6,6,15,759,691,1450,1334
3405-000,2016,6,6,16,898,682,1580,1450
3405-000,2016,6,6,17,1034,609,1643,1580
3405-000,2016,6,6,18,1180,683,1863,1643
3405-000,2016,6,6,19,892,716,1608,1863
3405-000,2016,6,6,20,755,590,1345,1608
3405-000,2016,6,6,21,467,611,1078,1345
3405-000,2016,6,6,22,377,394,771,1078
3405-000,2016,6,6,23,248,280,528,771
3405-000,2016,6,6,24,126,197,323,528
3405-000,2016,6,7,1,94,124,218,323
3405-000,2016,6,7,2,53,73,126,218
3405-000,2016,6,7,3,48,45,93,126
3405-000,2016,6,7,4,50,76,126,93
3405-000,2016,6,7,5,102,94,196,126
3405-000,2016,6,7,6,248,257,505,196
3405-000,2016,6,7,7,610,661,1271,505
3405-000,2016,6,7,8,1107,1450,2557,1271
3405-000,2016,6,7,9,1353,1361,2714,2557
3405-000,2016,6,7,10,1031,910,1941,2714
3405-000,2016,6,7,11,1154,990,2144,1941
3405-000,2016,6,7,12,1084,1048,2132,2144
3405-000,2016,6,7,13,862,799,1661,2132
3405-000,2016,6,7,14,984,936,1920,1661
3405-000,2016,6,7,15,1164,1058,2222,1920
3405-000,2016,6,7,16,1243,1014,2257,2222
3405-000,2016,6,7,17,1088,911,1999,2257
3405-000,2016,6,7,18,1308,1036,2344,1999
3405-000,2016,6,7,19,1084,975,2059,2344
3405-000,2016,6,7,20,741,703,1444,2059
3405-000,2016,6,7,21,645,637,1282,1444
3405-000,2016,6,7,22,459,441,900,1282
3405-000,2016,6,7,23,301,285,586,900
3405-000,2016,6,7,24,156,188,344,586
3405-000,2016,6,8,1,110,103,213,344
3405-000,2016,6,8,2,74,81,155,213
3405-000,2016,6,8,3,61,69,130,155
3405-000,2016,6,8,4,64,98,162,130
3405-000,2016,6,8,5,96,115,211,162
3405-000,2016,6,8,6,289,237,526,211
3405-000,2016,6,8,7,547,540,1087,526
3405-000,2016,6,8,8,1076,1208,2284,1087
3405-000,2016,6,8,9,1377,1277,2654,2284
3405-000,2016,6,8,10,1088,997,2085,2654
3405-000,2016,6,8,11,1155,922,2077,2085
3405-000,2016,6,8,12,1116,990,2106,2077
3405-000,2016,6,8,13,883,820,1703,2106
3405-000,2016,6,8,14,1045,940,1985,1703
3405-000,2016,6,8,15,1096,965,2061,1985
3405-000,2016,6,8,16,1204,915,2119,2061
3405-000,2016,6,8,17,1186,889,2075,2119
3405-000,2016,6,8,18,1245,1041,2286,2075
3405-000,2016,6,8,19,1199,1044,2243,2286
3405-000,2016,6,8,20,759,684,1443,2243
3405-000,2016,6,8,21,620,594,1214,1443
3405-000,2016,6,8,22,419,483,902,1214
3405-000,2016,6,8,23,297,285,582,902
3405-000,2016,6,8,24,170,187,357,582
3405-000,2016,6,9,1,118,111,229,357
3405-000,2016,6,9,2,75,64,139,229
3405-000,2016,6,9,3,54,62,116,139
3405-000,2016,6,9,4,62,81,143,116
3405-000,2016,6,9,5,114,102,216,143
3405-000,2016,6,9,6,284,223,507,216
3405-000,2016,6,9,7,569,565,1134,507
3405-000,2016,6,9,8,1104,1179,2283,1134
3405-000,2016,6,9,9,1366,1245,2611,2283
3405-000,2016,6,9,10,1063,1019,2082,2611
3405-000,2016,6,9,11,1143,949,2092,2082
3405-000,2016,6,9,12,1040,928,1968,2092
3405-000,2016,6,9,13,897,860,1757,1968
3405-000,2016,6,9,14,1023,972,1995,1757
3405-000,2016,6,9,15,1193,996,2189,1995
3405-000,2016,6,9,16,1200,987,2187,2189
3405-000,2016,6,9,17,1160,992,2152,2187
3405-000,2016,6,9,18,1259,975,2234,2152
3405-000,2016,6,9,19,1118,1050,2168,2234
3405-000,2016,6,9,20,817,686,1503,2168
3405-000,2016,6,9,21,658,602,1260,1503
3405-000,2016,6,9,22,450,462,912,1260
3405-000,2016,6,9,23,292,296,588,912
3405-000,2016,6,9,24,164,193,357,588
3405-000,2016,6,10,1,132,124,256,357
3405-000,2016,6,10,2,78,76,154,256
3405-000,2016,6,10,3,63,53,116,154
3405-000,2016,6,10,4,54,87,141,116
3405-000,2016,6,10,5,117,95,212,141
3405-000,2016,6,10,6,292,269,561,212
3405-000,2016,6,10,7,582,546,1128,561
3405-000,2016,6,10,8,1094,1211,2305,1128
3405-000,2016,6,10,9,1393,1245,2638,2305
3405-000,2016,6,10,10,1113,1000,2113,2638
3405-000,2016,6,10,11,1142,995,2137,2113
3405-000,2016,6,10,12,1204,978,2182,2137
3405-000,2016,6,10,13,943,818,1761,2182
3405-000,2016,6,10,14,1086,926,2012,1761
3405-000,2016,6,10,15,1226,1035,2261,2012
3405-000,2016,6,10,16,1221,975,2196,2261
3405-000,2016,6,10,17,1248,1005,2253,2196
3405-000,2016,6,10,18,1474,1007,2481,2253
3405-000,2016,6,10,19,1527,1153,2680,2481
3405-000,2016,6,10,20,1050,822,1872,2680
3405-000,2016,6,10,21,740,596,1336,1872
3405-000,2016,6,10,22,478,479,957,1336
3405-000,2016,6,10,23,305,301,606,957
3405-000,2016,6,10,24,196,218,414,606
3405-000,2016,6,11,1,134,120,254,414
3405-000,2016,6,11,2,90,95,185,254
3405-000,2016,6,11,3,70,59,129,185
3405-000,2016,6,11,4,64,90,154,129
3405-000,2016,6,11,5,118,106,224,154
3405-000,2016,6,11,6,286,170,456,224
3405-000,2016,6,11,7,523,406,929,456
3405-000,2016,6,11,8,869,616,1485,929
3405-000,2016,6,11,9,1024,739,1763,1485
3405-000,2016,6,11,10,1022,765,1787,1763
3405-000,2016,6,11,11,1106,729,1835,1787
3405-000,2016,6,11,12,936,732,1668,1835
3405-000,2016,6,11,13,822,697,1519,1668
3405-000,2016,6,11,14,882,771,1653,1519
3405-000,2016,6,11,15,924,711,1635,1653
3405-000,2016,6,11,16,980,718,1698,1635
3405-000,2016,6,11,17,992,700,1692,1698
3405-000,2016,6,11,18,1092,857,1949,1692
3405-000,2016,6,11,19,881,738,1619,1949
3405-000,2016,6,11,20,565,519,1084,1619
3405-000,2016,6,11,21,447,389,836,1084
3405-000,2016,6,11,22,343,360,703,836
3405-000,2016,6,11,23,261,242,503,703
3405-000,2016,6,11,24,168,198,366,503
3405-000,2016,6,12,1,111,99,210,366
3405-000,2016,6,12,2,47,72,119,210
3405-000,2016,6,12,3,55,48,103,119
3405-000,2016,6,12,4,41,42,83,103
3405-000,2016,6,12,5,57,57,114,83
3405-000,2016,6,12,6,153,95,248,114
3405-000,2016,6,12,7,260,174,434,248
3405-000,2016,6,12,8,303,258,561,434
3405-000,2016,6,12,9,415,338,753,561
3405-000,2016,6,12,10,524,352,876,753
3405-000,2016,6,12,11,549,428,977,876
3405-000,2016,6,12,12,544,472,1016,977
3405-000,2016,6,12,13,486,458,944,1016
3405-000,2016,6,12,14,489,520,1009,944
3405-000,2016,6,12,15,598,555,1153,1009
3405-000,2016,6,12,16,597,561,1158,1153
3405-000,2016,6,12,17,632,627,1259,1158
3405-000,2016,6,12,18,621,591,1212,1259
3405-000,2016,6,12,19,541,590,1131,1212
3405-000,2016,6,12,20,435,470,905,1131
3405-000,2016,6,12,21,394,412,806,905
3405-000,2016,6,12,22,312,373,685,806
3405-000,2016,6,12,23,210,284,494,685
3405-000,2016,6,12,24,130,194,324,494
3405-000,2016,6,13,1,66,115,181,324
3405-000,2016,6,13,2,58,80,138,181
3405-000,2016,6,13,3,43,56,99,138
3405-000,2016,6,13,4,50,65,115,99
3405-000,2016,6,13,5,121,118,239,115
3405-000,2016,6,13,6,322,275,597,239
3405-000,2016,6,13,7,620,695,1315,597
3405-000,2016,6,13,8,1115,1559,2674,1315
3405-000,2016,6,13,9,1288,1349,2637,2674
3405-000,2016,6,13,10,1048,972,2020,2637
3405-000,2016,6,13,11,1098,981,2079,2020
3405-000,2016,6,13,12,1055,954,2009,2079
3405-000,2016,6,13,13,943,844,1787,2009
3405-000,2016,6,13,14,978,933,1911,1787
3405-000,2016,6,13,15,1135,1037,2172,1911
3405-000,2016,6,13,16,1072,1038,2110,2172
3405-000,2016,6,13,17,1107,938,2045,2110
3405-000,2016,6,13,18,1178,994,2172,2045
3405-000,2016,6,13,19,1153,986,2139,2172
3405-000,2016,6,13,20,773,721,1494,2139
3405-000,2016,6,13,21,657,604,1261,1494
3405-000,2016,6,13,22,428,437,865,1261
3405-000,2016,6,13,23,305,252,557,865
3405-000,2016,6,13,24,137,199,336,557
3405-000,2016,6,14,1,87,138,225,336
3405-000,2016,6,14,2,57,89,146,225
3405-000,2016,6,14,3,47,78,125,146
3405-000,2016,6,14,4,72,84,156,125
3405-000,2016,6,14,5,119,95,214,156
3405-000,2016,6,14,6,286,246,532,214
3405-000,2016,6,14,7,588,532,1120,532
3405-000,2016,6,14,8,1067,1204,2271,1120
3405-000,2016,6,14,9,1335,1305,2640,2271
3405-000,2016,6,14,10,1198,996,2194,2640
3405-000,2016,6,14,11,1081,1047,2128,2194
3405-000,2016,6,14,12,1115,972,2087,2128
3405-000,2016,6,14,13,959,863,1822,2087
3405-000,2016,6,14,14,961,947,1908,1822
3405-000,2016,6,14,15,1150,999,2149,1908
3405-000,2016,6,14,16,1133,987,2120,2149
3405-000,2016,6,14,17,1188,977,2165,2120
3405-000,2016,6,14,18,1268,1072,2340,2165
3405-000,2016,6,14,19,1180,1042,2222,2340
3405-000,2016,6,14,20,781,706,1487,2222
3405-000,2016,6,14,21,653,619,1272,1487
3405-000,2016,6,14,22,454,502,956,1272
3405-000,2016,6,14,23,315,258,573,956
3405-000,2016,6,14,24,177,197,374,573
3405-000,2016,6,15,1,99,132,231,374
3405-000,2016,6,15,2,65,87,152,231
3405-000,2016,6,15,3,55,57,112,152
3405-000,2016,6,15,4,56,79,135,112
3405-000,2016,6,15,5,123,121,244,135
3405-000,2016,6,15,6,284,218,502,244
3405-000,2016,6,15,7,543,501,1044,502
3405-000,2016,6,15,8,1021,1171,2192,1044
3405-000,2016,6,15,9,1293,1280,2573,2192
3405-000,2016,6,15,10,1154,965,2119,2573
3405-000,2016,6,15,11,1149,1000,2149,2119
3405-000,2016,6,15,12,1109,966,2075,2149
3405-000,2016,6,15,13,926,817,1743,2075
3405-000,2016,6,15,14,995,1018,2013,1743
3405-000,2016,6,15,15,1203,940,2143,2013
3405-000,2016,6,15,16,1084,947,2031,2143
3405-000,2016,6,15,17,1109,941,2050,2031
3405-000,2016,6,15,18,1195,993,2188,2050
3405-000,2016,6,15,19,1123,1028,2151,2188
3405-000,2016,6,15,20,723,607,1330,2151
3405-000,2016,6,15,21,540,533,1073,1330
3405-000,2016,6,15,22,435,429,864,1073
3405-000,2016,6,15,23,273,259,532,864
3405-000,2016,6,15,24,184,160,344,532
3405-000,2016,6,16,1,85,134,219,344
3405-000,2016,6,16,2,67,86,153,219
3405-000,2016,6,16,3,56,56,112,153
3405-000,2016,6,16,4,59,72,131,112
3405-000,2016,6,16,5,98,122,220,131
3405-000,2016,6,16,6,288,239,527,220
3405-000,2016,6,16,7,562,504,1066,527
3405-000,2016,6,16,8,1019,1205,2224,1066
3405-000,2016,6,16,9,1295,1280,2575,2224
3405-000,2016,6,16,10,1181,1043,2224,2575
3405-000,2016,6,16,11,1109,983,2092,2224
3405-000,2016,6,16,12,1081,956,2037,2092
3405-000,2016,6,16,13,946,890,1836,2037
3405-000,2016,6,16,14,1049,960,2009,1836
3405-000,2016,6,16,15,1204,1021,2225,2009
3405-000,2016,6,16,16,1139,993,2132,2225
3405-000,2016,6,16,17,1211,979,2190,2132
3405-000,2016,6,16,18,1224,1030,2254,2190
3405-000,2016,6,16,19,1242,996,2238,2254
3405-000,2016,6,16,20,868,678,1546,2238
3405-000,2016,6,16,21,722,642,1364,1546
3405-000,2016,6,16,22,425,464,889,1364
3405-000,2016,6,16,23,333,255,588,889
3405-000,2016,6,16,24,167,197,364,588
3405-000,2016,6,17,1,115,144,259,364
3405-000,2016,6,17,2,60,84,144,259
3405-000,2016,6,17,3,54,70,124,144
3405-000,2016,6,17,4,64,66,130,124
3405-000,2016,6,17,5,124,102,226,130
3405-000,2016,6,17,6,289,292,581,226
3405-000,2016,6,17,7,606,543,1149,581
3405-000,2016,6,17,8,1058,1259,2317,1149
3405-000,2016,6,17,9,1332,1381,2713,2317
3405-000,2016,6,17,10,1230,990,2220,2713
3405-000,2016,6,17,11,1194,1047,2241,2220
3405-000,2016,6,17,12,1187,999,2186,2241
3405-000,2016,6,17,13,1049,892,1941,2186
3405-000,2016,6,17,14,1099,1070,2169,1941
3405-000,2016,6,17,15,1267,1075,2342,2169
3405-000,2016,6,17,16,1302,1021,2323,2342
3405-000,2016,6,17,17,1460,1004,2464,2323
3405-000,2016,6,17,18,1530,1131,2661,2464
3405-000,2016,6,17,19,1558,1265,2823,2661
3405-000,2016,6,17,20,1106,872,1978,2823
3405-000,2016,6,17,21,790,661,1451,1978
3405-000,2016,6,17,22,548,444,992,1451
3405-000,2016,6,17,23,363,300,663,992
3405-000,2016,6,17,24,214,239,453,663
3405-000,2016,6,18,1,148,130,278,453
3405-000,2016,6,18,2,83,93,176,278
3405-000,2016,6,18,3,69,66,135,176
3405-000,2016,6,18,4,73,82,155,135
3405-000,2016,6,18,5,137,107,244,155
3405-000,2016,6,18,6,287,209,496,244
3405-000,2016,6,18,7,500,402,902,496
3405-000,2016,6,18,8,785,637,1422,902
3405-000,2016,6,18,9,1029,803,1832,1422
3405-000,2016,6,18,10,939,791,1730,1832
3405-000,2016,6,18,11,878,817,1695,1730
3405-000,2016,6,18,12,964,788,1752,1695
3405-000,2016,6,18,13,874,748,1622,1752
3405-000,2016,6,18,14,891,869,1760,1622
3405-000,2016,6,18,15,882,787,1669,1760
3405-000,2016,6,18,16,884,881,1765,1669
3405-000,2016,6,18,17,900,764,1664,1765
3405-000,2016,6,18,18,1101,884,1985,1664
3405-000,2016,6,18,19,914,810,1724,1985
3405-000,2016,6,18,20,630,558,1188,1724
3405-000,2016,6,18,21,455,423,878,1188
3405-000,2016,6,18,22,328,332,660,878
3405-000,2016,6,18,23,268,260,528,660
3405-000,2016,6,18,24,160,183,343,528
3405-000,2016,6,19,1,98,88,186,343
3405-000,2016,6,19,2,68,51,119,186
3405-000,2016,6,19,3,39,35,74,119
3405-000,2016,6,19,4,39,49,88,74
3405-000,2016,6,19,5,70,62,132,88
3405-000,2016,6,19,6,195,121,316,132
3405-000,2016,6,19,7,274,212,486,316
3405-000,2016,6,19,8,352,328,680,486
3405-000,2016,6,19,9,500,358,858,680
3405-000,2016,6,19,10,507,401,908,858
3405-000,2016,6,19,11,565,490,1055,908
3405-000,2016,6,19,12,535,503,1038,1055
3405-000,2016,6,19,13,546,515,1061,1038
3405-000,2016,6,19,14,607,566,1173,1061
3405-000,2016,6,19,15,620,565,1185,1173
3405-000,2016,6,19,16,659,672,1331,1185
3405-000,2016,6,19,17,719,654,1373,1331
3405-000,2016,6,19,18,796,698,1494,1373
3405-000,2016,6,19,19,600,688,1288,1494
3405-000,2016,6,19,20,473,591,1064,1288
3405-000,2016,6,19,21,403,483,886,1064
3405-000,2016,6,19,22,318,445,763,886
3405-000,2016,6,19,23,262,341,603,763
3405-000,2016,6,19,24,135,209,344,603
3405-000,2016,6,20,1,78,122,200,344
3405-000,2016,6,20,2,55,71,126,200
3405-000,2016,6,20,3,39,54,93,126
3405-000,2016,6,20,4,57,81,138,93
3405-000,2016,6,20,5,119,126,245,138
3405-000,2016,6,20,6,338,311,649,245
3405-000,2016,6,20,7,696,803,1499,649
3405-000,2016,6,20,8,1217,1530,2747,1499
3405-000,2016,6,20,9,1317,1292,2609,2747
3405-000,2016,6,20,10,1125,960,2085,2609
3405-000,2016,6,20,11,1134,1018,2152,2085
3405-000,2016,6,20,12,1054,1015,2069,2152
3405-000,2016,6,20,13,869,974,1843,2069
3405-000,2016,6,20,14,1044,1116,2160,1843
3405-000,2016,6,20,15,1185,1035,2220,2160
3405-000,2016,6,20,16,1146,994,2140,2220
3405-000,2016,6,20,17,1135,949,2084,2140
3405-000,2016,6,20,18,1238,1039,2277,2084
3405-000,2016,6,20,19,1173,1069,2242,2277
3405-000,2016,6,20,20,825,709,1534,2242
3405-000,2016,6,20,21,621,633,1254,1534
3405-000,2016,6,20,22,449,437,886,1254
3405-000,2016,6,20,23,269,241,510,886
3405-000,2016,6,20,24,173,200,373,510
3405-000,2016,6,21,1,95,112,207,373
3405-000,2016,6,21,2,53,86,139,207
3405-000,2016,6,21,3,50,57,107,139
3405-000,2016,6,21,4,76,90,166,107
3405-000,2016,6,21,5,113,123,236,166
3405-000,2016,6,21,6,327,266,593,236
3405-000,2016,6,21,7,633,585,1218,593
3405-000,2016,6,21,8,1119,1329,2448,1218
3405-000,2016,6,21,9,1307,1232,2539,2448
3405-000,2016,6,21,10,1192,1070,2262,2539
3405-000,2016,6,21,11,1093,1055,2148,2262
3405-000,2016,6,21,12,1141,895,2036,2148
3405-000,2016,6,21,13,927,849,1776,2036
3405-000,2016,6,21,14,1016,994,2010,1776
3405-000,2016,6,21,15,1180,1025,2205,2010
3405-000,2016,6,21,16,1205,1072,2277,2205
3405-000,2016,6,21,17,1188,984,2172,2277
3405-000,2016,6,21,18,1241,1047,2288,2172
3405-000,2016,6,21,19,1084,1009,2093,2288
3405-000,2016,6,21,20,754,683,1437,2093
3405-000,2016,6,21,21,604,618,1222,1437
3405-000,2016,6,21,22,450,393,843,1222
3405-000,2016,6,21,23,289,249,538,843
3405-000,2016,6,21,24,157,188,345,538
3405-000,2016,6,22,1,107,120,227,345
3405-000,2016,6,22,2,56,67,123,227
3405-000,2016,6,22,3,61,55,116,123
3405-000,2016,6,22,4,49,85,134,116
3405-000,2016,6,22,5,112,100,212,134
3405-000,2016,6,22,6,308,210,518,212
3405-000,2016,6,22,7,574,536,1110,518
3405-000,2016,6,22,8,1122,1261,2383,1110
3405-000,2016,6,22,9,1354,1235,2589,2383
3405-000,2016,6,22,10,1153,995,2148,2589
3405-000,2016,6,22,11,1123,968,2091,2148
3405-000,2016,6,22,12,1104,915,2019,2091
3405-000,2016,6,22,13,937,869,1806,2019
3405-000,2016,6,22,14,983,996,1979,1806
3405-000,2016,6,22,15,1199,1105,2304,1979
3405-000,2016,6,22,16,1141,961,2102,2304
3405-000,2016,6,22,17,1140,959,2099,2102
3405-000,2016,6,22,18,1253,1001,2254,2099
3405-000,2016,6,22,19,1100,1000,2100,2254
3405-000,2016,6,22,20,725,660,1385,2100
3405-000,2016,6,22,21,501,540,1041,1385
3405-000,2016,6,22,22,372,377,749,1041
3405-000,2016,6,22,23,246,245,491,749
3405-000,2016,6,22,24,156,177,333,491
3405-000,2016,6,23,1,100,105,205,333
3405-000,2016,6,23,2,70,79,149,205
3405-000,2016,6,23,3,66,74,140,149
3405-000,2016,6,23,4,81,85,166,140
3405-000,2016,6,23,5,117,125,242,166
3405-000,2016,6,23,6,312,279,591,242
3405-000,2016,6,23,7,616,611,1227,591
3405-000,2016,6,23,8,1120,1306,2426,1227
3405-000,2016,6,23,9,1390,1280,2670,2426
3405-000,2016,6,23,10,1129,1014,2143,2670
3405-000,2016,6,23,11,1205,1033,2238,2143
3405-000,2016,6,23,12,1125,973,2098,2238
3405-000,2016,6,23,13,969,885,1854,2098
3405-000,2016,6,23,14,1040,971,2011,1854
3405-000,2016,6,23,15,1197,1032,2229,2011
3405-000,2016,6,23,16,1175,1028,2203,2229
3405-000,2016,6,23,17,1146,1034,2180,2203
3405-000,2016,6,23,18,1306,1025,2331,2180
3405-000,2016,6,23,19,1130,1048,2178,2331
3405-000,2016,6,23,20,815,683,1498,2178
3405-000,2016,6,23,21,636,628,1264,1498
3405-000,2016,6,23,22,431,429,860,1264
3405-000,2016,6,23,23,317,269,586,860
3405-000,2016,6,23,24,160,184,344,586
3405-000,2016,6,24,1,99,101,200,344
3405-000,2016,6,24,2,67,76,143,200
3405-000,2016,6,24,3,47,69,116,143
3405-000,2016,6,24,4,68,78,146,116
3405-000,2016,6,24,5,104,96,200,146
3405-000,2016,6,24,6,256,201,457,200
3405-000,2016,6,24,7,515,474,989,457
3405-000,2016,6,24,8,1033,1162,2195,989
3405-000,2016,6,24,9,1264,1156,2420,2195
3405-000,2016,6,24,10,1054,898,1952,2420
3405-000,2016,6,24,11,1089,938,2027,1952
3405-000,2016,6,24,12,1078,899,1977,2027
3405-000,2016,6,24,13,933,887,1820,1977
3405-000,2016,6,24,14,1018,984,2002,1820
3405-000,2016,6,24,15,1160,1036,2196,2002
3405-000,2016,6,24,16,1157,1050,2207,2196
3405-000,2016,6,24,17,1169,907,2076,2207
3405-000,2016,6,24,18,1342,991,2333,2076
3405-000,2016,6,24,19,1371,1150,2521,2333
3405-000,2016,6,24,20,966,687,1653,2521
3405-000,2016,6,24,21,695,607,1302,1653
3405-000,2016,6,24,22,512,465,977,1302
3405-000,2016,6,24,23,335,272,607,977
3405-000,2016,6,24,24,199,213,412,607
3405-000,2016,6,25,1,131,116,247,412
3405-000,2016,6,25,2,67,107,174,247
3405-000,2016,6,25,3,59,64,123,174
3405-000,2016,6,25,4,75,88,163,123
3405-000,2016,6,25,5,115,117,232,163
3405-000,2016,6,25,6,282,203,485,232
3405-000,2016,6,25,7,501,440,941,485
3405-000,2016,6,25,8,808,614,1422,941
3405-000,2016,6,25,9,986,713,1699,1422
3405-000,2016,6,25,10,963,782,1745,1699
3405-000,2016,6,25,11,970,774,1744,1745
3405-000,2016,6,25,12,920,798,1718,1744
3405-000,2016,6,25,13,861,709,1570,1718
3405-000,2016,6,25,14,917,722,1639,1570
3405-000,2016,6,25,15,913,743,1656,1639
3405-000,2016,6,25,16,868,806,1674,1656
3405-000,2016,6,25,17,899,726,1625,1674
3405-000,2016,6,25,18,986,899,1885,1625
3405-000,2016,6,25,19,865,718,1583,1885
3405-000,2016,6,25,20,563,540,1103,1583
3405-000,2016,6,25,21,420,467,887,1103
3405-000,2016,6,25,22,346,355,701,887
3405-000,2016,6,25,23,263,255,518,701
3405-000,2016,6,25,24,146,200,346,518
3405-000,2016,6,26,1,108,106,214,346
3405-000,2016,6,26,2,52,67,119,214
3405-000,2016,6,26,3,36,39,75,119
3405-000,2016,6,26,4,33,38,71,75
3405-000,2016,6,26,5,80,59,139,71
3405-000,2016,6,26,6,170,115,285,139
3405-000,2016,6,26,7,285,212,497,285
3405-000,2016,6,26,8,377,303,680,497
3405-000,2016,6,26,9,531,387,918,680
3405-000,2016,6,26,10,538,394,932,918
3405-000,2016,6,26,11,634,472,1106,932
3405-000,2016,6,26,12,607,553,1160,1106
3405-000,2016,6,26,13,497,445,942,1160
3405-000,2016,6,26,14,552,525,1077,942
3405-000,2016,6,26,15,625,531,1156,1077
3405-000,2016,6,26,16,704,595,1299,1156
3405-000,2016,6,26,17,695,644,1339,1299
3405-000,2016,6,26,18,712,605,1317,1339
3405-000,2016,6,26,19,632,605,1237,1317
3405-000,2016,6,26,20,500,616,1116,1237
3405-000,2016,6,26,21,369,498,867,1116
3405-000,2016,6,26,22,286,441,727,867
3405-000,2016,6,26,23,226,328,554,727
3405-000,2016,6,26,24,115,238,353,554
3405-000,2016,6,27,1,100,123,223,353
3405-000,2016,6,27,2,56,89,145,223
3405-000,2016,6,27,3,54,54,108,145
3405-000,2016,6,27,4,48,90,138,108
3405-000,2016,6,27,5,125,133,258,138
3405-000,2016,6,27,6,337,339,676,258
3405-000,2016,6,27,7,700,706,1406,676
3405-000,2016,6,27,8,1165,1572,2737,1406
3405-000,2016,6,27,9,1337,1304,2641,2737
3405-000,2016,6,27,10,1109,947,2056,2641
3405-000,2016,6,27,11,1150,1001,2151,2056
3405-000,2016,6,27,12,1070,970,2040,2151
3405-000,2016,6,27,13,908,893,1801,2040
3405-000,2016,6,27,14,992,1062,2054,1801
3405-000,2016,6,27,15,1183,1047,2230,2054
3405-000,2016,6,27,16,1162,1063,2225,2230
3405-000,2016,6,27,17,1134,992,2126,2225
3405-000,2016,6,27,18,1279,998,2277,2126
3405-000,2016,6,27,19,1080,1070,2150,2277
3405-000,2016,6,27,20,744,723,1467,2150
3405-000,2016,6,27,21,602,598,1200,1467
3405-000,2016,6,27,22,414,411,825,1200
3405-000,2016,6,27,23,271,268,539,825
3405-000,2016,6,27,24,149,179,328,539
3405-000,2016,6,28,1,93,121,214,328
3405-000,2016,6,28,2,55,66,121,214
3405-000,2016,6,28,3,59,70,129,121
3405-000,2016,6,28,4,81,90,171,129
3405-000,2016,6,28,5,124,102,226,171
3405-000,2016,6,28,6,336,272,608,226
3405-000,2016,6,28,7,606,589,1195,608
3405-000,2016,6,28,8,1113,1305,2418,1195
3405-000,2016,6,28,9,1385,1284,2669,2418
3405-000,2016,6,28,10,1164,1010,2174,2669
3405-000,2016,6,28,11,1195,978,2173,2174
3405-000,2016,6,28,12,1146,953,2099,2173
3405-000,2016,6,28,13,913,850,1763,2099
3405-000,2016,6,28,14,1053,969,2022,1763
3405-000,2016,6,28,15,1179,1119,2298,2022
3405-000,2016,6,28,16,1158,1017,2175,2298
3405-000,2016,6,28,17,1182,986,2168,2175
3405-000,2016,6,28,18,1261,1032,2293,2168
3405-000,2016,6,28,19,1235,1055,2290,2293
3405-000,2016,6,28,20,791,701,1492,2290
3405-000,2016,6,28,21,625,615,1240,1492
3405-000,2016,6,28,22,421,452,873,1240
3405-000,2016,6,28,23,297,233,530,873
3405-000,2016,6,28,24,156,196,352,530
3405-000,2016,6,29,1,82,111,193,352
3405-000,2016,6,29,2,72,76,148,193
3405-000,2016,6,29,3,52,67,119,148
3405-000,2016,6,29,4,57,72,129,119
3405-000,2016,6,29,5,124,118,242,129
3405-000,2016,6,29,6,323,276,599,242
3405-000,2016,6,29,7,635,570,1205,599
3405-000,2016,6,29,8,1086,1338,2424,1205
3405-000,2016,6,29,9,1346,1244,2590,2424
3405-000,2016,6,29,10,1111,999,2110,2590
3405-000,2016,6,29,11,1103,1031,2134,2110
3405-000,2016,6,29,12,1149,978,2127,2134
3405-000,2016,6,29,13,950,861,1811,2127
3405-000,2016,6,29,14,1067,1068,2135,1811
3405-000,2016,6,29,15,1215,1060,2275,2135
3405-000,2016,6,29,16,1264,1019,2283,2275
3405-000,2016,6,29,17,1192,1018,2210,2283
3405-000,2016,6,29,18,1333,1098,2431,2210
3405-000,2016,6,29,19,1231,1036,2267,2431
3405-000,2016,6,29,20,764,713,1477,2267
3405-000,2016,6,29,21,552,495,1047,1477
3405-000,2016,6,29,22,411,400,811,1047
3405-000,2016,6,29,23,302,224,526,811
3405-000,2016,6,29,24,159,177,336,526
3405-000,2016,6,30,1,99,114,213,336
3405-000,2016,6,30,2,75,68,143,213
3405-000,2016,6,30,3,62,65,127,143
3405-000,2016,6,30,4,59,75,134,127
3405-000,2016,6,30,5,119,108,227,134
3405-000,2016,6,30,6,292,251,543,227
3405-000,2016,6,30,7,571,570,1141,543
3405-000,2016,6,30,8,1087,1294,2381,1141
3405-000,2016,6,30,9,1323,1331,2654,2381
3405-000,2016,6,30,10,1126,1018,2144,2654
3405-000,2016,6,30,11,1141,1008,2149,2144
3405-000,2016,6,30,12,1100,908,2008,2149
3405-000,2016,6,30,13,887,862,1749,2008
3405-000,2016,6,30,14,999,1020,2019,1749
3405-000,2016,6,30,15,1132,989,2121,2019
3405-000,2016,6,30,16,1056,930,1986,2121
3405-000,2016,6,30,17,1148,920,2068,1986
3405-000,2016,6,30,18,1253,1067,2320,2068
3405-000,2016,6,30,19,1153,1023,2176,2320
3405-000,2016,6,30,20,805,701,1506,2176
3405-000,2016,6,30,21,668,604,1272,1506
3405-000,2016,6,30,22,435,427,862,1272
3405-000,2016,6,30,23,290,233,523,862
3405-000,2016,6,30,24,149,189,338,523
3405-000,2016,7,1,1,120,120,240,338
3405-000,2016,7,1,2,94,93,187,240
3405-000,2016,7,1,3,56,64,120,187
3405-000,2016,7,1,4,77,75,152,120
3405-000,2016,7,1,5,121,108,229,152
3405-000,2016,7,1,6,277,254,531,229
3405-000,2016,7,1,7,593,503,1096,531
3405-000,2016,7,1,8,1068,1295,2363,1096
3405-000,2016,7,1,9,1365,1234,2599,2363
3405-000,2016,7,1,10,1140,953,2093,2599
3405-000,2016,7,1,11,1182,978,2160,2093
3405-000,2016,7,1,12,1089,893,1982,2160
3405-000,2016,7,1,13,991,849,1840,1982
3405-000,2016,7,1,14,1056,952,2008,1840
3405-000,2016,7,1,15,1121,935,2056,2008
3405-000,2016,7,1,16,1137,1036,2173,2056
3405-000,2016,7,1,17,1075,956,2031,2173
3405-000,2016,7,1,18,1356,1148,2504,2031
3405-000,2016,7,1,19,1409,1267,2676,2504
3405-000,2016,7,1,20,951,861,1812,2676
3405-000,2016,7,1,21,662,684,1346,1812
3405-000,2016,7,1,22,496,395,891,1346
3405-000,2016,7,1,23,294,232,526,891
3405-000,2016,7,1,24,145,160,305,526
3405-000,2016,7,2,1,102,114,216,305
3405-000,2016,7,2,2,86,73,159,216
3405-000,2016,7,2,3,54,50,104,159
3405-000,2016,7,2,4,65,85,150,104
3405-000,2016,7,2,5,68,97,165,150
3405-000,2016,7,2,6,212,171,383,165
3405-000,2016,7,2,7,422,282,704,383
3405-000,2016,7,2,8,690,560,1250,704
3405-000,2016,7,2,9,842,647,1489,1250
3405-000,2016,7,2,10,878,652,1530,1489
3405-000,2016,7,2,11,926,695,1621,1530
3405-000,2016,7,2,12,926,696,1622,1621
3405-000,2016,7,2,13,815,713,1528,1622
3405-000,2016,7,2,14,714,668,1382,1528
3405-000,2016,7,2,15,826,718,1544,1382
3405-000,2016,7,2,16,814,712,1526,1544
3405-000,2016,7,2,17,849,718,1567,1526
3405-000,2016,7,2,18,918,820,1738,1567
3405-000,2016,7,2,19,770,632,1402,1738
3405-000,2016,7,2,20,468,494,962,1402
3405-000,2016,7,2,21,406,374,780,962
3405-000,2016,7,2,22,301,311,612,780
3405-000,2016,7,2,23,213,228,441,612
3405-000,2016,7,2,24,141,157,298,441
3405-000,2016,7,3,1,98,91,189,298
3405-000,2016,7,3,2,67,71,138,189
3405-000,2016,7,3,3,32,37,69,138
3405-000,2016,7,3,4,38,45,83,69
3405-000,2016,7,3,5,62,57,119,83
3405-000,2016,7,3,6,127,95,222,119
3405-000,2016,7,3,7,233,174,407,222
3405-000,2016,7,3,8,336,266,602,407
3405-000,2016,7,3,9,454,328,782,602
3405-000,2016,7,3,10,477,338,815,782
3405-000,2016,7,3,11,594,426,1020,815
3405-000,2016,7,3,12,504,489,993,1020
3405-000,2016,7,3,13,488,462,950,993
3405-000,2016,7,3,14,506,531,1037,950
3405-000,2016,7,3,15,611,630,1241,1037
3405-000,2016,7,3,16,625,732,1357,1241
3405-000,2016,7,3,17,606,794,1400,1357
3405-000,2016,7,3,18,577,780,1357,1400
3405-000,2016,7,3,19,454,736,1190,1357
3405-000,2016,7,3,20,359,543,902,1190
3405-000,2016,7,3,21,365,403,768,902
3405-000,2016,7,3,22,319,381,700,768
3405-000,2016,7,3,23,233,270,503,700
3405-000,2016,7,3,24,123,168,291,503
3405-000,2016,7,4,1,73,103,176,291
3405-000,2016,7,4,2,50,61,111,176
3405-000,2016,7,4,3,41,42,83,111
3405-000,2016,7,4,4,47,69,116,83
3405-000,2016,7,4,5,85,101,186,116
3405-000,2016,7,4,6,283,231,514,186
3405-000,2016,7,4,7,563,599,1162,514
3405-000,2016,7,4,8,1055,1442,2497,1162
3405-000,2016,7,4,9,1214,1309,2523,2497
3405-000,2016,7,4,10,963,864,1827,2523
3405-000,2016,7,4,11,953,898,1851,1827
3405-000,2016,7,4,12,911,812,1723,1851
3405-000,2016,7,4,13,868,729,1597,1723
3405-000,2016,7,4,14,875,900,1775,1597
3405-000,2016,7,4,15,1017,930,1947,1775
3405-000,2016,7,4,16,922,972,1894,1947
3405-000,2016,7,4,17,1017,836,1853,1894
3405-000,2016,7,4,18,1021,923,1944,1853
3405-000,2016,7,4,19,1011,956,1967,1944
3405-000,2016,7,4,20,645,627,1272,1967
3405-000,2016,7,4,21,571,530,1101,1272
3405-000,2016,7,4,22,396,361,757,1101
3405-000,2016,7,4,23,228,201,429,757
3405-000,2016,7,4,24,122,139,261,429
3405-000,2016,7,5,1,95,108,203,261
3405-000,2016,7,5,2,76,65,141,203
3405-000,2016,7,5,3,49,64,113,141
3405-000,2016,7,5,4,57,79,136,113
3405-000,2016,7,5,5,85,95,180,136
3405-000,2016,7,5,6,239,188,427,180
3405-000,2016,7,5,7,518,467,985,427
3405-000,2016,7,5,8,1025,1201,2226,985
3405-000,2016,7,5,9,1275,1176,2451,2226
3405-000,2016,7,5,10,1015,835,1850,2451
3405-000,2016,7,5,11,1038,884,1922,1850
3405-000,2016,7,5,12,986,919,1905,1922
3405-000,2016,7,5,13,850,753,1603,1905
3405-000,2016,7,5,14,921,905,1826,1603
3405-000,2016,7,5,15,1100,972,2072,1826
3405-000,2016,7,5,16,1080,895,1975,2072
3405-000,2016,7,5,17,1041,953,1994,1975
3405-000,2016,7,5,18,1027,904,1931,1994
3405-000,2016,7,5,19,995,968,1963,1931
3405-000,2016,7,5,20,769,663,1432,1963
3405-000,2016,7,5,21,547,547,1094,1432
3405-000,2016,7,5,22,375,409,784,1094
3405-000,2016,7,5,23,276,223,499,784
3405-000,2016,7,5,24,158,154,312,499
3405-000,2016,7,6,1,104,105,209,312
3405-000,2016,7,6,2,60,84,144,209
3405-000,2016,7,6,3,51,70,121,144
3405-000,2016,7,6,4,52,64,116,121
3405-000,2016,7,6,5,85,81,166,116
3405-000,2016,7,6,6,226,179,405,166
3405-000,2016,7,6,7,471,461,932,405
3405-000,2016,7,6,8,985,1161,2146,932
3405-000,2016,7,6,9,1235,1161,2396,2146
3405-000,2016,7,6,10,1050,968,2018,2396
3405-000,2016,7,6,11,1071,932,2003,2018
3405-000,2016,7,6,12,1048,881,1929,2003
3405-000,2016,7,6,13,910,804,1714,1929
3405-000,2016,7,6,14,1011,968,1979,1714
3405-000,2016,7,6,15,1129,1011,2140,1979
3405-000,2016,7,6,16,1126,971,2097,2140
3405-000,2016,7,6,17,1047,976,2023,2097
3405-000,2016,7,6,18,1202,1075,2277,2023
3405-000,2016,7,6,19,1177,927,2104,2277
3405-000,2016,7,6,20,765,655,1420,2104
3405-000,2016,7,6,21,550,518,1068,1420
3405-000,2016,7,6,22,379,397,776,1068
3405-000,2016,7,6,23,265,215,480,776
3405-000,2016,7,6,24,163,156,319,480
3405-000,2016,7,7,1,92,103,195,319
3405-000,2016,7,7,2,57,93,150,195
3405-000,2016,7,7,3,50,67,117,150
3405-000,2016,7,7,4,52,86,138,117
3405-000,2016,7,7,5,106,102,208,138
3405-000,2016,7,7,6,277,222,499,208
3405-000,2016,7,7,7,558,533,1091,499
3405-000,2016,7,7,8,1097,1263,2360,1091
3405-000,2016,7,7,9,1290,1301,2591,2360
3405-000,2016,7,7,10,1103,913,2016,2591
3405-000,2016,7,7,11,1158,979,2137,2016
3405-000,2016,7,7,12,1010,1001,2011,2137
3405-000,2016,7,7,13,972,857,1829,2011
3405-000,2016,7,7,14,1024,958,1982,1829
3405-000,2016,7,7,15,1178,1022,2200,1982
3405-000,2016,7,7,16,1121,988,2109,2200
3405-000,2016,7,7,17,1112,962,2074,2109
3405-000,2016,7,7,18,1225,1058,2283,2074
3405-000,2016,7,7,19,1101,950,2051,2283
3405-000,2016,7,7,20,747,677,1424,2051
3405-000,2016,7,7,21,619,596,1215,1424
3405-000,2016,7,7,22,426,472,898,1215
3405-000,2016,7,7,23,299,256,555,898
3405-000,2016,7,7,24,181,167,348,555
3405-000,2016,7,8,1,104,129,233,348
3405-000,2016,7,8,2,56,77,133,233
3405-000,2016,7,8,3,56,78,134,133
3405-000,2016,7,8,4,65,66,131,134
3405-000,2016,7,8,5,104,108,212,131
3405-000,2016,7,8,6,303,236,539,212
3405-000,2016,7,8,7,589,580,1169,539
3405-000,2016,7,8,8,1068,1281,2349,1169
3405-000,2016,7,8,9,1317,1224,2541,2349
3405-000,2016,7,8,10,1097,937,2034,2541
3405-000,2016,7,8,11,1110,944,2054,2034
3405-000,2016,7,8,12,1082,927,2009,2054
3405-000,2016,7,8,13,941,808,1749,2009
3405-000,2016,7,8,14,1056,973,2029,1749
3405-000,2016,7,8,15,1227,1041,2268,2029
3405-000,2016,7,8,16,1180,975,2155,2268
3405-000,2016,7,8,17,1170,997,2167,2155
3405-000,2016,7,8,18,1374,1172,2546,2167
3405-000,2016,7,8,19,1595,1270,2865,2546
3405-000,2016,7,8,20,1042,783,1825,2865
3405-000,2016,7,8,21,786,647,1433,1825
3405-000,2016,7,8,22,486,451,937,1433
3405-000,2016,7,8,23,329,249,578,937
3405-000,2016,7,8,24,178,183,361,578
3405-000,2016,7,9,1,134,135,269,361
3405-000,2016,7,9,2,64,81,145,269
3405-000,2016,7,9,3,63,63,126,145
3405-000,2016,7,9,4,85,66,151,126
3405-000,2016,7,9,5,129,112,241,151
3405-000,2016,7,9,6,268,177,445,241
3405-000,2016,7,9,7,478,370,848,445
3405-000,2016,7,9,8,732,644,1376,848
3405-000,2016,7,9,9,988,790,1778,1376
3405-000,2016,7,9,10,951,741,1692,1778
3405-000,2016,7,9,11,992,828,1820,1692
3405-000,2016,7,9,12,1010,689,1699,1820
3405-000,2016,7,9,13,872,679,1551,1699
3405-000,2016,7,9,14,815,654,1469,1551
3405-000,2016,7,9,15,804,706,1510,1469
3405-000,2016,7,9,16,875,757,1632,1510
3405-000,2016,7,9,17,883,771,1654,1632
3405-000,2016,7,9,18,1016,786,1802,1654
3405-000,2016,7,9,19,826,723,1549,1802
3405-000,2016,7,9,20,590,530,1120,1549
3405-000,2016,7,9,21,422,404,826,1120
3405-000,2016,7,9,22,358,332,690,826
3405-000,2016,7,9,23,225,215,440,690
3405-000,2016,7,9,24,161,162,323,440
3405-000,2016,7,10,1,84,84,168,323
3405-000,2016,7,10,2,65,72,137,168
3405-000,2016,7,10,3,44,47,91,137
3405-000,2016,7,10,4,42,37,79,91
3405-000,2016,7,10,5,69,48,117,79
3405-000,2016,7,10,6,159,102,261,117
3405-000,2016,7,10,7,305,189,494,261
3405-000,2016,7,10,8,393,309,702,494
3405-000,2016,7,10,9,473,388,861,702
3405-000,2016,7,10,10,499,384,883,861
3405-000,2016,7,10,11,645,399,1044,883
3405-000,2016,7,10,12,573,469,1042,1044
3405-000,2016,7,10,13,510,469,979,1042
3405-000,2016,7,10,14,539,520,1059,979
3405-000,2016,7,10,15,631,569,1200,1059
3405-000,2016,7,10,16,629,718,1347,1200
3405-000,2016,7,10,17,619,679,1298,1347
3405-000,2016,7,10,18,807,665,1472,1298
3405-000,2016,7,10,19,795,625,1420,1472
3405-000,2016,7,10,20,471,510,981,1420
3405-000,2016,7,10,21,363,466,829,981
3405-000,2016,7,10,22,325,435,760,829
3405-000,2016,7,10,23,223,319,542,760
3405-000,2016,7,10,24,113,192,305,542
3405-000,2016,7,11,1,87,137,224,305
3405-000,2016,7,11,2,58,71,129,224
3405-000,2016,7,11,3,47,55,102,129
3405-000,2016,7,11,4,38,60,98,102
3405-000,2016,7,11,5,111,98,209,98
3405-000,2016,7,11,6,323,268,591,209
3405-000,2016,7,11,7,665,703,1368,591
3405-000,2016,7,11,8,1149,1576,2725,1368
3405-000,2016,7,11,9,1294,1326,2620,2725
3405-000,2016,7,11,10,1070,913,1983,2620
3405-000,2016,7,11,11,1085,1012,2097,1983
3405-000,2016,7,11,12,1058,931,1989,2097
3405-000,2016,7,11,13,900,855,1755,1989
3405-000,2016,7,11,14,1009,966,1975,1755
3405-000,2016,7,11,15,1149,1093,2242,1975
3405-000,2016,7,11,16,1208,986,2194,2242
3405-000,2016,7,11,17,1162,966,2128,2194
3405-000,2016,7,11,18,1238,989,2227,2128
3405-000,2016,7,11,19,1069,1041,2110,2227
3405-000,2016,7,11,20,828,712,1540,2110
3405-000,2016,7,11,21,640,631,1271,1540
3405-000,2016,7,11,22,390,457,847,1271
3405-000,2016,7,11,23,250,222,472,847
3405-000,2016,7,11,24,147,194,341,472
3405-000,2016,7,12,1,97,120,217,341
3405-000,2016,7,12,2,57,74,131,217
3405-000,2016,7,12,3,53,57,110,131
3405-000,2016,7,12,4,67,74,141,110
3405-000,2016,7,12,5,103,90,193,141
3405-000,2016,7,12,6,213,213,426,193
3405-000,2016,7,12,7,507,449,956,426
3405-000,2016,7,12,8,1043,1249,2292,956
3405-000,2016,7,12,9,1222,1262,2484,2292
3405-000,2016,7,12,10,1104,944,2048,2484
3405-000,2016,7,12,11,1075,986,2061,2048
3405-000,2016,7,12,12,991,941,1932,2061
3405-000,2016,7,12,13,834,828,1662,1932
3405-000,2016,7,12,14,996,946,1942,1662
3405-000,2016,7,12,15,1116,1018,2134,1942
3405-000,2016,7,12,16,1143,980,2123,2134
3405-000,2016,7,12,17,1040,1260,2300,2123
3405-000,2016,7,12,18,1225,979,2204,2300
3405-000,2016,7,12,19,1061,1024,2085,2204
3405-000,2016,7,12,20,764,661,1425,2085
3405-000,2016,7,12,21,578,584,1162,1425
3405-000,2016,7,12,22,438,397,835,1162
3405-000,2016,7,12,23,309,226,535,835
3405-000,2016,7,12,24,163,196,359,535
3405-000,2016,7,13,1,89,114,203,359
3405-000,2016,7,13,2,76,53,129,203
3405-000,2016,7,13,3,64,57,121,129
3405-000,2016,7,13,4,65,72,137,121
3405-000,2016,7,13,5,90,112,202,137
3405-000,2016,7,13,6,295,231,526,202
3405-000,2016,7,13,7,575,565,1140,526
3405-000,2016,7,13,8,1069,1310,2379,1140
3405-000,2016,7,13,9,1311,1282,2593,2379
3405-000,2016,7,13,10,1132,952,2084,2593
3405-000,2016,7,13,11,1128,1059,2187,2084
3405-000,2016,7,13,12,1032,969,2001,2187
3405-000,2016,7,13,13,926,803,1729,2001
3405-000,2016,7,13,14,1044,1006,2050,1729
3405-000,2016,7,13,15,1185,1009,2194,2050
3405-000,2016,7,13,16,1120,1024,2144,2194
3405-000,2016,7,13,17,1156,968,2124,2144
3405-000,2016,7,13,18,1295,1063,2358,2124
3405-000,2016,7,13,19,1177,1045,2222,2358
3405-000,2016,7,13,20,803,730,1533,2222
3405-000,2016,7,13,21,629,568,1197,1533
3405-000,2016,7,13,22,437,448,885,1197
3405-000,2016,7,13,23,275,223,498,885
3405-000,2016,7,13,24,139,181,320,498
3405-000,2016,7,14,1,113,124,237,320
3405-000,2016,7,14,2,64,100,164,237
3405-000,2016,7,14,3,57,65,122,164
3405-000,2016,7,14,4,70,66,136,122
3405-000,2016,7,14,5,98,99,197,136
3405-000,2016,7,14,6,288,225,513,197
3405-000,2016,7,14,7,599,567,1166,513
3405-000,2016,7,14,8,1106,1286,2392,1166
3405-000,2016,7,14,9,1339,1309,2648,2392
3405-000,2016,7,14,10,1089,946,2035,2648
3405-000,2016,7,14,11,1131,1016,2147,2035
3405-000,2016,7,14,12,1077,973,2050,2147
3405-000,2016,7,14,13,865,908,1773,2050
3405-000,2016,7,14,14,1024,1145,2169,1773
3405-000,2016,7,14,15,1120,1054,2174,2169
3405-000,2016,7,14,16,1134,933,2067,2174
3405-000,2016,7,14,17,1119,891,2010,2067
3405-000,2016,7,14,18,1236,998,2234,2010
3405-000,2016,7,14,19,1187,991,2178,2234
3405-000,2016,7,14,20,808,757,1565,2178
3405-000,2016,7,14,21,641,646,1287,1565
3405-000,2016,7,14,22,475,451,926,1287
3405-000,2016,7,14,23,290,256,546,926
3405-000,2016,7,14,24,160,208,368,546
3405-000,2016,7,15,1,92,96,188,368
3405-000,2016,7,15,2,80,80,160,188
3405-000,2016,7,15,3,50,65,115,160
3405-000,2016,7,15,4,67,67,134,115
3405-000,2016,7,15,5,110,88,198,134
3405-000,2016,7,15,6,286,224,510,198
3405-000,2016,7,15,7,540,582,1122,510
3405-000,2016,7,15,8,1083,1232,2315,1122
3405-000,2016,7,15,9,1285,1302,2587,2315
3405-000,2016,7,15,10,1152,929,2081,2587
3405-000,2016,7,15,11,1145,1081,2226,2081
3405-000,2016,7,15,12,1141,986,2127,2226
3405-000,2016,7,15,13,967,867,1834,2127
3405-000,2016,7,15,14,1063,994,2057,1834
3405-000,2016,7,15,15,1213,1096,2309,2057
3405-000,2016,7,15,16,1268,1025,2293,2309
3405-000,2016,7,15,17,1354,1165,2519,2293
3405-000,2016,7,15,18,1695,1235,2930,2519
3405-000,2016,7,15,19,1634,1213,2847,2930
3405-000,2016,7,15,20,1015,833,1848,2847
3405-000,2016,7,15,21,752,706,1458,1848
3405-000,2016,7,15,22,479,412,891,1458
3405-000,2016,7,15,23,320,249,569,891
3405-000,2016,7,15,24,169,188,357,569
3405-000,2016,7,16,1,115,149,264,357
3405-000,2016,7,16,2,82,112,194,264
3405-000,2016,7,16,3,60,57,117,194
3405-000,2016,7,16,4,67,78,145,117
3405-000,2016,7,16,5,74,83,157,145
3405-000,2016,7,16,6,202,135,337,157
3405-000,2016,7,16,7,389,272,661,337
3405-000,2016,7,16,8,682,525,1207,661
3405-000,2016,7,16,9,776,623,1399,1207
3405-000,2016,7,16,10,838,596,1434,1399
3405-000,2016,7,16,11,988,649,1637,1434
3405-000,2016,7,16,12,996,654,1650,1637
3405-000,2016,7,16,13,856,634,1490,1650
3405-000,2016,7,16,14,845,608,1453,1490
3405-000,2016,7,16,15,785,661,1446,1453
3405-000,2016,7,16,16,744,691,1435,1446
3405-000,2016,7,16,17,717,667,1384,1435
3405-000,2016,7,16,18,892,828,1720,1384
3405-000,2016,7,16,19,710,566,1276,1720
3405-000,2016,7,16,20,485,379,864,1276
3405-000,2016,7,16,21,362,335,697,864
3405-000,2016,7,16,22,287,277,564,697
3405-000,2016,7,16,23,214,186,400,564
3405-000,2016,7,16,24,111,140,251,400
3405-000,2016,7,17,1,92,88,180,251
3405-000,2016,7,17,2,36,46,82,180
3405-000,2016,7,17,3,44,36,80,82
3405-000,2016,7,17,4,40,43,83,80
3405-000,2016,7,17,5,70,53,123,83
3405-000,2016,7,17,6,136,93,229,123
3405-000,2016,7,17,7,226,190,416,229
3405-000,2016,7,17,8,351,285,636,416
3405-000,2016,7,17,9,428,331,759,636
3405-000,2016,7,17,10,459,311,770,759
3405-000,2016,7,17,11,562,419,981,770
3405-000,2016,7,17,12,542,432,974,981
3405-000,2016,7,17,13,510,508,1018,974
3405-000,2016,7,17,14,515,530,1045,1018
3405-000,2016,7,17,15,567,530,1097,1045
3405-000,2016,7,17,16,562,620,1182,1097
3405-000,2016,7,17,17,661,643,1304,1182
3405-000,2016,7,17,18,656,652,1308,1304
3405-000,2016,7,17,19,557,596,1153,1308
3405-000,2016,7,17,20,434,614,1048,1153
3405-000,2016,7,17,21,375,549,924,1048
3405-000,2016,7,17,22,286,404,690,924
3405-000,2016,7,17,23,227,284,511,690
3405-000,2016,7,17,24,119,189,308,511
3405-000,2016,7,18,1,80,91,171,308
3405-000,2016,7,18,2,49,66,115,171
3405-000,2016,7,18,3,39,34,73,115
3405-000,2016,7,18,4,53,82,135,73
3405-000,2016,7,18,5,104,98,202,135
3405-000,2016,7,18,6,315,297,612,202
3405-000,2016,7,18,7,679,691,1370,612
3405-000,2016,7,18,8,1175,1497,2672,1370
3405-000,2016,7,18,9,1246,1363,2609,2672
3405-000,2016,7,18,10,1041,859,1900,2609
3405-000,2016,7,18,11,1089,990,2079,1900
3405-000,2016,7,18,12,1059,929,1988,2079
3405-000,2016,7,18,13,862,833,1695,1988
3405-000,2016,7,18,14,983,991,1974,1695
3405-000,2016,7,18,15,1095,1057,2152,1974
3405-000,2016,7,18,16,1075,989,2064,2152
3405-000,2016,7,18,17,1092,924,2016,2064
3405-000,2016,7,18,18,1198,1043,2241,2016
3405-000,2016,7,18,19,1093,995,2088,2241
3405-000,2016,7,18,20,802,707,1509,2088
3405-000,2016,7,18,21,628,625,1253,1509
3405-000,2016,7,18,22,447,445,892,1253
3405-000,2016,7,18,23,260,256,516,892
3405-000,2016,7,18,24,161,191,352,516
3405-000,2016,7,19,1,108,101,209,352
3405-000,2016,7,19,2,72,66,138,209
3405-000,2016,7,19,3,60,55,115,138
3405-000,2016,7,19,4,78,88,166,115
3405-000,2016,7,19,5,105,108,213,166
3405-000,2016,7,19,6,275,232,507,213
3405-000,2016,7,19,7,554,546,1100,507
3405-000,2016,7,19,8,1100,1258,2358,1100
3405-000,2016,7,19,9,1259,1282,2541,2358
3405-000,2016,7,19,10,1134,1017,2151,2541
3405-000,2016,7,19,11,1101,983,2084,2151
3405-000,2016,7,19,12,1144,936,2080,2084
3405-000,2016,7,19,13,920,797,1717,2080
3405-000,2016,7,19,14,997,961,1958,1717
3405-000,2016,7,19,15,1158,994,2152,1958
3405-000,2016,7,19,16,1132,997,2129,2152
3405-000,2016,7,19,17,1193,971,2164,2129
3405-000,2016,7,19,18,1304,1016,2320,2164
3405-000,2016,7,19,19,1124,1021,2145,2320
3405-000,2016,7,19,20,798,694,1492,2145
3405-000,2016,7,19,21,630,610,1240,1492
3405-000,2016,7,19,22,418,467,885,1240
3405-000,2016,7,19,23,324,277,601,885
3405-000,2016,7,19,24,143,187,330,601
3405-000,2016,7,20,1,94,106,200,330
3405-000,2016,7,20,2,73,69,142,200
3405-000,2016,7,20,3,67,62,129,142
3405-000,2016,7,20,4,76,69,145,129
3405-000,2016,7,20,5,109,83,192,145
3405-000,2016,7,20,6,288,235,523,192
3405-000,2016,7,20,7,579,591,1170,523
3405-000,2016,7,20,8,1133,1239,2372,1170
3405-000,2016,7,20,9,1295,1282,2577,2372
3405-000,2016,7,20,10,1114,976,2090,2577
3405-000,2016,7,20,11,1159,995,2154,2090
3405-000,2016,7,20,12,1123,979,2102,2154
3405-000,2016,7,20,13,947,788,1735,2102
3405-000,2016,7,20,14,970,940,1910,1735
3405-000,2016,7,20,15,1144,1062,2206,1910
3405-000,2016,7,20,16,1181,1019,2200,2206
3405-000,2016,7,20,17,1114,918,2032,2200
3405-000,2016,7,20,18,1359,1119,2478,2032
3405-000,2016,7,20,19,1173,1084,2257,2478
3405-000,2016,7,20,20,791,688,1479,2257
3405-000,2016,7,20,21,543,572,1115,1479
3405-000,2016,7,20,22,468,375,843,1115
3405-000,2016,7,20,23,285,232,517,843
3405-000,2016,7,20,24,163,183,346,517
3405-000,2016,7,21,1,123,106,229,346
3405-000,2016,7,21,2,47,77,124,229
3405-000,2016,7,21,3,56,48,104,124
3405-000,2016,7,21,4,70,71,141,104
3405-000,2016,7,21,5,108,96,204,141
3405-000,2016,7,21,6,270,206,476,204
3405-000,2016,7,21,7,537,593,1130,476
3405-000,2016,7,21,8,1101,1288,2389,1130
3405-000,2016,7,21,9,1256,1315,2571,2389
3405-000,2016,7,21,10,1081,1004,2085,2571
3405-000,2016,7,21,11,1169,986,2155,2085
3405-000,2016,7,21,12,1129,992,2121,2155
3405-000,2016,7,21,13,916,876,1792,2121
3405-000,2016,7,21,14,1028,1024,2052,1792
3405-000,2016,7,21,15,1196,1076,2272,2052
3405-000,2016,7,21,16,1206,963,2169,2272
3405-000,2016,7,21,17,1106,1052,2158,2169
3405-000,2016,7,21,18,1248,1024,2272,2158
3405-000,2016,7,21,19,1082,1069,2151,2272
3405-000,2016,7,21,20,804,658,1462,2151
3405-000,2016,7,21,21,635,657,1292,1462
3405-000,2016,7,21,22,461,415,876,1292
3405-000,2016,7,21,23,304,300,604,876
3405-000,2016,7,21,24,163,182,345,604
3405-000,2016,7,22,1,101,102,203,345
3405-000,2016,7,22,2,69,75,144,203
3405-000,2016,7,22,3,62,54,116,144
3405-000,2016,7,22,4,61,79,140,116
3405-000,2016,7,22,5,127,101,228,140
3405-000,2016,7,22,6,264,237,501,228
3405-000,2016,7,22,7,570,537,1107,501
3405-000,2016,7,22,8,1137,1276,2413,1107
3405-000,2016,7,22,9,1268,1310,2578,2413
3405-000,2016,7,22,10,1137,978,2115,2578
3405-000,2016,7,22,11,1134,1018,2152,2115
3405-000,2016,7,22,12,1163,1014,2177,2152
3405-000,2016,7,22,13,941,862,1803,2177
3405-000,2016,7,22,14,1029,1035,2064,1803
3405-000,2016,7,22,15,1169,1016,2185,2064
3405-000,2016,7,22,16,1183,1083,2266,2185
3405-000,2016,7,22,17,1105,1182,2287,2266
3405-000,2016,7,22,18,1262,1259,2521,2287
3405-000,2016,7,22,19,1453,1246,2699,2521
3405-000,2016,7,22,20,1022,864,1886,2699
3405-000,2016,7,22,21,700,650,1350,1886
3405-000,2016,7,22,22,525,446,971,1350
3405-000,2016,7,22,23,330,279,609,971
3405-000,2016,7,22,24,200,205,405,609
3405-000,2016,7,23,1,127,124,251,405
3405-000,2016,7,23,2,87,64,151,251
3405-000,2016,7,23,3,61,84,145,151
3405-000,2016,7,23,4,70,80,150,145
3405-000,2016,7,23,5,108,107,215,150
3405-000,2016,7,23,6,279,200,479,215
3405-000,2016,7,23,7,518,393,911,479
3405-000,2016,7,23,8,740,643,1383,911
3405-000,2016,7,23,9,1001,837,1838,1383
3405-000,2016,7,23,10,1042,851,1893,1838
3405-000,2016,7,23,11,1091,912,2003,1893
3405-000,2016,7,23,12,969,911,1880,2003
3405-000,2016,7,23,13,848,883,1731,1880
3405-000,2016,7,23,14,998,879,1877,1731
3405-000,2016,7,23,15,898,737,1635,1877
3405-000,2016,7,23,16,852,792,1644,1635
3405-000,2016,7,23,17,947,836,1783,1644
3405-000,2016,7,23,18,987,939,1926,1783
3405-000,2016,7,23,19,917,684,1601,1926
3405-000,2016,7,23,20,549,531,1080,1601
3405-000,2016,7,23,21,411,377,788,1080
3405-000,2016,7,23,22,376,319,695,788
3405-000,2016,7,23,23,249,237,486,695
3405-000,2016,7,23,24,153,168,321,486
3405-000,2016,7,24,1,101,95,196,321
3405-000,2016,7,24,2,70,47,117,196
3405-000,2016,7,24,3,54,47,101,117
3405-000,2016,7,24,4,37,36,73,101
3405-000,2016,7,24,5,63,54,117,73
3405-000,2016,7,24,6,161,116,277,117
3405-000,2016,7,24,7,271,207,478,277
3405-000,2016,7,24,8,367,282,649,478
3405-000,2016,7,24,9,455,378,833,649
3405-000,2016,7,24,10,486,371,857,833
3405-000,2016,7,24,11,589,448,1037,857
3405-000,2016,7,24,12,629,415,1044,1037
3405-000,2016,7,24,13,587,507,1094,1044
3405-000,2016,7,24,14,643,480,1123,1094
3405-000,2016,7,24,15,652,529,1181,1123
3405-000,2016,7,24,16,672,585,1257,1181
3405-000,2016,7,24,17,721,625,1346,1257
3405-000,2016,7,24,18,735,685,1420,1346
3405-000,2016,7,24,19,634,577,1211,1420
3405-000,2016,7,24,20,468,622,1090,1211
3405-000,2016,7,24,21,385,526,911,1090
3405-000,2016,7,24,22,305,410,715,911
3405-000,2016,7,24,23,234,307,541,715
3405-000,2016,7,24,24,140,199,339,541
3405-000,2016,7,25,1,67,99,166,339
3405-000,2016,7,25,2,40,56,96,166
3405-000,2016,7,25,3,42,63,105,96
3405-000,2016,7,25,4,65,78,143,105
3405-000,2016,7,25,5,90,116,206,143
3405-000,2016,7,25,6,303,275,578,206
3405-000,2016,7,25,7,659,721,1380,578
3405-000,2016,7,25,8,1120,1548,2668,1380
3405-000,2016,7,25,9,1291,1301,2592,2668
3405-000,2016,7,25,10,1067,937,2004,2592
3405-000,2016,7,25,11,1143,1033,2176,2004
3405-000,2016,7,25,12,1148,933,2081,2176
3405-000,2016,7,25,13,957,844,1801,2081
3405-000,2016,7,25,14,993,922,1915,1801
3405-000,2016,7,25,15,1278,1076,2354,1915
3405-000,2016,7,25,16,1169,1020,2189,2354
3405-000,2016,7,25,17,1184,847,2031,2189
3405-000,2016,7,25,18,1569,974,2543,2031
3405-000,2016,7,25,19,1269,1029,2298,2543
3405-000,2016,7,25,20,824,728,1552,2298
3405-000,2016,7,25,21,683,636,1319,1552
3405-000,2016,7,25,22,447,428,875,1319
3405-000,2016,7,25,23,296,264,560,875
3405-000,2016,7,25,24,154,159,313,560
3405-000,2016,7,26,1,95,114,209,313
3405-000,2016,7,26,2,74,66,140,209
3405-000,2016,7,26,3,45,76,121,140
3405-000,2016,7,26,4,65,77,142,121
3405-000,2016,7,26,5,110,116,226,142
3405-000,2016,7,26,6,307,269,576,226
3405-000,2016,7,26,7,627,542,1169,576
3405-000,2016,7,26,8,1065,1249,2314,1169
3405-000,2016,7,26,9,1286,1215,2501,2314
3405-000,2016,7,26,10,1176,1025,2201,2501
3405-000,2016,7,26,11,1142,1059,2201,2201
3405-000,2016,7,26,12,1136,981,2117,2201
3405-000,2016,7,26,13,972,936,1908,2117
3405-000,2016,7,26,14,1008,1008,2016,1908
3405-000,2016,7,26,15,1141,1031,2172,2016
3405-000,2016,7,26,16,1316,1007,2323,2172
3405-000,2016,7,26,17,1231,1034,2265,2323
3405-000,2016,7,26,18,1176,1025,2201,2265
3405-000,2016,7,26,19,1134,1057,2191,2201
3405-000,2016,7,26,20,851,702,1553,2191
3405-000,2016,7,26,21,643,687,1330,1553
3405-000,2016,7,26,22,478,420,898,1330
3405-000,2016,7,26,23,330,275,605,898
3405-000,2016,7,26,24,156,169,325,605
3405-000,2016,7,27,1,101,106,207,325
3405-000,2016,7,27,2,66,77,143,207
3405-000,2016,7,27,3,63,69,132,143
3405-000,2016,7,27,4,55,76,131,132
3405-000,2016,7,27,5,107,104,211,131
3405-000,2016,7,27,6,284,226,510,211
3405-000,2016,7,27,7,611,534,1145,510
3405-000,2016,7,27,8,1095,1217,2312,1145
3405-000,2016,7,27,9,1331,1252,2583,2312
3405-000,2016,7,27,10,1108,1021,2129,2583
3405-000,2016,7,27,11,1173,978,2151,2129
3405-000,2016,7,27,12,1081,947,2028,2151
3405-000,2016,7,27,13,975,894,1869,2028
3405-000,2016,7,27,14,1012,972,1984,1869
3405-000,2016,7,27,15,1135,952,2087,1984
3405-000,2016,7,27,16,1185,1018,2203,2087
3405-000,2016,7,27,17,1093,973,2066,2203
3405-000,2016,7,27,18,1308,1047,2355,2066
3405-000,2016,7,27,19,1181,1009,2190,2355
3405-000,2016,7,27,20,850,654,1504,2190
3405-000,2016,7,27,21,599,525,1124,1504
3405-000,2016,7,27,22,415,380,795,1124
3405-000,2016,7,27,23,297,244,541,795
3405-000,2016,7,27,24,137,166,303,541
3405-000,2016,7,28,1,107,90,197,303
3405-000,2016,7,28,2,70,76,146,197
3405-000,2016,7,28,3,54,70,124,146
3405-000,2016,7,28,4,61,70,131,124
3405-000,2016,7,28,5,111,119,230,131
3405-000,2016,7,28,6,318,239,557,230
3405-000,2016,7,28,7,587,540,1127,557
3405-000,2016,7,28,8,1096,1207,2303,1127
3405-000,2016,7,28,9,1286,1248,2534,2303
3405-000,2016,7,28,10,1143,941,2084,2534
3405-000,2016,7,28,11,1139,995,2134,2084
3405-000,2016,7,28,12,1081,1029,2110,2134
3405-000,2016,7,28,13,947,913,1860,2110
3405-000,2016,7,28,14,988,956,1944,1860
3405-000,2016,7,28,15,1151,1058,2209,1944
3405-000,2016,7,28,16,1196,1019,2215,2209
3405-000,2016,7,28,17,1122,978,2100,2215
3405-000,2016,7,28,18,1261,1005,2266,2100
3405-000,2016,7,28,19,1163,995,2158,2266
3405-000,2016,7,28,20,885,705,1590,2158
3405-000,2016,7,28,21,642,656,1298,1590
3405-000,2016,7,28,22,457,412,869,1298
3405-000,2016,7,28,23,313,251,564,869
3405-000,2016,7,28,24,163,191,354,564
3405-000,2016,7,29,1,102,112,214,354
3405-000,2016,7,29,2,85,76,161,214
3405-000,2016,7,29,3,49,65,114,161
3405-000,2016,7,29,4,60,73,133,114
3405-000,2016,7,29,5,130,112,242,133
3405-000,2016,7,29,6,279,233,512,242
3405-000,2016,7,29,7,604,527,1131,512
3405-000,2016,7,29,8,1065,1187,2252,1131
3405-000,2016,7,29,9,1311,1205,2516,2252
3405-000,2016,7,29,10,1042,877,1919,2516
3405-000,2016,7,29,11,1058,972,2030,1919
3405-000,2016,7,29,12,1000,833,1833,2030
3405-000,2016,7,29,13,976,785,1761,1833
3405-000,2016,7,29,14,1033,871,1904,1761
3405-000,2016,7,29,15,1178,928,2106,1904
3405-000,2016,7,29,16,1231,976,2207,2106
3405-000,2016,7,29,17,1172,1015,2187,2207
3405-000,2016,7,29,18,1365,1120,2485,2187
3405-000,2016,7,29,19,1525,1120,2645,2485
3405-000,2016,7,29,20,1014,789,1803,2645
3405-000,2016,7,29,21,776,597,1373,1803
3405-000,2016,7,29,22,547,469,1016,1373
3405-000,2016,7,29,23,347,246,593,1016
3405-000,2016,7,29,24,208,175,383,593
3405-000,2016,7,30,1,150,136,286,383
3405-000,2016,7,30,2,85,85,170,286
3405-000,2016,7,30,3,74,54,128,170
3405-000,2016,7,30,4,79,75,154,128
3405-000,2016,7,30,5,138,96,234,154
3405-000,2016,7,30,6,328,159,487,234
3405-000,2016,7,30,7,543,341,884,487
3405-000,2016,7,30,8,788,580,1368,884
3405-000,2016,7,30,9,962,671,1633,1368
3405-000,2016,7,30,10,1174,636,1810,1633
3405-000,2016,7,30,11,1578,731,2309,1810
3405-000,2016,7,30,12,1246,768,2014,2309
3405-000,2016,7,30,13,1023,747,1770,2014
3405-000,2016,7,30,14,1062,773,1835,1770
3405-000,2016,7,30,15,938,780,1718,1835
3405-000,2016,7,30,16,797,739,1536,1718
3405-000,2016,7,30,17,781,710,1491,1536
3405-000,2016,7,30,18,879,754,1633,1491
3405-000,2016,7,30,19,796,672,1468,1633
3405-000,2016,7,30,20,537,446,983,1468
3405-000,2016,7,30,21,423,368,791,983
3405-000,2016,7,30,22,349,264,613,791
3405-000,2016,7,30,23,257,231,488,613
3405-000,2016,7,30,24,149,165,314,488
3405-000,2016,7,31,1,84,92,176,314
3405-000,2016,7,31,2,72,49,121,176
3405-000,2016,7,31,3,44,29,73,121
3405-000,2016,7,31,4,59,37,96,73
3405-000,2016,7,31,5,81,60,141,96
3405-000,2016,7,31,6,186,108,294,141
3405-000,2016,7,31,7,313,220,533,294
3405-000,2016,7,31,8,433,287,720,533
3405-000,2016,7,31,9,527,326,853,720
3405-000,2016,7,31,10,609,383,992,853
3405-000,2016,7,31,11,665,496,1161,992
3405-000,2016,7,31,12,601,509,1110,1161
3405-000,2016,7,31,13,587,493,1080,1110
3405-000,2016,7,31,14,630,513,1143,1080
3405-000,2016,7,31,15,590,502,1092,1143
3405-000,2016,7,31,16,715,582,1297,1092
3405-000,2016,7,31,17,708,567,1275,1297
3405-000,2016,7,31,18,786,642,1428,1275
3405-000,2016,7,31,19,587,617,1204,1428
3405-000,2016,7,31,20,466,522,988,1204
3405-000,2016,7,31,21,403,481,884,988
3405-000,2016,7,31,22,311,382,693,884
3405-000,2016,7,31,23,225,350,575,693
3405-000,2016,7,31,24,136,205,341,575
3405-000,2016,8,1,1,84,126,210,341
3405-000,2016,8,1,2,54,81,135,210
3405-000,2016,8,1,3,40,52,92,135
3405-000,2016,8,1,4,59,67,126,92
3405-000,2016,8,1,5,109,95,204,126
3405-000,2016,8,1,6,281,212,493,204
3405-000,2016,8,1,7,536,548,1084,493
3405-000,2016,8,1,8,930,1048,1978,1084
3405-000,2016,8,1,9,1039,1015,2054,1978
3405-000,2016,8,1,10,950,748,1698,2054
3405-000,2016,8,1,11,961,880,1841,1698
3405-000,2016,8,1,12,983,957,1940,1841
3405-000,2016,8,1,13,787,782,1569,1940
3405-000,2016,8,1,14,859,836,1695,1569
3405-000,2016,8,1,15,955,992,1947,1695
3405-000,2016,8,1,16,886,840,1726,1947
3405-000,2016,8,1,17,941,786,1727,1726
3405-000,2016,8,1,18,1014,858,1872,1727
3405-000,2016,8,1,19,916,876,1792,1872
3405-000,2016,8,1,20,660,598,1258,1792
3405-000,2016,8,1,21,495,501,996,1258
3405-000,2016,8,1,22,335,376,711,996
3405-000,2016,8,1,23,231,265,496,711
3405-000,2016,8,1,24,155,149,304,496
3405-000,2016,8,2,1,84,111,195,304
3405-000,2016,8,2,2,50,76,126,195
3405-000,2016,8,2,3,54,57,111,126
3405-000,2016,8,2,4,59,72,131,111
3405-000,2016,8,2,5,100,59,159,131
3405-000,2016,8,2,6,247,186,433,159
3405-000,2016,8,2,7,484,444,928,433
3405-000,2016,8,2,8,880,818,1698,928
3405-000,2016,8,2,9,1028,883,1911,1698
3405-000,2016,8,2,10,979,758,1737,1911
3405-000,2016,8,2,11,998,830,1828,1737
3405-000,2016,8,2,12,916,881,1797,1828
3405-000,2016,8,2,13,795,724,1519,1797
3405-000,2016,8,2,14,857,806,1663,1519
3405-000,2016,8,2,15,958,853,1811,1663
3405-000,2016,8,2,16,998,850,1848,1811
3405-000,2016,8,2,17,900,814,1714,1848
3405-000,2016,8,2,18,996,972,1968,1714
3405-000,2016,8,2,19,924,957,1881,1968
3405-000,2016,8,2,20,677,694,1371,1881
3405-000,2016,8,2,21,469,561,1030,1371
3405-000,2016,8,2,22,353,400,753,1030
3405-000,2016,8,2,23,257,266,523,753
3405-000,2016,8,2,24,134,172,306,523
3405-000,2016,8,3,1,84,102,186,306
3405-000,2016,8,3,2,50,65,115,186
3405-000,2016,8,3,3,46,46,92,115
3405-000,2016,8,3,4,71,72,143,92
3405-000,2016,8,3,5,116,86,202,143
3405-000,2016,8,3,6,268,184,452,202
3405-000,2016,8,3,7,503,447,950,452
3405-000,2016,8,3,8,822,812,1634,950
3405-000,2016,8,3,9,1039,915,1954,1634
3405-000,2016,8,3,10,962,728,1690,1954
3405-000,2016,8,3,11,993,830,1823,1690
3405-000,2016,8,3,12,930,785,1715,1823
3405-000,2016,8,3,13,807,692,1499,1715
3405-000,2016,8,3,14,825,839,1664,1499
3405-000,2016,8,3,15,959,844,1803,1664
3405-000,2016,8,3,16,923,858,1781,1803
3405-000,2016,8,3,17,1020,805,1825,1781
3405-000,2016,8,3,18,1046,905,1951,1825
3405-000,2016,8,3,19,973,999,1972,1951
3405-000,2016,8,3,20,661,580,1241,1972
3405-000,2016,8,3,21,458,472,930,1241
3405-000,2016,8,3,22,322,375,697,930
3405-000,2016,8,3,23,246,312,558,697
3405-000,2016,8,3,24,152,181,333,558
3405-000,2016,8,4,1,82,108,190,333
3405-000,2016,8,4,2,77,72,149,190
3405-000,2016,8,4,3,54,43,97,149
3405-000,2016,8,4,4,63,58,121,97
3405-000,2016,8,4,5,100,99,199,121
3405-000,2016,8,4,6,245,203,448,199
3405-000,2016,8,4,7,560,462,1022,448
3405-000,2016,8,4,8,932,967,1899,1022
3405-000,2016,8,4,9,1207,1032,2239,1899
3405-000,2016,8,4,10,1004,808,1812,2239
3405-000,2016,8,4,11,996,947,1943,1812
3405-000,2016,8,4,12,1028,801,1829,1943
3405-000,2016,8,4,13,821,754,1575,1829
3405-000,2016,8,4,14,899,922,1821,1575
3405-000,2016,8,4,15,956,902,1858,1821
3405-000,2016,8,4,16,942,893,1835,1858
3405-000,2016,8,4,17,978,837,1815,1835
3405-000,2016,8,4,18,1013,950,1963,1815
3405-000,2016,8,4,19,1015,977,1992,1963
3405-000,2016,8,4,20,657,660,1317,1992
3405-000,2016,8,4,21,551,488,1039,1317
3405-000,2016,8,4,22,368,372,740,1039
3405-000,2016,8,4,23,266,260,526,740
3405-000,2016,8,4,24,153,157,310,526
3405-000,2016,8,5,1,91,99,190,310
3405-000,2016,8,5,2,70,68,138,190
3405-000,2016,8,5,3,44,51,95,138
3405-000,2016,8,5,4,64,72,136,95
3405-000,2016,8,5,5,91,94,185,136
3405-000,2016,8,5,6,272,185,457,185
3405-000,2016,8,5,7,535,417,952,457
3405-000,2016,8,5,8,971,984,1955,952
3405-000,2016,8,5,9,1149,1038,2187,1955
3405-000,2016,8,5,10,968,824,1792,2187
3405-000,2016,8,5,11,1036,897,1933,1792
3405-000,2016,8,5,12,1003,863,1866,1933
3405-000,2016,8,5,13,865,818,1683,1866
3405-000,2016,8,5,14,972,835,1807,1683
3405-000,2016,8,5,15,1034,938,1972,1807
3405-000,2016,8,5,16,1046,861,1907,1972
3405-000,2016,8,5,17,1012,840,1852,1907
3405-000,2016,8,5,18,1190,1038,2228,1852
3405-000,2016,8,5,19,1270,1035,2305,2228
3405-000,2016,8,5,20,827,781,1608,2305
3405-000,2016,8,5,21,605,566,1171,1608
3405-000,2016,8,5,22,433,415,848,1171
3405-000,2016,8,5,23,274,314,588,848
3405-000,2016,8,5,24,173,203,376,588
3405-000,2016,8,6,1,106,101,207,376
3405-000,2016,8,6,2,73,68,141,207
3405-000,2016,8,6,3,51,45,96,141
3405-000,2016,8,6,4,72,57,129,96
3405-000,2016,8,6,5,90,79,169,129
3405-000,2016,8,6,6,242,171,413,169
3405-000,2016,8,6,7,458,341,799,413
3405-000,2016,8,6,8,722,588,1310,799
3405-000,2016,8,6,9,769,676,1445,1310
3405-000,2016,8,6,10,790,688,1478,1445
3405-000,2016,8,6,11,865,633,1498,1478
3405-000,2016,8,6,12,1003,687,1690,1498
3405-000,2016,8,6,13,802,689,1491,1690
3405-000,2016,8,6,14,767,623,1390,1491
3405-000,2016,8,6,15,749,674,1423,1390
3405-000,2016,8,6,16,753,697,1450,1423
3405-000,2016,8,6,17,801,680,1481,1450
3405-000,2016,8,6,18,900,758,1658,1481
3405-000,2016,8,6,19,762,706,1468,1658
3405-000,2016,8,6,20,521,535,1056,1468
3405-000,2016,8,6,21,418,432,850,1056
3405-000,2016,8,6,22,311,343,654,850
3405-000,2016,8,6,23,217,240,457,654
3405-000,2016,8,6,24,127,166,293,457
3405-000,2016,8,7,1,83,116,199,293
3405-000,2016,8,7,2,53,68,121,199
3405-000,2016,8,7,3,35,42,77,121
3405-000,2016,8,7,4,40,35,75,77
3405-000,2016,8,7,5,63,59,122,75
3405-000,2016,8,7,6,132,85,217,122
3405-000,2016,8,7,7,256,184,440,217
3405-000,2016,8,7,8,359,281,640,440
3405-000,2016,8,7,9,505,344,849,640
3405-000,2016,8,7,10,488,394,882,849
3405-000,2016,8,7,11,511,432,943,882
3405-000,2016,8,7,12,533,510,1043,943
3405-000,2016,8,7,13,526,496,1022,1043
3405-000,2016,8,7,14,507,551,1058,1022
3405-000,2016,8,7,15,580,582,1162,1058
3405-000,2016,8,7,16,581,634,1215,1162
3405-000,2016,8,7,17,614,556,1170,1215
3405-000,2016,8,7,18,603,609,1212,1170
3405-000,2016,8,7,19,519,559,1078,1212
3405-000,2016,8,7,20,424,571,995,1078
3405-000,2016,8,7,21,380,475,855,995
3405-000,2016,8,7,22,340,395,735,855
3405-000,2016,8,7,23,218,332,550,735
3405-000,2016,8,7,24,130,217,347,550
3405-000,2016,8,8,1,67,110,177,347
3405-000,2016,8,8,2,52,78,130,177
3405-000,2016,8,8,3,51,41,92,130
3405-000,2016,8,8,4,46,73,119,92
3405-000,2016,8,8,5,115,120,235,119
3405-000,2016,8,8,6,283,255,538,235
3405-000,2016,8,8,7,660,685,1345,538
3405-000,2016,8,8,8,1101,1476,2577,1345
3405-000,2016,8,8,9,1255,1278,2533,2577
3405-000,2016,8,8,10,997,930,1927,2533
3405-000,2016,8,8,11,1132,928,2060,1927
3405-000,2016,8,8,12,1044,975,2019,2060
3405-000,2016,8,8,13,982,879,1861,2019
3405-000,2016,8,8,14,922,1048,1970,1861
3405-000,2016,8,8,15,1102,1040,2142,1970
3405-000,2016,8,8,16,1128,1133,2261,2142
3405-000,2016,8,8,17,1051,1258,2309,2261
3405-000,2016,8,8,18,1311,1430,2741,2309
3405-000,2016,8,8,19,1278,1375,2653,2741
3405-000,2016,8,8,20,793,895,1688,2653
3405-000,2016,8,8,21,630,608,1238,1688
3405-000,2016,8,8,22,439,498,937,1238
3405-000,2016,8,8,23,274,505,779,937
3405-000,2016,8,8,24,166,261,427,779
3405-000,2016,8,9,1,87,112,199,427
3405-000,2016,8,9,2,79,56,135,199
3405-000,2016,8,9,3,57,72,129,135
3405-000,2016,8,9,4,68,88,156,129
3405-000,2016,8,9,5,103,111,214,156
3405-000,2016,8,9,6,281,224,505,214
3405-000,2016,8,9,7,576,526,1102,505
3405-000,2016,8,9,8,1102,1278,2380,1102
3405-000,2016,8,9,9,1391,1271,2662,2380
3405-000,2016,8,9,10,1188,980,2168,2662
3405-000,2016,8,9,11,1171,1032,2203,2168
3405-000,2016,8,9,12,1147,1016,2163,2203
3405-000,2016,8,9,13,916,894,1810,2163
3405-000,2016,8,9,14,1011,1039,2050,1810
3405-000,2016,8,9,15,1200,1083,2283,2050
3405-000,2016,8,9,16,1151,960,2111,2283
3405-000,2016,8,9,17,1136,960,2096,2111
3405-000,2016,8,9,18,1222,1036,2258,2096
3405-000,2016,8,9,19,1104,1036,2140,2258
3405-000,2016,8,9,20,786,747,1533,2140
3405-000,2016,8,9,21,677,661,1338,1533
3405-000,2016,8,9,22,423,635,1058,1338
3405-000,2016,8,9,23,309,484,793,1058
3405-000,2016,8,9,24,252,223,475,793
3405-000,2016,8,10,1,123,118,241,475
3405-000,2016,8,10,2,67,74,141,241
3405-000,2016,8,10,3,74,66,140,141
3405-000,2016,8,10,4,70,96,166,140
3405-000,2016,8,10,5,114,96,210,166
3405-000,2016,8,10,6,258,211,469,210
3405-000,2016,8,10,7,585,489,1074,469
3405-000,2016,8,10,8,1071,1147,2218,1074
3405-000,2016,8,10,9,1484,1172,2656,2218
3405-000,2016,8,10,10,1336,931,2267,2656
3405-000,2016,8,10,11,1299,1020,2319,2267
3405-000,2016,8,10,12,1084,900,1984,2319
3405-000,2016,8,10,13,950,998,1948,1984
3405-000,2016,8,10,14,998,1206,2204,1948
3405-000,2016,8,10,15,1125,1053,2178,2204
3405-000,2016,8,10,16,1170,1017,2187,2178
3405-000,2016,8,10,17,1193,978,2171,2187
3405-000,2016,8,10,18,1229,1004,2233,2171
3405-000,2016,8,10,19,1204,1106,2310,2233
3405-000,2016,8,10,20,816,726,1542,2310
3405-000,2016,8,10,21,627,535,1162,1542
3405-000,2016,8,10,22,410,367,777,1162
3405-000,2016,8,10,23,302,274,576,777
3405-000,2016,8,10,24,172,190,362,576
3405-000,2016,8,11,1,109,138,247,362
3405-000,2016,8,11,2,82,82,164,247
3405-000,2016,8,11,3,51,74,125,164
3405-000,2016,8,11,4,70,67,137,125
3405-000,2016,8,11,5,103,99,202,137
3405-000,2016,8,11,6,244,242,486,202
3405-000,2016,8,11,7,610,483,1093,486
3405-000,2016,8,11,8,1060,1251,2311,1093
3405-000,2016,8,11,9,1347,1278,2625,2311
3405-000,2016,8,11,10,1116,981,2097,2625
3405-000,2016,8,11,11,1088,1110,2198,2097
3405-000,2016,8,11,12,1143,1009,2152,2198
3405-000,2016,8,11,13,1054,988,2042,2152
3405-000,2016,8,11,14,1084,907,1991,2042
3405-000,2016,8,11,15,1144,1014,2158,1991
3405-000,2016,8,11,16,1181,953,2134,2158
3405-000,2016,8,11,17,1146,1128,2274,2134
3405-000,2016,8,11,18,1241,1030,2271,2274
3405-000,2016,8,11,19,1265,1008,2273,2271
3405-000,2016,8,11,20,841,751,1592,2273
3405-000,2016,8,11,21,671,577,1248,1592
3405-000,2016,8,11,22,445,395,840,1248
3405-000,2016,8,11,23,302,299,601,840
3405-000,2016,8,11,24,166,215,381,601
3405-000,2016,8,12,1,90,142,232,381
3405-000,2016,8,12,2,63,92,155,232
3405-000,2016,8,12,3,61,61,122,155
3405-000,2016,8,12,4,77,76,153,122
3405-000,2016,8,12,5,117,98,215,153
3405-000,2016,8,12,6,263,211,474,215
3405-000,2016,8,12,7,587,510,1097,474
3405-000,2016,8,12,8,1049,1203,2252,1097
3405-000,2016,8,12,9,1374,1264,2638,2252
3405-000,2016,8,12,10,1143,966,2109,2638
3405-000,2016,8,12,11,1154,1094,2248,2109
3405-000,2016,8,12,12,1158,955,2113,2248
3405-000,2016,8,12,13,976,860,1836,2113
3405-000,2016,8,12,14,1037,996,2033,1836
3405-000,2016,8,12,15,1212,1073,2285,2033
3405-000,2016,8,12,16,1294,1021,2315,2285
3405-000,2016,8,12,17,1269,1026,2295,2315
3405-000,2016,8,12,18,1440,1132,2572,2295
3405-000,2016,8,12,19,1687,1171,2858,2572
3405-000,2016,8,12,20,1136,928,2064,2858
3405-000,2016,8,12,21,848,714,1562,2064
3405-000,2016,8,12,22,597,453,1050,1562
3405-000,2016,8,12,23,388,307,695,1050
3405-000,2016,8,12,24,208,228,436,695
3405-000,2016,8,13,1,134,153,287,436
3405-000,2016,8,13,2,102,94,196,287
3405-000,2016,8,13,3,74,67,141,196
3405-000,2016,8,13,4,84,84,168,141
3405-000,2016,8,13,5,132,99,231,168
3405-000,2016,8,13,6,283,201,484,231
3405-000,2016,8,13,7,595,382,977,484
3405-000,2016,8,13,8,805,650,1455,977
3405-000,2016,8,13,9,1018,803,1821,1455
3405-000,2016,8,13,10,957,899,1856,1821
3405-000,2016,8,13,11,1076,922,1998,1856
3405-000,2016,8,13,12,1086,907,1993,1998
3405-000,2016,8,13,13,936,894,1830,1993
3405-000,2016,8,13,14,989,868,1857,1830
3405-000,2016,8,13,15,967,857,1824,1857
3405-000,2016,8,13,16,829,882,1711,1824
3405-000,2016,8,13,17,794,791,1585,1711
3405-000,2016,8,13,18,932,916,1848,1585
3405-000,2016,8,13,19,851,764,1615,1848
3405-000,2016,8,13,20,565,591,1156,1615
3405-000,2016,8,13,21,449,420,869,1156
3405-000,2016,8,13,22,386,335,721,869
3405-000,2016,8,13,23,213,241,454,721
3405-000,2016,8,13,24,150,182,332,454
3405-000,2016,8,14,1,91,119,210,332
3405-000,2016,8,14,2,49,59,108,210
3405-000,2016,8,14,3,44,47,91,108
3405-000,2016,8,14,4,41,32,73,91
3405-000,2016,8,14,5,73,44,117,73
3405-000,2016,8,14,6,161,97,258,117
3405-000,2016,8,14,7,250,178,428,258
3405-000,2016,8,14,8,345,254,599,428
3405-000,2016,8,14,9,461,353,814,599
3405-000,2016,8,14,10,546,396,942,814
3405-000,2016,8,14,11,580,453,1033,942
3405-000,2016,8,14,12,568,452,1020,1033
3405-000,2016,8,14,13,582,512,1094,1020
3405-000,2016,8,14,14,548,506,1054,1094
3405-000,2016,8,14,15,565,540,1105,1054
3405-000,2016,8,14,16,572,570,1142,1105
3405-000,2016,8,14,17,597,645,1242,1142
3405-000,2016,8,14,18,639,601,1240,1242
3405-000,2016,8,14,19,578,544,1122,1240
3405-000,2016,8,14,20,462,544,1006,1122
3405-000,2016,8,14,21,394,442,836,1006
3405-000,2016,8,14,22,278,419,697,836
3405-000,2016,8,14,23,225,273,498,697
3405-000,2016,8,14,24,141,216,357,498
3405-000,2016,8,15,1,82,135,217,357
3405-000,2016,8,15,2,67,90,157,217
3405-000,2016,8,15,3,41,66,107,157
3405-000,2016,8,15,4,51,67,118,107
3405-000,2016,8,15,5,80,66,146,118
3405-000,2016,8,15,6,206,163,369,146
3405-000,2016,8,15,7,420,359,779,369
3405-000,2016,8,15,8,600,496,1096,779
3405-000,2016,8,15,9,709,564,1273,1096
3405-000,2016,8,15,10,633,519,1152,1273
3405-000,2016,8,15,11,728,672,1400,1152
3405-000,2016,8,15,12,914,604,1518,1400
3405-000,2016,8,15,13,921,568,1489,1518
3405-000,2016,8,15,14,672,670,1342,1489
3405-000,2016,8,15,15,773,681,1454,1342
3405-000,2016,8,15,16,830,721,1551,1454
3405-000,2016,8,15,17,782,644,1426,1551
3405-000,2016,8,15,18,901,772,1673,1426
3405-000,2016,8,15,19,750,687,1437,1673
3405-000,2016,8,15,20,572,585,1157,1437
3405-000,2016,8,15,21,461,512,973,1157
3405-000,2016,8,15,22,285,391,676,973
3405-000,2016,8,15,23,242,326,568,676
3405-000,2016,8,15,24,130,223,353,568
3405-000,2016,8,16,1,89,129,218,353
3405-000,2016,8,16,2,51,88,139,218
3405-000,2016,8,16,3,35,55,90,139
3405-000,2016,8,16,4,60,80,140,90
3405-000,2016,8,16,5,85,98,183,140
3405-000,2016,8,16,6,266,219,485,183
3405-000,2016,8,16,7,594,638,1232,485
3405-000,2016,8,16,8,1078,1502,2580,1232
3405-000,2016,8,16,9,1336,1313,2649,2580
3405-000,2016,8,16,10,1032,952,1984,2649
3405-000,2016,8,16,11,1119,1028,2147,1984
3405-000,2016,8,16,12,1039,956,1995,2147
3405-000,2016,8,16,13,912,928,1840,1995
3405-000,2016,8,16,14,964,984,1948,1840
3405-000,2016,8,16,15,1110,954,2064,1948
3405-000,2016,8,16,16,1159,999,2158,2064
3405-000,2016,8,16,17,1093,992,2085,2158
3405-000,2016,8,16,18,1211,1090,2301,2085
3405-000,2016,8,16,19,1106,980,2086,2301
3405-000,2016,8,16,20,791,737,1528,2086
3405-000,2016,8,16,21,684,606,1290,1528
3405-000,2016,8,16,22,454,462,916,1290
3405-000,2016,8,16,23,298,242,540,916
3405-000,2016,8,16,24,161,198,359,540
3405-000,2016,8,17,1,118,110,228,359
3405-000,2016,8,17,2,65,85,150,228
3405-000,2016,8,17,3,62,58,120,150
3405-000,2016,8,17,4,96,89,185,120
3405-000,2016,8,17,5,103,112,215,185
3405-000,2016,8,17,6,265,232,497,215
3405-000,2016,8,17,7,612,535,1147,497
3405-000,2016,8,17,8,1033,1282,2315,1147
3405-000,2016,8,17,9,1344,1271,2615,2315
3405-000,2016,8,17,10,1120,994,2114,2615
3405-000,2016,8,17,11,1158,957,2115,2114
3405-000,2016,8,17,12,1125,1077,2202,2115
3405-000,2016,8,17,13,963,881,1844,2202
3405-000,2016,8,17,14,985,983,1968,1844
3405-000,2016,8,17,15,1189,1055,2244,1968
3405-000,2016,8,17,16,1088,1017,2105,2244
3405-000,2016,8,17,17,1099,932,2031,2105
3405-000,2016,8,17,18,1363,979,2342,2031
3405-000,2016,8,17,19,1290,989,2279,2342
3405-000,2016,8,17,20,845,725,1570,2279
3405-000,2016,8,17,21,606,551,1157,1570
3405-000,2016,8,17,22,414,414,828,1157
3405-000,2016,8,17,23,269,250,519,828
3405-000,2016,8,17,24,153,195,348,519
3405-000,2016,8,18,1,93,127,220,348
3405-000,2016,8,18,2,64,78,142,220
3405-000,2016,8,18,3,65,67,132,142
3405-000,2016,8,18,4,77,82,159,132
3405-000,2016,8,18,5,88,104,192,159
3405-000,2016,8,18,6,266,231,497,192
3405-000,2016,8,18,7,589,557,1146,497
3405-000,2016,8,18,8,1097,1258,2355,1146
3405-000,2016,8,18,9,1333,1255,2588,2355
3405-000,2016,8,18,10,1174,995,2169,2588
3405-000,2016,8,18,11,1142,993,2135,2169
3405-000,2016,8,18,12,1134,977,2111,2135
3405-000,2016,8,18,13,936,888,1824,2111
3405-000,2016,8,18,14,1064,974,2038,1824
3405-000,2016,8,18,15,1126,1041,2167,2038
3405-000,2016,8,18,16,1187,1048,2235,2167
3405-000,2016,8,18,17,1145,995,2140,2235
3405-000,2016,8,18,18,1222,1042,2264,2140
3405-000,2016,8,18,19,1171,997,2168,2264
3405-000,2016,8,18,20,797,726,1523,2168
3405-000,2016,8,18,21,686,615,1301,1523
3405-000,2016,8,18,22,429,418,847,1301
3405-000,2016,8,18,23,261,287,548,847
3405-000,2016,8,18,24,155,192,347,548
3405-000,2016,8,19,1,90,139,229,347
3405-000,2016,8,19,2,75,83,158,229
3405-000,2016,8,19,3,49,69,118,158
3405-000,2016,8,19,4,70,76,146,118
3405-000,2016,8,19,5,103,124,227,146
3405-000,2016,8,19,6,274,211,485,227
3405-000,2016,8,19,7,578,482,1060,485
3405-000,2016,8,19,8,1043,1255,2298,1060
3405-000,2016,8,19,9,1326,1349,2675,2298
3405-000,2016,8,19,10,1132,1043,2175,2675
3405-000,2016,8,19,11,1175,1035,2210,2175
3405-000,2016,8,19,12,1244,1024,2268,2210
3405-000,2016,8,19,13,1007,895,1902,2268
3405-000,2016,8,19,14,1054,1008,2062,1902
3405-000,2016,8,19,15,1189,1079,2268,2062
3405-000,2016,8,19,16,1273,1021,2294,2268
3405-000,2016,8,19,17,1224,960,2184,2294
3405-000,2016,8,19,18,1438,1056,2494,2184
3405-000,2016,8,19,19,1453,1095,2548,2494
3405-000,2016,8,19,20,990,875,1865,2548
3405-000,2016,8,19,21,784,644,1428,1865
3405-000,2016,8,19,22,483,438,921,1428
3405-000,2016,8,19,23,324,292,616,921
3405-000,2016,8,19,24,178,199,377,616
3405-000,2016,8,20,1,128,133,261,377
3405-000,2016,8,20,2,83,96,179,261
3405-000,2016,8,20,3,58,71,129,179
3405-000,2016,8,20,4,76,73,149,129
3405-000,2016,8,20,5,110,91,201,149
3405-000,2016,8,20,6,271,183,454,201
3405-000,2016,8,20,7,517,368,885,454
3405-000,2016,8,20,8,792,649,1441,885
3405-000,2016,8,20,9,1002,757,1759,1441
3405-000,2016,8,20,10,899,766,1665,1759
3405-000,2016,8,20,11,1014,736,1750,1665
3405-000,2016,8,20,12,965,832,1797,1750
3405-000,2016,8,20,13,761,898,1659,1797
3405-000,2016,8,20,14,793,694,1487,1659
3405-000,2016,8,20,15,808,711,1519,1487
3405-000,2016,8,20,16,844,708,1552,1519
3405-000,2016,8,20,17,906,636,1542,1552
3405-000,2016,8,20,18,1008,818,1826,1542
3405-000,2016,8,20,19,894,773,1667,1826
3405-000,2016,8,20,20,583,524,1107,1667
3405-000,2016,8,20,21,431,414,845,1107
3405-000,2016,8,20,22,351,282,633,845
3405-000,2016,8,20,23,230,269,499,633
3405-000,2016,8,20,24,137,159,296,499
3405-000,2016,8,21,1,93,97,190,296
3405-000,2016,8,21,2,45,67,112,190
3405-000,2016,8,21,3,52,34,86,112
3405-000,2016,8,21,4,42,32,74,86
3405-000,2016,8,21,5,66,52,118,74
3405-000,2016,8,21,6,172,91,263,118
3405-000,2016,8,21,7,282,202,484,263
3405-000,2016,8,21,8,387,275,662,484
3405-000,2016,8,21,9,470,379,849,662
3405-000,2016,8,21,10,480,350,830,849
3405-000,2016,8,21,11,529,432,961,830
3405-000,2016,8,21,12,611,469,1080,961
3405-000,2016,8,21,13,551,519,1070,1080
3405-000,2016,8,21,14,530,540,1070,1070
3405-000,2016,8,21,15,626,597,1223,1070
3405-000,2016,8,21,16,715,666,1381,1223
3405-000,2016,8,21,17,692,623,1315,1381
3405-000,2016,8,21,18,693,675,1368,1315
3405-000,2016,8,21,19,566,579,1145,1368
3405-000,2016,8,21,20,433,527,960,1145
3405-000,2016,8,21,21,395,459,854,960
3405-000,2016,8,21,22,309,416,725,854
3405-000,2016,8,21,23,208,313,521,725
3405-000,2016,8,21,24,139,216,355,521
3405-000,2016,8,22,1,97,119,216,355
3405-000,2016,8,22,2,61,70,131,216
3405-000,2016,8,22,3,42,51,93,131
3405-000,2016,8,22,4,50,70,120,93
3405-000,2016,8,22,5,95,84,179,120
3405-000,2016,8,22,6,321,256,577,179
3405-000,2016,8,22,7,662,707,1369,577
3405-000,2016,8,22,8,1168,1582,2750,1369
3405-000,2016,8,22,9,1287,1370,2657,2750
3405-000,2016,8,22,10,1052,956,2008,2657
3405-000,2016,8,22,11,1134,1085,2219,2008
3405-000,2016,8,22,12,1069,928,1997,2219
3405-000,2016,8,22,13,900,903,1803,1997
3405-000,2016,8,22,14,983,1007,1990,1803
3405-000,2016,8,22,15,1128,1029,2157,1990
3405-000,2016,8,22,16,1171,1023,2194,2157
3405-000,2016,8,22,17,1118,916,2034,2194
3405-000,2016,8,22,18,1224,1020,2244,2034
3405-000,2016,8,22,19,1138,999,2137,2244
3405-000,2016,8,22,20,817,709,1526,2137
3405-000,2016,8,22,21,685,580,1265,1526
3405-000,2016,8,22,22,447,473,920,1265
3405-000,2016,8,22,23,261,248,509,920
3405-000,2016,8,22,24,160,186,346,509
3405-000,2016,8,23,1,91,99,190,346
3405-000,2016,8,23,2,75,71,146,190
3405-000,2016,8,23,3,60,72,132,146
3405-000,2016,8,23,4,79,71,150,132
3405-000,2016,8,23,5,110,107,217,150
3405-000,2016,8,23,6,289,233,522,217
3405-000,2016,8,23,7,597,554,1151,522
3405-000,2016,8,23,8,1124,1321,2445,1151
3405-000,2016,8,23,9,1348,1277,2625,2445
3405-000,2016,8,23,10,1151,980,2131,2625
3405-000,2016,8,23,11,1121,1087,2208,2131
3405-000,2016,8,23,12,1127,1030,2157,2208
3405-000,2016,8,23,13,1014,921,1935,2157
3405-000,2016,8,23,14,1009,1032,2041,1935
3405-000,2016,8,23,15,1173,1035,2208,2041
3405-000,2016,8,23,16,1198,992,2190,2208
3405-000,2016,8,23,17,1268,1071,2339,2190
3405-000,2016,8,23,18,1257,1047,2304,2339
3405-000,2016,8,23,19,1158,1054,2212,2304
3405-000,2016,8,23,20,841,751,1592,2212
3405-000,2016,8,23,21,685,585,1270,1592
3405-000,2016,8,23,22,453,441,894,1270
3405-000,2016,8,23,23,299,243,542,894
3405-000,2016,8,23,24,155,223,378,542
3405-000,2016,8,24,1,117,110,227,378
3405-000,2016,8,24,2,49,96,145,227
3405-000,2016,8,24,3,41,62,103,145
3405-000,2016,8,24,4,79,79,158,103
3405-000,2016,8,24,5,94,99,193,158
3405-000,2016,8,24,6,278,220,498,193
3405-000,2016,8,24,7,587,536,1123,498
3405-000,2016,8,24,8,1106,1306,2412,1123
3405-000,2016,8,24,9,1435,1320,2755,2412
3405-000,2016,8,24,10,1072,948,2020,2755
3405-000,2016,8,24,11,1159,1084,2243,2020
3405-000,2016,8,24,12,1184,1029,2213,2243
3405-000,2016,8,24,13,985,857,1842,2213
3405-000,2016,8,24,14,1048,959,2007,1842
3405-000,2016,8,24,15,1186,1123,2309,2007
3405-000,2016,8,24,16,1237,1050,2287,2309
3405-000,2016,8,24,17,1198,986,2184,2287
3405-000,2016,8,24,18,1230,1148,2378,2184
3405-000,2016,8,24,19,1225,1052,2277,2378
3405-000,2016,8,24,20,780,767,1547,2277
3405-000,2016,8,24,21,601,598,1199,1547
3405-000,2016,8,24,22,456,398,854,1199
3405-000,2016,8,24,23,273,257,530,854
3405-000,2016,8,24,24,157,173,330,530
3405-000,2016,8,25,1,113,115,228,330
3405-000,2016,8,25,2,64,93,157,228
3405-000,2016,8,25,3,51,68,119,157
3405-000,2016,8,25,4,61,73,134,119
3405-000,2016,8,25,5,115,107,222,134
3405-000,2016,8,25,6,266,216,482,222
3405-000,2016,8,25,7,581,540,1121,482
3405-000,2016,8,25,8,1126,1298,2424,1121
3405-000,2016,8,25,9,1397,1328,2725,2424
3405-000,2016,8,25,10,1165,1055,2220,2725
3405-000,2016,8,25,11,1096,984,2080,2220
3405-000,2016,8,25,12,1199,1042,2241,2080
3405-000,2016,8,25,13,1000,871,1871,2241
3405-000,2016,8,25,14,1014,901,1915,1871
3405-000,2016,8,25,15,1162,1086,2248,1915
3405-000,2016,8,25,16,1157,1047,2204,2248
3405-000,2016,8,25,17,1125,1055,2180,2204
3405-000,2016,8,25,18,1272,998,2270,2180
3405-000,2016,8,25,19,1169,1077,2246,2270
3405-000,2016,8,25,20,884,729,1613,2246
3405-000,2016,8,25,21,644,609,1253,1613
3405-000,2016,8,25,22,427,411,838,1253
3405-000,2016,8,25,23,296,272,568,838
3405-000,2016,8,25,24,177,206,383,568
3405-000,2016,8,26,1,104,96,200,383
3405-000,2016,8,26,2,85,103,188,200
3405-000,2016,8,26,3,68,73,141,188
3405-000,2016,8,26,4,55,90,145,141
3405-000,2016,8,26,5,114,101,215,145
3405-000,2016,8,26,6,294,204,498,215
3405-000,2016,8,26,7,518,473,991,498
3405-000,2016,8,26,8,1026,1143,2169,991
3405-000,2016,8,26,9,1353,1260,2613,2169
3405-000,2016,8,26,10,1186,951,2137,2613
3405-000,2016,8,26,11,1128,1041,2169,2137
3405-000,2016,8,26,12,1152,952,2104,2169
3405-000,2016,8,26,13,1039,889,1928,2104
3405-000,2016,8,26,14,989,1024,2013,1928
3405-000,2016,8,26,15,1216,1031,2247,2013
3405-000,2016,8,26,16,1168,1063,2231,2247
3405-000,2016,8,26,17,1301,1018,2319,2231
3405-000,2016,8,26,18,1462,1072,2534,2319
3405-000,2016,8,26,19,1511,1176,2687,2534
3405-000,2016,8,26,20,1024,815,1839,2687
3405-000,2016,8,26,21,750,622,1372,1839
3405-000,2016,8,26,22,546,421,967,1372
3405-000,2016,8,26,23,307,281,588,967
3405-000,2016,8,26,24,202,206,408,588
3405-000,2016,8,27,1,129,117,246,408
3405-000,2016,8,27,2,77,98,175,246
3405-000,2016,8,27,3,71,65,136,175
3405-000,2016,8,27,4,57,95,152,136
3405-000,2016,8,27,5,110,83,193,152
3405-000,2016,8,27,6,308,198,506,193
3405-000,2016,8,27,7,548,384,932,506
3405-000,2016,8,27,8,860,658,1518,932
3405-000,2016,8,27,9,1031,699,1730,1518
3405-000,2016,8,27,10,1034,765,1799,1730
3405-000,2016,8,27,11,1067,777,1844,1799
3405-000,2016,8,27,12,1043,770,1813,1844
3405-000,2016,8,27,13,978,734,1712,1813
3405-000,2016,8,27,14,873,834,1707,1712
3405-000,2016,8,27,15,995,1020,2015,1707
3405-000,2016,8,27,16,1113,963,2076,2015
3405-000,2016,8,27,17,980,876,1856,2076
3405-000,2016,8,27,18,1197,918,2115,1856
3405-000,2016,8,27,19,1080,779,1859,2115
3405-000,2016,8,27,20,645,614,1259,1859
3405-000,2016,8,27,21,490,458,948,1259
3405-000,2016,8,27,22,359,376,735,948
3405-000,2016,8,27,23,241,221,462,735
3405-000,2016,8,27,24,119,164,283,462
3405-000,2016,8,28,1,95,91,186,283
3405-000,2016,8,28,2,42,48,90,186
3405-000,2016,8,28,3,42,42,84,90
3405-000,2016,8,28,4,43,44,87,84
3405-000,2016,8,28,5,82,46,128,87
3405-000,2016,8,28,6,198,120,318,128
3405-000,2016,8,28,7,383,194,577,318
3405-000,2016,8,28,8,512,382,894,577
3405-000,2016,8,28,9,520,373,893,894
3405-000,2016,8,28,10,500,404,904,893
3405-000,2016,8,28,11,659,481,1140,904
3405-000,2016,8,28,12,731,494,1225,1140
3405-000,2016,8,28,13,638,538,1176,1225
3405-000,2016,8,28,14,641,582,1223,1176
3405-000,2016,8,28,15,806,673,1479,1223
3405-000,2016,8,28,16,973,736,1709,1479
3405-000,2016,8,28,17,1072,710,1782,1709
3405-000,2016,8,28,18,1018,759,1777,1782
3405-000,2016,8,28,19,1158,678,1836,1777
3405-000,2016,8,28,20,832,636,1468,1836
3405-000,2016,8,28,21,953,544,1497,1468
3405-000,2016,8,28,22,599,450,1049,1497
3405-000,2016,8,28,23,317,383,700,1049
3405-000,2016,8,28,24,147,267,414,700
3405-000,2016,8,29,1,71,122,193,414
3405-000,2016,8,29,2,46,74,120,193
3405-000,2016,8,29,3,37,51,88,120
3405-000,2016,8,29,4,47,77,124,88
3405-000,2016,8,29,5,125,116,241,124
3405-000,2016,8,29,6,332,269,601,241
3405-000,2016,8,29,7,686,752,1438,601
3405-000,2016,8,29,8,1220,1526,2746,1438
3405-000,2016,8,29,9,1365,1432,2797,2746
3405-000,2016,8,29,10,1063,1008,2071,2797
3405-000,2016,8,29,11,1113,1049,2162,2071
3405-000,2016,8,29,12,1172,1016,2188,2162
3405-000,2016,8,29,13,979,914,1893,2188
3405-000,2016,8,29,14,1077,1017,2094,1893
3405-000,2016,8,29,15,1216,1165,2381,2094
3405-000,2016,8,29,16,1140,1059,2199,2381
3405-000,2016,8,29,17,1206,1045,2251,2199
3405-000,2016,8,29,18,1233,1067,2300,2251
3405-000,2016,8,29,19,1222,1141,2363,2300
3405-000,2016,8,29,20,863,733,1596,2363
3405-000,2016,8,29,21,625,578,1203,1596
3405-000,2016,8,29,22,403,426,829,1203
3405-000,2016,8,29,23,270,248,518,829
3405-000,2016,8,29,24,145,188,333,518
3405-000,2016,8,30,1,88,125,213,333
3405-000,2016,8,30,2,78,80,158,213
3405-000,2016,8,30,3,61,81,142,158
3405-000,2016,8,30,4,73,94,167,142
3405-000,2016,8,30,5,113,110,223,167
3405-000,2016,8,30,6,288,248,536,223
3405-000,2016,8,30,7,658,582,1240,536
3405-000,2016,8,30,8,1163,1356,2519,1240
3405-000,2016,8,30,9,1350,1268,2618,2519
3405-000,2016,8,30,10,1135,974,2109,2618
3405-000,2016,8,30,11,1215,1081,2296,2109
3405-000,2016,8,30,12,1034,993,2027,2296
3405-000,2016,8,30,13,993,905,1898,2027
3405-000,2016,8,30,14,1035,1016,2051,1898
3405-000,2016,8,30,15,1298,1069,2367,2051
3405-000,2016,8,30,16,1189,1036,2225,2367
3405-000,2016,8,30,17,1243,1030,2273,2225
3405-000,2016,8,30,18,1176,1058,2234,2273
3405-000,2016,8,30,19,1139,1065,2204,2234
3405-000,2016,8,30,20,809,660,1469,2204
3405-000,2016,8,30,21,609,613,1222,1469
3405-000,2016,8,30,22,428,435,863,1222
3405-000,2016,8,30,23,277,247,524,863
3405-000,2016,8,30,24,142,159,301,524
3405-000,2016,8,31,1,94,97,191,301
3405-000,2016,8,31,2,52,60,112,191
3405-000,2016,8,31,3,59,82,141,112
3405-000,2016,8,31,4,59,66,125,141
3405-000,2016,8,31,5,107,96,203,125
3405-000,2016,8,31,6,264,167,431,203
3405-000,2016,8,31,7,508,477,985,431
3405-000,2016,8,31,8,1073,1206,2279,985
3405-000,2016,8,31,9,1239,1229,2468,2279
3405-000,2016,8,31,10,985,947,1932,2468
3405-000,2016,8,31,11,1106,912,2018,1932
3405-000,2016,8,31,12,955,884,1839,2018
3405-000,2016,8,31,13,847,786,1633,1839
3405-000,2016,8,31,14,958,885,1843,1633
3405-000,2016,8,31,15,1108,936,2044,1843
3405-000,2016,8,31,16,1077,996,2073,2044
3405-000,2016,8,31,17,1089,877,1966,2073
3405-000,2016,8,31,18,1166,984,2150,1966
3405-000,2016,8,31,19,1143,972,2115,2150
3405-000,2016,8,31,20,750,675,1425,2115
3405-000,2016,8,31,21,560,487,1047,1425
3405-000,2016,8,31,22,388,385,773,1047
3405-000,2016,8,31,23,265,249,514,773
3405-000,2016,8,31,24,154,176,330,514
3405-000,2016,9,1,1,112,112,224,330
3405-000,2016,9,1,2,81,71,152,224
3405-000,2016,9,1,3,46,53,99,152
3405-000,2016,9,1,4,65,67,132,99
3405-000,2016,9,1,5,96,105,201,132
3405-000,2016,9,1,6,268,213,481,201
3405-000,2016,9,1,7,579,521,1100,481
3405-000,2016,9,1,8,1175,1432,2607,1100
3405-000,2016,9,1,9,1307,1315,2622,2607
3405-000,2016,9,1,10,1130,1021,2151,2622
3405-000,2016,9,1,11,1175,1003,2178,2151
3405-000,2016,9,1,12,1085,1059,2144,2178
3405-000,2016,9,1,13,963,888,1851,2144
3405-000,2016,9,1,14,1055,997,2052,1851
3405-000,2016,9,1,15,1216,1025,2241,2052
3405-000,2016,9,1,16,1160,1047,2207,2241
3405-000,2016,9,1,17,1128,951,2079,2207
3405-000,2016,9,1,18,1235,997,2232,2079
3405-000,2016,9,1,19,1182,1070,2252,2232
3405-000,2016,9,1,20,854,693,1547,2252
3405-000,2016,9,1,21,707,594,1301,1547
3405-000,2016,9,1,22,460,405,865,1301
3405-000,2016,9,1,23,276,280,556,865
3405-000,2016,9,1,24,190,202,392,556
3405-000,2016,9,2,1,120,132,252,392
3405-000,2016,9,2,2,86,89,175,252
3405-000,2016,9,2,3,53,78,131,175
3405-000,2016,9,2,4,62,80,142,131
3405-000,2016,9,2,5,106,99,205,142
3405-000,2016,9,2,6,249,226,475,205
3405-000,2016,9,2,7,604,540,1144,475
3405-000,2016,9,2,8,1140,1337,2477,1144
3405-000,2016,9,2,9,1329,1324,2653,2477
3405-000,2016,9,2,10,1104,1019,2123,2653
3405-000,2016,9,2,11,1240,1096,2336,2123
3405-000,2016,9,2,12,1135,1002,2137,2336
3405-000,2016,9,2,13,1023,919,1942,2137
3405-000,2016,9,2,14,1143,1047,2190,1942
3405-000,2016,9,2,15,1164,1127,2291,2190
3405-000,2016,9,2,16,1290,1072,2362,2291
3405-000,2016,9,2,17,1262,1206,2468,2362
3405-000,2016,9,2,18,1448,1247,2695,2468
3405-000,2016,9,2,19,1482,1252,2734,2695
3405-000,2016,9,2,20,1073,809,1882,2734
3405-000,2016,9,2,21,810,648,1458,1882
3405-000,2016,9,2,22,549,458,1007,1458
3405-000,2016,9,2,23,359,276,635,1007
3405-000,2016,9,2,24,177,204,381,635
3405-000,2016,9,3,1,121,132,253,381
3405-000,2016,9,3,2,80,88,168,253
3405-000,2016,9,3,3,66,70,136,168
3405-000,2016,9,3,4,68,81,149,136
3405-000,2016,9,3,5,128,87,215,149
3405-000,2016,9,3,6,264,159,423,215
3405-000,2016,9,3,7,587,394,981,423
3405-000,2016,9,3,8,859,766,1625,981
3405-000,2016,9,3,9,1054,851,1905,1625
3405-000,2016,9,3,10,1066,915,1981,1905
3405-000,2016,9,3,11,1253,857,2110,1981
3405-000,2016,9,3,12,1096,856,1952,2110
3405-000,2016,9,3,13,1012,889,1901,1952
3405-000,2016,9,3,14,1037,865,1902,1901
3405-000,2016,9,3,15,991,871,1862,1902
3405-000,2016,9,3,16,1016,844,1860,1862
3405-000,2016,9,3,17,1043,760,1803,1860
3405-000,2016,9,3,18,1235,969,2204,1803
3405-000,2016,9,3,19,1067,744,1811,2204
3405-000,2016,9,3,20,921,532,1453,1811
3405-000,2016,9,3,21,558,511,1069,1453
3405-000,2016,9,3,22,371,367,738,1069
3405-000,2016,9,3,23,207,321,528,738
3405-000,2016,9,3,24,157,187,344,528
3405-000,2016,9,4,1,77,113,190,344
3405-000,2016,9,4,2,63,62,125,190
3405-000,2016,9,4,3,64,46,110,125
3405-000,2016,9,4,4,36,34,70,110
3405-000,2016,9,4,5,63,44,107,70
3405-000,2016,9,4,6,196,106,302,107
3405-000,2016,9,4,7,383,247,630,302
3405-000,2016,9,4,8,600,347,947,630
3405-000,2016,9,4,9,655,373,1028,947
3405-000,2016,9,4,10,632,431,1063,1028
3405-000,2016,9,4,11,621,516,1137,1063
3405-000,2016,9,4,12,676,541,1217,1137
3405-000,2016,9,4,13,611,569,1180,1217
3405-000,2016,9,4,14,693,637,1330,1180
3405-000,2016,9,4,15,795,706,1501,1330
3405-000,2016,9,4,16,783,774,1557,1501
3405-000,2016,9,4,17,821,775,1596,1557
3405-000,2016,9,4,18,871,768,1639,1596
3405-000,2016,9,4,19,752,692,1444,1639
3405-000,2016,9,4,20,535,591,1126,1444
3405-000,2016,9,4,21,500,515,1015,1126
3405-000,2016,9,4,22,340,438,778,1015
3405-000,2016,9,4,23,227,341,568,778
3405-000,2016,9,4,24,122,212,334,568
3405-000,2016,9,5,1,92,117,209,334
3405-000,2016,9,5,2,50,60,110,209
3405-000,2016,9,5,3,26,53,79,110
3405-000,2016,9,5,4,72,73,145,79
3405-000,2016,9,5,5,88,105,193,145
3405-000,2016,9,5,6,308,273,581,193
3405-000,2016,9,5,7,703,759,1462,581
3405-000,2016,9,5,8,1218,1625,2843,1462
3405-000,2016,9,5,9,1382,1388,2770,2843
3405-000,2016,9,5,10,1103,966,2069,2770
3405-000,2016,9,5,11,1158,998,2156,2069
3405-000,2016,9,5,12,1155,922,2077,2156
3405-000,2016,9,5,13,962,837,1799,2077
3405-000,2016,9,5,14,1043,1079,2122,1799
3405-000,2016,9,5,15,1208,1115,2323,2122
3405-000,2016,9,5,16,1190,1047,2237,2323
3405-000,2016,9,5,17,1185,1098,2283,2237
3405-000,2016,9,5,18,1304,1057,2361,2283
3405-000,2016,9,5,19,1193,1122,2315,2361
3405-000,2016,9,5,20,894,714,1608,2315
3405-000,2016,9,5,21,693,640,1333,1608
3405-000,2016,9,5,22,454,459,913,1333
3405-000,2016,9,5,23,263,287,550,913
3405-000,2016,9,5,24,166,146,312,550
3405-000,2016,9,6,1,97,106,203,312
3405-000,2016,9,6,2,62,81,143,203
3405-000,2016,9,6,3,66,61,127,143
3405-000,2016,9,6,4,74,86,160,127
3405-000,2016,9,6,5,112,105,217,160
3405-000,2016,9,6,6,288,230,518,217
3405-000,2016,9,6,7,590,544,1134,518
3405-000,2016,9,6,8,1154,1435,2589,1134
3405-000,2016,9,6,9,1336,1307,2643,2589
3405-000,2016,9,6,10,1198,1042,2240,2643
3405-000,2016,9,6,11,1210,1016,2226,2240
3405-000,2016,9,6,12,1127,952,2079,2226
3405-000,2016,9,6,13,994,928,1922,2079
3405-000,2016,9,6,14,1049,1025,2074,1922
3405-000,2016,9,6,15,1184,1137,2321,2074
3405-000,2016,9,6,16,1239,1055,2294,2321
3405-000,2016,9,6,17,1248,1097,2345,2294
3405-000,2016,9,6,18,1294,1081,2375,2345
3405-000,2016,9,6,19,1206,1126,2332,2375
3405-000,2016,9,6,20,833,685,1518,2332
3405-000,2016,9,6,21,696,609,1305,1518
3405-000,2016,9,6,22,445,473,918,1305
3405-000,2016,9,6,23,320,318,638,918
3405-000,2016,9,6,24,195,206,401,638
3405-000,2016,9,7,1,104,120,224,401
3405-000,2016,9,7,2,67,82,149,224
3405-000,2016,9,7,3,59,63,122,149
3405-000,2016,9,7,4,80,93,173,122
3405-000,2016,9,7,5,127,96,223,173
3405-000,2016,9,7,6,290,248,538,223
3405-000,2016,9,7,7,628,568,1196,538
3405-000,2016,9,7,8,1092,1431,2523,1196
3405-000,2016,9,7,9,1276,1256,2532,2523
3405-000,2016,9,7,10,1126,1012,2138,2532
3405-000,2016,9,7,11,1204,1135,2339,2138
3405-000,2016,9,7,12,1160,1032,2192,2339
3405-000,2016,9,7,13,971,894,1865,2192
3405-000,2016,9,7,14,1056,1114,2170,1865
3405-000,2016,9,7,15,1242,1125,2367,2170
3405-000,2016,9,7,16,1297,1107,2404,2367
3405-000,2016,9,7,17,1256,993,2249,2404
3405-000,2016,9,7,18,1418,1164,2582,2249
3405-000,2016,9,7,19,1351,1101,2452,2582
3405-000,2016,9,7,20,893,692,1585,2452
3405-000,2016,9,7,21,618,588,1206,1585
3405-000,2016,9,7,22,397,438,835,1206
3405-000,2016,9,7,23,293,288,581,835
3405-000,2016,9,7,24,173,202,375,581
3405-000,2016,9,8,1,122,138,260,375
3405-000,2016,9,8,2,63,80,143,260
3405-000,2016,9,8,3,69,72,141,143
3405-000,2016,9,8,4,70,78,148,141
3405-000,2016,9,8,5,109,112,221,148
3405-000,2016,9,8,6,290,243,533,221
3405-000,2016,9,8,7,581,588,1169,533
3405-000,2016,9,8,8,1199,1444,2643,1169
3405-000,2016,9,8,9,1362,1329,2691,2643
3405-000,2016,9,8,10,1217,1154,2371,2691
3405-000,2016,9,8,11,1277,1131,2408,2371
3405-000,2016,9,8,12,1191,1065,2256,2408
3405-000,2016,9,8,13,1002,1049,2051,2256
3405-000,2016,9,8,14,1027,1118,2145,2051
3405-000,2016,9,8,15,1253,1180,2433,2145
3405-000,2016,9,8,16,1256,1160,2416,2433
3405-000,2016,9,8,17,1224,1220,2444,2416
3405-000,2016,9,8,18,1254,948,2202,2444
3405-000,2016,9,8,19,1176,1058,2234,2202
3405-000,2016,9,8,20,869,730,1599,2234
3405-000,2016,9,8,21,676,597,1273,1599
3405-000,2016,9,8,22,430,465,895,1273
3405-000,2016,9,8,23,334,273,607,895
3405-000,2016,9,8,24,172,192,364,607
3405-000,2016,9,9,1,120,109,229,364
3405-000,2016,9,9,2,70,78,148,229
3405-000,2016,9,9,3,57,85,142,148
3405-000,2016,9,9,4,74,95,169,142
3405-000,2016,9,9,5,118,128,246,169
3405-000,2016,9,9,6,318,229,547,246
3405-000,2016,9,9,7,622,599,1221,547
3405-000,2016,9,9,8,1176,1449,2625,1221
3405-000,2016,9,9,9,1336,1389,2725,2625
3405-000,2016,9,9,10,1224,998,2222,2725
3405-000,2016,9,9,11,1261,1127,2388,2222
3405-000,2016,9,9,12,1064,930,1994,2388
3405-000,2016,9,9,13,1055,942,1997,1994
3405-000,2016,9,9,14,1099,1024,2123,1997
3405-000,2016,9,9,15,1359,1129,2488,2123
3405-000,2016,9,9,16,1342,1204,2546,2488
3405-000,2016,9,9,17,1420,1125,2545,2546
3405-000,2016,9,9,18,1870,1238,3108,2545
3405-000,2016,9,9,19,1660,1311,2971,3108
3405-000,2016,9,9,20,1144,893,2037,2971
3405-000,2016,9,9,21,850,643,1493,2037
3405-000,2016,9,9,22,595,473,1068,1493
3405-000,2016,9,9,23,386,281,667,1068
3405-000,2016,9,9,24,220,203,423,667
3405-000,2016,9,10,1,155,161,316,423
3405-000,2016,9,10,2,96,76,172,316
3405-000,2016,9,10,3,80,96,176,172
3405-000,2016,9,10,4,67,91,158,176
3405-000,2016,9,10,5,140,117,257,158
3405-000,2016,9,10,6,280,216,496,257
3405-000,2016,9,10,7,516,463,979,496
3405-000,2016,9,10,8,864,766,1630,979
3405-000,2016,9,10,9,1080,855,1935,1630
3405-000,2016,9,10,10,1042,862,1904,1935
3405-000,2016,9,10,11,1049,803,1852,1904
3405-000,2016,9,10,12,1090,831,1921,1852
3405-000,2016,9,10,13,956,758,1714,1921
3405-000,2016,9,10,14,875,782,1657,1714
3405-000,2016,9,10,15,965,782,1747,1657
3405-000,2016,9,10,16,942,832,1774,1747
3405-000,2016,9,10,17,950,823,1773,1774
3405-000,2016,9,10,18,1079,957,2036,1773
3405-000,2016,9,10,19,891,710,1601,2036
3405-000,2016,9,10,20,552,526,1078,1601
3405-000,2016,9,10,21,492,393,885,1078
3405-000,2016,9,10,22,356,304,660,885
3405-000,2016,9,10,23,223,239,462,660
3405-000,2016,9,10,24,136,150,286,462
3405-000,2016,9,11,1,99,93,192,286
3405-000,2016,9,11,2,74,60,134,192
3405-000,2016,9,11,3,50,58,108,134
3405-000,2016,9,11,4,60,46,106,108
3405-000,2016,9,11,5,64,50,114,106
3405-000,2016,9,11,6,169,108,277,114
3405-000,2016,9,11,7,334,224,558,277
3405-000,2016,9,11,8,484,342,826,558
3405-000,2016,9,11,9,550,398,948,826
3405-000,2016,9,11,10,594,353,947,948
3405-000,2016,9,11,11,611,450,1061,947
3405-000,2016,9,11,12,541,473,1014,1061
3405-000,2016,9,11,13,600,550,1150,1014
3405-000,2016,9,11,14,626,576,1202,1150
3405-000,2016,9,11,15,622,583,1205,1202
3405-000,2016,9,11,16,748,661,1409,1205
3405-000,2016,9,11,17,628,665,1293,1409
3405-000,2016,9,11,18,705,660,1365,1293
3405-000,2016,9,11,19,555,582,1137,1365
3405-000,2016,9,11,20,470,514,984,1137
3405-000,2016,9,11,21,371,402,773,984
3405-000,2016,9,11,22,291,321,612,773
3405-000,2016,9,11,23,191,230,421,612
3405-000,2016,9,11,24,124,169,293,421
3405-000,2016,9,12,1,68,95,163,293
3405-000,2016,9,12,2,52,65,117,163
3405-000,2016,9,12,3,40,52,92,117
3405-000,2016,9,12,4,56,75,131,92
3405-000,2016,9,12,5,91,113,204,131
3405-000,2016,9,12,6,269,279,548,204
3405-000,2016,9,12,7,672,635,1307,548
3405-000,2016,9,12,8,1228,1545,2773,1307
3405-000,2016,9,12,9,1373,1286,2659,2773
3405-000,2016,9,12,10,1206,984,2190,2659
3405-000,2016,9,12,11,1227,1123,2350,2190
3405-000,2016,9,12,12,1223,1090,2313,2350
3405-000,2016,9,12,13,1052,1003,2055,2313
3405-000,2016,9,12,14,1110,1119,2229,2055
3405-000,2016,9,12,15,1421,1119,2540,2229
3405-000,2016,9,12,16,1304,1159,2463,2540
3405-000,2016,9,12,17,1303,1113,2416,2463
3405-000,2016,9,12,18,1416,1156,2572,2416
3405-000,2016,9,12,19,1324,1097,2421,2572
3405-000,2016,9,12,20,906,749,1655,2421
3405-000,2016,9,12,21,693,660,1353,1655
3405-000,2016,9,12,22,439,473,912,1353
3405-000,2016,9,12,23,336,270,606,912
3405-000,2016,9,12,24,172,209,381,606
3405-000,2016,9,13,1,105,129,234,381
3405-000,2016,9,13,2,76,83,159,234
3405-000,2016,9,13,3,65,84,149,159
3405-000,2016,9,13,4,74,82,156,149
3405-000,2016,9,13,5,120,115,235,156
3405-000,2016,9,13,6,229,208,437,235
3405-000,2016,9,13,7,525,445,970,437
3405-000,2016,9,13,8,1113,1172,2285,970
3405-000,2016,9,13,9,1292,1146,2438,2285
3405-000,2016,9,13,10,1092,953,2045,2438
3405-000,2016,9,13,11,1206,978,2184,2045
3405-000,2016,9,13,12,1123,895,2018,2184
3405-000,2016,9,13,13,1067,814,1881,2018
3405-000,2016,9,13,14,1146,873,2019,1881
3405-000,2016,9,13,15,1294,1215,2509,2019
3405-000,2016,9,13,16,1409,1375,2784,2509
3405-000,2016,9,13,17,1835,1173,3008,2784
3405-000,2016,9,13,18,1424,1383,2807,3008
3405-000,2016,9,13,19,1396,1114,2510,2807
3405-000,2016,9,13,20,928,854,1782,2510
3405-000,2016,9,13,21,636,682,1318,1782
3405-000,2016,9,13,22,444,606,1050,1318
3405-000,2016,9,13,23,319,271,590,1050
3405-000,2016,9,13,24,221,194,415,590
3405-000,2016,9,14,1,165,167,332,415
3405-000,2016,9,14,2,122,124,246,332
3405-000,2016,9,14,3,132,109,241,246
3405-000,2016,9,14,4,123,126,249,241
3405-000,2016,9,14,5,267,192,459,249
3405-000,2016,9,14,6,406,337,743,459
3405-000,2016,9,14,7,559,282,841,743
3405-000,2016,9,14,8,534,469,1003,841
3405-000,2016,9,14,9,712,746,1458,1003
3405-000,2016,9,14,10,756,897,1653,1458
3405-000,2016,9,14,11,993,668,1661,1653
3405-000,2016,9,14,12,954,818,1772,1661
3405-000,2016,9,14,13,980,600,1580,1772
3405-000,2016,9,14,14,932,560,1492,1580
3405-000,2016,9,14,15,869,522,1391,1492
3405-000,2016,9,14,16,596,565,1161,1391
3405-000,2016,9,14,17,516,460,976,1161
3405-000,2016,9,14,18,472,428,900,976
3405-000,2016,9,14,19,382,491,873,900
3405-000,2016,9,14,20,307,318,625,873
3405-000,2016,9,14,21,242,227,469,625
3405-000,2016,9,14,22,212,154,366,469
3405-000,2016,9,14,23,144,117,261,366
3405-000,2016,9,14,24,95,89,184,261
3405-000,2016,9,15,1,65,50,115,184
3405-000,2016,9,15,2,26,49,75,115
3405-000,2016,9,15,3,24,20,44,75
3405-000,2016,9,15,4,26,14,40,44
3405-000,2016,9,15,5,53,34,87,40
3405-000,2016,9,15,6,136,65,201,87
3405-000,2016,9,15,7,351,152,503,201
3405-000,2016,9,15,8,494,326,820,503
3405-000,2016,9,15,9,471,245,716,820
3405-000,2016,9,15,10,794,350,1144,716
3405-000,2016,9,15,11,1186,551,1737,1144
3405-000,2016,9,15,12,1310,772,2082,1737
3405-000,2016,9,15,13,1147,758,1905,2082
3405-000,2016,9,15,14,1032,895,1927,1905
3405-000,2016,9,15,15,1169,1020,2189,1927
3405-000,2016,9,15,16,1257,1306,2563,2189
3405-000,2016,9,15,17,1348,1062,2410,2563
3405-000,2016,9,15,18,1150,1105,2255,2410
3405-000,2016,9,15,19,972,876,1848,2255
3405-000,2016,9,15,20,629,568,1197,1848
3405-000,2016,9,15,21,474,476,950,1197
3405-000,2016,9,15,22,324,429,753,950
3405-000,2016,9,15,23,210,439,649,753
3405-000,2016,9,15,24,152,184,336,649
3405-000,2016,9,16,1,90,106,196,336
3405-000,2016,9,16,2,48,60,108,196
3405-000,2016,9,16,3,43,45,88,108
3405-000,2016,9,16,4,48,34,82,88
3405-000,2016,9,16,5,50,37,87,82
3405-000,2016,9,16,6,112,62,174,87
3405-000,2016,9,16,7,150,110,260,174
3405-000,2016,9,16,8,251,186,437,260
3405-000,2016,9,16,9,349,239,588,437
3405-000,2016,9,16,10,615,279,894,588
3405-000,2016,9,16,11,773,471,1244,894
3405-000,2016,9,16,12,849,538,1387,1244
3405-000,2016,9,16,13,854,545,1399,1387
3405-000,2016,9,16,14,713,528,1241,1399
3405-000,2016,9,16,15,825,613,1438,1241
3405-000,2016,9,16,16,674,619,1293,1438
3405-000,2016,9,16,17,744,668,1412,1293
3405-000,2016,9,16,18,1045,590,1635,1412
3405-000,2016,9,16,19,776,523,1299,1635
3405-000,2016,9,16,20,837,456,1293,1299
3405-000,2016,9,16,21,780,341,1121,1293
3405-000,2016,9,16,22,495,301,796,1121
3405-000,2016,9,16,23,531,251,782,796
3405-000,2016,9,16,24,333,177,510,782
3405-000,2016,9,17,1,145,129,274,510
3405-000,2016,9,17,2,101,84,185,274
3405-000,2016,9,17,3,46,74,120,185
3405-000,2016,9,17,4,31,45,76,120
3405-000,2016,9,17,5,67,47,114,76
3405-000,2016,9,17,6,102,86,188,114
3405-000,2016,9,17,7,160,134,294,188
3405-000,2016,9,17,8,277,223,500,294
3405-000,2016,9,17,9,388,300,688,500
3405-000,2016,9,17,10,405,319,724,688
3405-000,2016,9,17,11,561,374,935,724
3405-000,2016,9,17,12,736,420,1156,935
3405-000,2016,9,17,13,816,508,1324,1156
3405-000,2016,9,17,14,767,532,1299,1324
3405-000,2016,9,17,15,950,491,1441,1299
3405-000,2016,9,17,16,861,490,1351,1441
3405-000,2016,9,17,17,900,518,1418,1351
3405-000,2016,9,17,18,733,476,1209,1418
3405-000,2016,9,17,19,718,399,1117,1209
3405-000,2016,9,17,20,457,369,826,1117
3405-000,2016,9,17,21,287,323,610,826
3405-000,2016,9,17,22,274,256,530,610
3405-000,2016,9,17,23,160,179,339,530
3405-000,2016,9,17,24,99,137,236,339
3405-000,2016,9,18,1,82,80,162,236
3405-000,2016,9,18,2,48,41,89,162
3405-000,2016,9,18,3,47,22,69,89
3405-000,2016,9,18,4,27,39,66,69
3405-000,2016,9,18,5,58,39,97,66
3405-000,2016,9,18,6,98,63,161,97
3405-000,2016,9,18,7,168,122,290,161
3405-000,2016,9,18,8,259,192,451,290
3405-000,2016,9,18,9,405,278,683,451
3405-000,2016,9,18,10,424,314,738,683
3405-000,2016,9,18,11,497,407,904,738
3405-000,2016,9,18,12,475,437,912,904
3405-000,2016,9,18,13,481,427,908,912
3405-000,2016,9,18,14,511,504,1015,908
3405-000,2016,9,18,15,550,571,1121,1015
3405-000,2016,9,18,16,554,590,1144,1121
3405-000,2016,9,18,17,561,632,1193,1144
3405-000,2016,9,18,18,587,560,1147,1193
3405-000,2016,9,18,19,480,514,994,1147
3405-000,2016,9,18,20,382,439,821,994
3405-000,2016,9,18,21,340,366,706,821
3405-000,2016,9,18,22,262,328,590,706
3405-000,2016,9,18,23,175,265,440,590
3405-000,2016,9,18,24,117,165,282,440
3405-000,2016,9,19,1,62,96,158,282
3405-000,2016,9,19,2,33,58,91,158
3405-000,2016,9,19,3,33,53,86,91
3405-000,2016,9,19,4,58,71,129,86
3405-000,2016,9,19,5,86,104,190,129
3405-000,2016,9,19,6,281,273,554,190
3405-000,2016,9,19,7,646,686,1332,554
3405-000,2016,9,19,8,1165,1530,2695,1332
3405-000,2016,9,19,9,1314,1308,2622,2695
3405-000,2016,9,19,10,1016,910,1926,2622
3405-000,2016,9,19,11,1056,940,1996,1926
3405-000,2016,9,19,12,1049,896,1945,1996
3405-000,2016,9,19,13,922,749,1671,1945
3405-000,2016,9,19,14,926,967,1893,1671
3405-000,2016,9,19,15,1130,1034,2164,1893
3405-000,2016,9,19,16,1168,958,2126,2164
3405-000,2016,9,19,17,1113,916,2029,2126
3405-000,2016,9,19,18,1181,957,2138,2029
3405-000,2016,9,19,19,1118,1009,2127,2138
3405-000,2016,9,19,20,810,676,1486,2127
3405-000,2016,9,19,21,592,593,1185,1486
3405-000,2016,9,19,22,490,388,878,1185
3405-000,2016,9,19,23,273,230,503,878
3405-000,2016,9,19,24,156,198,354,503
3405-000,2016,9,20,1,79,106,185,354
3405-000,2016,9,20,2,63,78,141,185
3405-000,2016,9,20,3,55,66,121,141
3405-000,2016,9,20,4,95,74,169,121
3405-000,2016,9,20,5,117,136,253,169
3405-000,2016,9,20,6,287,240,527,253
3405-000,2016,9,20,7,585,540,1125,527
3405-000,2016,9,20,8,1159,1422,2581,1125
3405-000,2016,9,20,9,1413,1300,2713,2581
3405-000,2016,9,20,10,1172,997,2169,2713
3405-000,2016,9,20,11,1210,1036,2246,2169
3405-000,2016,9,20,12,1244,871,2115,2246
3405-000,2016,9,20,13,929,872,1801,2115
3405-000,2016,9,20,14,1070,1068,2138,1801
3405-000,2016,9,20,15,1262,1016,2278,2138
3405-000,2016,9,20,16,1268,1038,2306,2278
3405-000,2016,9,20,17,1178,1017,2195,2306
3405-000,2016,9,20,18,1213,1059,2272,2195
3405-000,2016,9,20,19,1175,1048,2223,2272
3405-000,2016,9,20,20,833,724,1557,2223
3405-000,2016,9,20,21,677,588,1265,1557
3405-000,2016,9,20,22,440,399,839,1265
3405-000,2016,9,20,23,266,252,518,839
3405-000,2016,9,20,24,162,178,340,518
3405-000,2016,9,21,1,90,126,216,340
3405-000,2016,9,21,2,71,80,151,216
3405-000,2016,9,21,3,67,81,148,151
3405-000,2016,9,21,4,63,59,122,148
3405-000,2016,9,21,5,114,112,226,122
3405-000,2016,9,21,6,264,211,475,226
3405-000,2016,9,21,7,634,520,1154,475
3405-000,2016,9,21,8,1168,1374,2542,1154
3405-000,2016,9,21,9,1346,1250,2596,2542
3405-000,2016,9,21,10,1182,1026,2208,2596
3405-000,2016,9,21,11,1240,1023,2263,2208
3405-000,2016,9,21,12,1159,1001,2160,2263
3405-000,2016,9,21,13,1006,882,1888,2160
3405-000,2016,9,21,14,1069,1003,2072,1888
3405-000,2016,9,21,15,1200,988,2188,2072
3405-000,2016,9,21,16,1173,977,2150,2188
3405-000,2016,9,21,17,1207,1072,2279,2150
3405-000,2016,9,21,18,1323,1130,2453,2279
3405-000,2016,9,21,19,1293,1064,2357,2453
3405-000,2016,9,21,20,806,696,1502,2357
3405-000,2016,9,21,21,596,538,1134,1502
3405-000,2016,9,21,22,386,374,760,1134
3405-000,2016,9,21,23,284,263,547,760
3405-000,2016,9,21,24,157,181,338,547
3405-000,2016,9,22,1,88,108,196,338
3405-000,2016,9,22,2,51,59,110,196
3405-000,2016,9,22,3,45,71,116,110
3405-000,2016,9,22,4,61,71,132,116
3405-000,2016,9,22,5,109,114,223,132
3405-000,2016,9,22,6,278,213,491,223
3405-000,2016,9,22,7,613,571,1184,491
3405-000,2016,9,22,8,1173,1397,2570,1184
3405-000,2016,9,22,9,1345,1342,2687,2570
3405-000,2016,9,22,10,1224,990,2214,2687
3405-000,2016,9,22,11,1198,969,2167,2214
3405-000,2016,9,22,12,1204,996,2200,2167
3405-000,2016,9,22,13,958,916,1874,2200
3405-000,2016,9,22,14,1012,975,1987,1874
3405-000,2016,9,22,15,1234,1034,2268,1987
3405-000,2016,9,22,16,1250,1048,2298,2268
3405-000,2016,9,22,17,1261,988,2249,2298
3405-000,2016,9,22,18,1328,1015,2343,2249
3405-000,2016,9,22,19,1328,1029,2357,2343
3405-000,2016,9,22,20,797,658,1455,2357
3405-000,2016,9,22,21,636,628,1264,1455
3405-000,2016,9,22,22,409,450,859,1264
3405-000,2016,9,22,23,300,242,542,859
3405-000,2016,9,22,24,173,173,346,542
3405-000,2016,9,23,1,101,127,228,346
3405-000,2016,9,23,2,63,90,153,228
3405-000,2016,9,23,3,53,74,127,153
3405-000,2016,9,23,4,66,98,164,127
3405-000,2016,9,23,5,116,124,240,164
3405-000,2016,9,23,6,281,233,514,240
3405-000,2016,9,23,7,601,596,1197,514
3405-000,2016,9,23,8,1149,1338,2487,1197
3405-000,2016,9,23,9,1400,1237,2637,2487
3405-000,2016,9,23,10,1199,973,2172,2637
3405-000,2016,9,23,11,1210,1022,2232,2172
3405-000,2016,9,23,12,1154,922,2076,2232
3405-000,2016,9,23,13,1149,857,2006,2076
3405-000,2016,9,23,14,1124,990,2114,2006
3405-000,2016,9,23,15,1394,1043,2437,2114
3405-000,2016,9,23,16,1329,1047,2376,2437
3405-000,2016,9,23,17,1338,1076,2414,2376
3405-000,2016,9,23,18,1450,1107,2557,2414
3405-000,2016,9,23,19,1461,1227,2688,2557
3405-000,2016,9,23,20,1023,791,1814,2688
3405-000,2016,9,23,21,736,632,1368,1814
3405-000,2016,9,23,22,501,431,932,1368
3405-000,2016,9,23,23,308,287,595,932
3405-000,2016,9,23,24,177,163,340,595
3405-000,2016,9,24,1,139,130,269,340
3405-000,2016,9,24,2,85,75,160,269
3405-000,2016,9,24,3,61,58,119,160
3405-000,2016,9,24,4,79,89,168,119
3405-000,2016,9,24,5,123,101,224,168
3405-000,2016,9,24,6,248,159,407,224
3405-000,2016,9,24,7,524,419,943,407
3405-000,2016,9,24,8,883,733,1616,943
3405-000,2016,9,24,9,1041,872,1913,1616
3405-000,2016,9,24,10,1097,796,1893,1913
3405-000,2016,9,24,11,1102,995,2097,1893
3405-000,2016,9,24,12,1121,939,2060,2097
3405-000,2016,9,24,13,884,775,1659,2060
3405-000,2016,9,24,14,882,771,1653,1659
3405-000,2016,9,24,15,963,797,1760,1653
3405-000,2016,9,24,16,981,848,1829,1760
3405-000,2016,9,24,17,954,823,1777,1829
3405-000,2016,9,24,18,1129,895,2024,1777
3405-000,2016,9,24,19,1041,748,1789,2024
3405-000,2016,9,24,20,607,595,1202,1789
3405-000,2016,9,24,21,402,389,791,1202
3405-000,2016,9,24,22,348,316,664,791
3405-000,2016,9,24,23,217,237,454,664
3405-000,2016,9,24,24,144,183,327,454
3405-000,2016,9,25,1,87,101,188,327
3405-000,2016,9,25,2,65,66,131,188
3405-000,2016,9,25,3,47,53,100,131
3405-000,2016,9,25,4,52,33,85,100
3405-000,2016,9,25,5,70,46,116,85
3405-000,2016,9,25,6,135,81,216,116
3405-000,2016,9,25,7,289,194,483,216
3405-000,2016,9,25,8,434,315,749,483
3405-000,2016,9,25,9,523,407,930,749
3405-000,2016,9,25,10,548,392,940,930
3405-000,2016,9,25,11,700,443,1143,940
3405-000,2016,9,25,12,599,483,1082,1143
3405-000,2016,9,25,13,530,514,1044,1082
3405-000,2016,9,25,14,588,575,1163,1044
3405-000,2016,9,25,15,606,632,1238,1163
3405-000,2016,9,25,16,650,684,1334,1238
3405-000,2016,9,25,17,686,715,1401,1334
3405-000,2016,9,25,18,789,718,1507,1401
3405-000,2016,9,25,19,672,638,1310,1507
3405-000,2016,9,25,20,639,523,1162,1310
3405-000,2016,9,25,21,505,413,918,1162
3405-000,2016,9,25,22,281,381,662,918
3405-000,2016,9,25,23,200,255,455,662
3405-000,2016,9,25,24,105,173,278,455
3405-000,2016,9,26,1,62,124,186,278
3405-000,2016,9,26,2,41,87,128,186
3405-000,2016,9,26,3,43,56,99,128
3405-000,2016,9,26,4,56,73,129,99
3405-000,2016,9,26,5,118,111,229,129
3405-000,2016,9,26,6,308,264,572,229
3405-000,2016,9,26,7,663,679,1342,572
3405-000,2016,9,26,8,1238,1568,2806,1342
3405-000,2016,9,26,9,1385,1364,2749,2806
3405-000,2016,9,26,10,1136,960,2096,2749
3405-000,2016,9,26,11,1157,964,2121,2096
3405-000,2016,9,26,12,1091,987,2078,2121
3405-000,2016,9,26,13,935,862,1797,2078
3405-000,2016,9,26,14,1003,989,1992,1797
3405-000,2016,9,26,15,1179,1050,2229,1992
3405-000,2016,9,26,16,1253,1010,2263,2229
3405-000,2016,9,26,17,1200,965,2165,2263
3405-000,2016,9,26,18,1251,1064,2315,2165
3405-000,2016,9,26,19,1182,1004,2186,2315
3405-000,2016,9,26,20,847,712,1559,2186
3405-000,2016,9,26,21,650,657,1307,1559
3405-000,2016,9,26,22,442,446,888,1307
3405-000,2016,9,26,23,273,223,496,888
3405-000,2016,9,26,24,148,160,308,496
3405-000,2016,9,27,1,97,122,219,308
3405-000,2016,9,27,2,69,71,140,219
3405-000,2016,9,27,3,56,65,121,140
3405-000,2016,9,27,4,78,94,172,121
3405-000,2016,9,27,5,117,102,219,172
3405-000,2016,9,27,6,239,242,481,219
3405-000,2016,9,27,7,572,459,1031,481
3405-000,2016,9,27,8,1145,1341,2486,1031
3405-000,2016,9,27,9,1318,1235,2553,2486
3405-000,2016,9,27,10,1143,1004,2147,2553
3405-000,2016,9,27,11,1127,1004,2131,2147
3405-000,2016,9,27,12,1080,927,2007,2131
3405-000,2016,9,27,13,937,763,1700,2007
3405-000,2016,9,27,14,971,916,1887,1700
3405-000,2016,9,27,15,1172,967,2139,1887
3405-000,2016,9,27,16,1157,943,2100,2139
3405-000,2016,9,27,17,1126,1027,2153,2100
3405-000,2016,9,27,18,1172,989,2161,2153
3405-000,2016,9,27,19,1112,927,2039,2161
3405-000,2016,9,27,20,756,651,1407,2039
3405-000,2016,9,27,21,573,573,1146,1407
3405-000,2016,9,27,22,415,404,819,1146
3405-000,2016,9,27,23,246,250,496,819
3405-000,2016,9,27,24,148,172,320,496
3405-000,2016,9,28,1,93,86,179,320
3405-000,2016,9,28,2,71,68,139,179
3405-000,2016,9,28,3,41,62,103,139
3405-000,2016,9,28,4,71,65,136,103
3405-000,2016,9,28,5,126,110,236,136
3405-000,2016,9,28,6,282,224,506,236
3405-000,2016,9,28,7,573,547,1120,506
3405-000,2016,9,28,8,1197,1341,2538,1120
3405-000,2016,9,28,9,1394,1253,2647,2538
3405-000,2016,9,28,10,1113,989,2102,2647
3405-000,2016,9,28,11,1249,1018,2267,2102
3405-000,2016,9,28,12,1143,986,2129,2267
3405-000,2016,9,28,13,966,947,1913,2129
3405-000,2016,9,28,14,1063,981,2044,1913
3405-000,2016,9,28,15,1198,995,2193,2044
3405-000,2016,9,28,16,1218,1012,2230,2193
3405-000,2016,9,28,17,1130,1043,2173,2230
3405-000,2016,9,28,18,1253,1113,2366,2173
3405-000,2016,9,28,19,1269,1010,2279,2366
3405-000,2016,9,28,20,808,640,1448,2279
3405-000,2016,9,28,21,569,500,1069,1448
3405-000,2016,9,28,22,420,380,800,1069
3405-000,2016,9,28,23,269,278,547,800
3405-000,2016,9,28,24,184,171,355,547
3405-000,2016,9,29,1,98,118,216,355
3405-000,2016,9,29,2,57,75,132,216
3405-000,2016,9,29,3,56,71,127,132
3405-000,2016,9,29,4,72,73,145,127
3405-000,2016,9,29,5,121,107,228,145
3405-000,2016,9,29,6,248,218,466,228
3405-000,2016,9,29,7,563,534,1097,466
3405-000,2016,9,29,8,1143,1320,2463,1097
3405-000,2016,9,29,9,1429,1296,2725,2463
3405-000,2016,9,29,10,1167,1047,2214,2725
3405-000,2016,9,29,11,1215,1020,2235,2214
3405-000,2016,9,29,12,1181,959,2140,2235
3405-000,2016,9,29,13,915,795,1710,2140
3405-000,2016,9,29,14,1096,976,2072,1710
3405-000,2016,9,29,15,1265,1010,2275,2072
3405-000,2016,9,29,16,1262,1068,2330,2275
3405-000,2016,9,29,17,1265,1069,2334,2330
3405-000,2016,9,29,18,1208,1062,2270,2334
3405-000,2016,9,29,19,1190,1027,2217,2270
3405-000,2016,9,29,20,845,654,1499,2217
3405-000,2016,9,29,21,643,596,1239,1499
3405-000,2016,9,29,22,445,454,899,1239
3405-000,2016,9,29,23,278,263,541,899
3405-000,2016,9,29,24,185,185,370,541
3405-000,2016,9,30,1,94,111,205,370
3405-000,2016,9,30,2,76,82,158,205
3405-000,2016,9,30,3,69,76,145,158
3405-000,2016,9,30,4,84,76,160,145
3405-000,2016,9,30,5,115,107,222,160
3405-000,2016,9,30,6,271,217,488,222
3405-000,2016,9,30,7,581,514,1095,488
3405-000,2016,9,30,8,1149,1329,2478,1095
3405-000,2016,9,30,9,1393,1280,2673,2478
3405-000,2016,9,30,10,1097,990,2087,2673
3405-000,2016,9,30,11,1245,943,2188,2087
3405-000,2016,9,30,12,1158,985,2143,2188
3405-000,2016,9,30,13,1013,869,1882,2143
3405-000,2016,9,30,14,1189,945,2134,1882
3405-000,2016,9,30,15,1357,1035,2392,2134
3405-000,2016,9,30,16,1259,969,2228,2392
3405-000,2016,9,30,17,1245,1008,2253,2228
3405-000,2016,9,30,18,1513,1207,2720,2253
3405-000,2016,9,30,19,1568,1144,2712,2720
3405-000,2016,9,30,20,1128,780,1908,2712
3405-000,2016,9,30,21,778,597,1375,1908
3405-000,2016,9,30,22,562,459,1021,1375
3405-000,2016,9,30,23,316,277,593,1021
3405-000,2016,9,30,24,194,179,373,593
3405-000,2016,10,1,1,118,139,257,373
3405-000,2016,10,1,2,84,85,169,257
3405-000,2016,10,1,3,63,68,131,169
3405-000,2016,10,1,4,79,69,148,131
3405-000,2016,10,1,5,99,97,196,148
3405-000,2016,10,1,6,245,153,398,196
3405-000,2016,10,1,7,560,385,945,398
3405-000,2016,10,1,8,854,705,1559,945
3405-000,2016,10,1,9,1078,787,1865,1559
3405-000,2016,10,1,10,1114,786,1900,1865
3405-000,2016,10,1,11,1142,819,1961,1900
3405-000,2016,10,1,12,1124,980,2104,1961
3405-000,2016,10,1,13,1122,842,1964,2104
3405-000,2016,10,1,14,991,863,1854,1964
3405-000,2016,10,1,15,1043,925,1968,1854
3405-000,2016,10,1,16,1068,830,1898,1968
3405-000,2016,10,1,17,1091,816,1907,1898
3405-000,2016,10,1,18,1218,920,2138,1907
3405-000,2016,10,1,19,1151,825,1976,2138
3405-000,2016,10,1,20,747,584,1331,1976
3405-000,2016,10,1,21,447,521,968,1331
3405-000,2016,10,1,22,375,340,715,968
3405-000,2016,10,1,23,242,249,491,715
3405-000,2016,10,1,24,144,155,299,491
3405-000,2016,10,2,1,102,90,192,299
3405-000,2016,10,2,2,60,49,109,192
3405-000,2016,10,2,3,50,35,85,109
3405-000,2016,10,2,4,33,38,71,85
3405-000,2016,10,2,5,58,38,96,71
3405-000,2016,10,2,6,102,77,179,96
3405-000,2016,10,2,7,202,133,335,179
3405-000,2016,10,2,8,317,274,591,335
3405-000,2016,10,2,9,442,326,768,591
3405-000,2016,10,2,10,498,357,855,768
3405-000,2016,10,2,11,590,453,1043,855
3405-000,2016,10,2,12,632,516,1148,1043
3405-000,2016,10,2,13,584,530,1114,1148
3405-000,2016,10,2,14,619,538,1157,1114
3405-000,2016,10,2,15,640,581,1221,1157
3405-000,2016,10,2,16,744,558,1302,1221
3405-000,2016,10,2,17,711,580,1291,1302
3405-000,2016,10,2,18,752,654,1406,1291
3405-000,2016,10,2,19,676,556,1232,1406
3405-000,2016,10,2,20,539,471,1010,1232
3405-000,2016,10,2,21,353,422,775,1010
3405-000,2016,10,2,22,275,319,594,775
3405-000,2016,10,2,23,200,273,473,594
3405-000,2016,10,2,24,131,150,281,473
3405-000,2016,10,3,1,88,96,184,281
3405-000,2016,10,3,2,56,70,126,184
3405-000,2016,10,3,3,48,43,91,126
3405-000,2016,10,3,4,49,49,98,91
3405-000,2016,10,3,5,70,74,144,98
3405-000,2016,10,3,6,198,167,365,144
3405-000,2016,10,3,7,332,305,637,365
3405-000,2016,10,3,8,524,531,1055,637
3405-000,2016,10,3,9,664,520,1184,1055
3405-000,2016,10,3,10,623,513,1136,1184
3405-000,2016,10,3,11,741,608,1349,1136
3405-000,2016,10,3,12,759,641,1400,1349
3405-000,2016,10,3,13,707,649,1356,1400
3405-000,2016,10,3,14,694,669,1363,1356
3405-000,2016,10,3,15,758,711,1469,1363
3405-000,2016,10,3,16,792,719,1511,1469
3405-000,2016,10,3,17,887,725,1612,1511
3405-000,2016,10,3,18,947,810,1757,1612
3405-000,2016,10,3,19,809,729,1538,1757
3405-000,2016,10,3,20,575,601,1176,1538
3405-000,2016,10,3,21,425,494,919,1176
3405-000,2016,10,3,22,336,384,720,919
3405-000,2016,10,3,23,193,286,479,720
3405-000,2016,10,3,24,141,179,320,479
3405-000,2016,10,4,1,66,104,170,320
3405-000,2016,10,4,2,42,68,110,170
3405-000,2016,10,4,3,44,52,96,110
3405-000,2016,10,4,4,49,58,107,96
3405-000,2016,10,4,5,97,100,197,107
3405-000,2016,10,4,6,233,235,468,197
3405-000,2016,10,4,7,609,634,1243,468
3405-000,2016,10,4,8,1161,1564,2725,1243
3405-000,2016,10,4,9,1372,1414,2786,2725
3405-000,2016,10,4,10,1139,950,2089,2786
3405-000,2016,10,4,11,1254,986,2240,2089
3405-000,2016,10,4,12,1141,947,2088,2240
3405-000,2016,10,4,13,1013,856,1869,2088
3405-000,2016,10,4,14,1042,996,2038,1869
3405-000,2016,10,4,15,1284,1049,2333,2038
3405-000,2016,10,4,16,1216,1036,2252,2333
3405-000,2016,10,4,17,1308,990,2298,2252
3405-000,2016,10,4,18,1314,1046,2360,2298
3405-000,2016,10,4,19,1190,1299,2489,2360
3405-000,2016,10,4,20,812,673,1485,2489
3405-000,2016,10,4,21,620,634,1254,1485
3405-000,2016,10,4,22,453,417,870,1254
3405-000,2016,10,4,23,296,278,574,870
3405-000,2016,10,4,24,177,173,350,574
3405-000,2016,10,5,1,102,120,222,350
3405-000,2016,10,5,2,67,83,150,222
3405-000,2016,10,5,3,51,76,127,150
3405-000,2016,10,5,4,65,61,126,127
3405-000,2016,10,5,5,135,94,229,126
3405-000,2016,10,5,6,199,189,388,229
3405-000,2016,10,5,7,516,431,947,388
3405-000,2016,10,5,8,1021,1242,2263,947
3405-000,2016,10,5,9,1260,1297,2557,2263
3405-000,2016,10,5,10,1119,942,2061,2557
3405-000,2016,10,5,11,1131,973,2104,2061
3405-000,2016,10,5,12,1094,906,2000,2104
3405-000,2016,10,5,13,927,849,1776,2000
3405-000,2016,10,5,14,1064,1007,2071,1776
3405-000,2016,10,5,15,1232,958,2190,2071
3405-000,2016,10,5,16,1291,952,2243,2190
3405-000,2016,10,5,17,1164,973,2137,2243
3405-000,2016,10,5,18,1286,1106,2392,2137
3405-000,2016,10,5,19,1177,1012,2189,2392
3405-000,2016,10,5,20,830,691,1521,2189
3405-000,2016,10,5,21,612,559,1171,1521
3405-000,2016,10,5,22,438,386,824,1171
3405-000,2016,10,5,23,283,265,548,824
3405-000,2016,10,5,24,165,200,365,548
3405-000,2016,10,6,1,110,121,231,365
3405-000,2016,10,6,2,76,80,156,231
3405-000,2016,10,6,3,61,66,127,156
3405-000,2016,10,6,4,80,78,158,127
3405-000,2016,10,6,5,117,109,226,158
3405-000,2016,10,6,6,234,217,451,226
3405-000,2016,10,6,7,560,511,1071,451
3405-000,2016,10,6,8,1167,1366,2533,1071
3405-000,2016,10,6,9,1388,1328,2716,2533
3405-000,2016,10,6,10,1191,1018,2209,2716
3405-000,2016,10,6,11,1145,1090,2235,2209
3405-000,2016,10,6,12,1081,1131,2212,2235
3405-000,2016,10,6,13,996,909,1905,2212
3405-000,2016,10,6,14,1085,1036,2121,1905
3405-000,2016,10,6,15,1268,990,2258,2121
3405-000,2016,10,6,16,1175,1039,2214,2258
3405-000,2016,10,6,17,1252,1076,2328,2214
3405-000,2016,10,6,18,1329,1118,2447,2328
3405-000,2016,10,6,19,1270,1030,2300,2447
3405-000,2016,10,6,20,836,688,1524,2300
3405-000,2016,10,6,21,662,586,1248,1524
3405-000,2016,10,6,22,440,422,862,1248
3405-000,2016,10,6,23,299,289,588,862
3405-000,2016,10,6,24,180,200,380,588
3405-000,2016,10,7,1,117,127,244,380
3405-000,2016,10,7,2,71,84,155,244
3405-000,2016,10,7,3,62,56,118,155
3405-000,2016,10,7,4,62,84,146,118
3405-000,2016,10,7,5,122,107,229,146
3405-000,2016,10,7,6,251,228,479,229
3405-000,2016,10,7,7,602,529,1131,479
3405-000,2016,10,7,8,1154,1388,2542,1131
3405-000,2016,10,7,9,1399,1343,2742,2542
3405-000,2016,10,7,10,1156,1033,2189,2742
3405-000,2016,10,7,11,1186,979,2165,2189
3405-000,2016,10,7,12,1240,952,2192,2165
3405-000,2016,10,7,13,1044,867,1911,2192
3405-000,2016,10,7,14,1118,980,2098,1911
3405-000,2016,10,7,15,1305,1056,2361,2098
3405-000,2016,10,7,16,1290,1107,2397,2361
3405-000,2016,10,7,17,1342,1145,2487,2397
3405-000,2016,10,7,18,1519,1165,2684,2487
3405-000,2016,10,7,19,1606,1252,2858,2684
3405-000,2016,10,7,20,1197,938,2135,2858
3405-000,2016,10,7,21,838,732,1570,2135
3405-000,2016,10,7,22,502,446,948,1570
3405-000,2016,10,7,23,332,271,603,948
3405-000,2016,10,7,24,198,179,377,603
3405-000,2016,10,8,1,108,100,208,377
3405-000,2016,10,8,2,73,87,160,208
3405-000,2016,10,8,3,60,72,132,160
3405-000,2016,10,8,4,55,80,135,132
3405-000,2016,10,8,5,90,104,194,135
3405-000,2016,10,8,6,188,178,366,194
3405-000,2016,10,8,7,367,317,684,366
3405-000,2016,10,8,8,736,582,1318,684
3405-000,2016,10,8,9,964,814,1778,1318
3405-000,2016,10,8,10,968,718,1686,1778
3405-000,2016,10,8,11,1085,824,1909,1686
3405-000,2016,10,8,12,1135,781,1916,1909
3405-000,2016,10,8,13,918,856,1774,1916
3405-000,2016,10,8,14,923,779,1702,1774
3405-000,2016,10,8,15,959,746,1705,1702
3405-000,2016,10,8,16,1082,741,1823,1705
3405-000,2016,10,8,17,1089,771,1860,1823
3405-000,2016,10,8,18,1262,983,2245,1860
3405-000,2016,10,8,19,1077,741,1818,2245
3405-000,2016,10,8,20,700,602,1302,1818
3405-000,2016,10,8,21,431,434,865,1302
3405-000,2016,10,8,22,299,315,614,865
3405-000,2016,10,8,23,224,226,450,614
3405-000,2016,10,8,24,143,174,317,450
3405-000,2016,10,9,1,104,121,225,317
3405-000,2016,10,9,2,72,65,137,225
3405-000,2016,10,9,3,43,33,76,137
3405-000,2016,10,9,4,40,45,85,76
3405-000,2016,10,9,5,63,38,101,85
3405-000,2016,10,9,6,126,77,203,101
3405-000,2016,10,9,7,262,207,469,203
3405-000,2016,10,9,8,400,345,745,469
3405-000,2016,10,9,9,546,387,933,745
3405-000,2016,10,9,10,590,424,1014,933
3405-000,2016,10,9,11,741,505,1246,1014
3405-000,2016,10,9,12,697,507,1204,1246
3405-000,2016,10,9,13,542,490,1032,1204
3405-000,2016,10,9,14,604,527,1131,1032
3405-000,2016,10,9,15,720,613,1333,1131
3405-000,2016,10,9,16,789,634,1423,1333
3405-000,2016,10,9,17,834,708,1542,1423
3405-000,2016,10,9,18,935,746,1681,1542
3405-000,2016,10,9,19,827,693,1520,1681
3405-000,2016,10,9,20,609,543,1152,1520
3405-000,2016,10,9,21,513,508,1021,1152
3405-000,2016,10,9,22,316,398,714,1021
3405-000,2016,10,9,23,199,322,521,714
3405-000,2016,10,9,24,141,181,322,521
3405-000,2016,10,10,1,68,124,192,322
3405-000,2016,10,10,2,43,56,99,192
3405-000,2016,10,10,3,37,54,91,99
3405-000,2016,10,10,4,35,71,106,91
3405-000,2016,10,10,5,107,110,217,106
3405-000,2016,10,10,6,283,247,530,217
3405-000,2016,10,10,7,626,672,1298,530
3405-000,2016,10,10,8,1206,1616,2822,1298
3405-000,2016,10,10,9,1403,1363,2766,2822
3405-000,2016,10,10,10,1116,970,2086,2766
3405-000,2016,10,10,11,1363,938,2301,2086
3405-000,2016,10,10,12,1207,981,2188,2301
3405-000,2016,10,10,13,962,909,1871,2188
3405-000,2016,10,10,14,1064,1046,2110,1871
3405-000,2016,10,10,15,1201,1044,2245,2110
3405-000,2016,10,10,16,1192,1091,2283,2245
3405-000,2016,10,10,17,1204,1020,2224,2283
3405-000,2016,10,10,18,1413,1023,2436,2224
3405-000,2016,10,10,19,1190,953,2143,2436
3405-000,2016,10,10,20,848,705,1553,2143
3405-000,2016,10,10,21,612,612,1224,1553
3405-000,2016,10,10,22,419,423,842,1224
3405-000,2016,10,10,23,274,259,533,842
3405-000,2016,10,10,24,142,167,309,533
3405-000,2016,10,11,1,102,91,193,309
3405-000,2016,10,11,2,46,83,129,193
3405-000,2016,10,11,3,59,65,124,129
3405-000,2016,10,11,4,88,86,174,124
3405-000,2016,10,11,5,107,89,196,174
3405-000,2016,10,11,6,231,212,443,196
3405-000,2016,10,11,7,562,519,1081,443
3405-000,2016,10,11,8,1167,1350,2517,1081
3405-000,2016,10,11,9,1292,1296,2588,2517
3405-000,2016,10,11,10,1181,1005,2186,2588
3405-000,2016,10,11,11,1205,1021,2226,2186
3405-000,2016,10,11,12,1119,954,2073,2226
3405-000,2016,10,11,13,992,879,1871,2073
3405-000,2016,10,11,14,1085,1004,2089,1871
3405-000,2016,10,11,15,1221,1048,2269,2089
3405-000,2016,10,11,16,1287,977,2264,2269
3405-000,2016,10,11,17,1193,1040,2233,2264
3405-000,2016,10,11,18,1374,1091,2465,2233
3405-000,2016,10,11,19,1167,990,2157,2465
3405-000,2016,10,11,20,853,667,1520,2157
3405-000,2016,10,11,21,641,612,1253,1520
3405-000,2016,10,11,22,443,426,869,1253
3405-000,2016,10,11,23,287,267,554,869
3405-000,2016,10,11,24,149,194,343,554
3405-000,2016,10,12,1,99,102,201,343
3405-000,2016,10,12,2,65,74,139,201
3405-000,2016,10,12,3,60,68,128,139
3405-000,2016,10,12,4,75,87,162,128
3405-000,2016,10,12,5,115,93,208,162
3405-000,2016,10,12,6,268,198,466,208
3405-000,2016,10,12,7,596,533,1129,466
3405-000,2016,10,12,8,1126,1306,2432,1129
3405-000,2016,10,12,9,1364,1317,2681,2432
3405-000,2016,10,12,10,1188,1015,2203,2681
3405-000,2016,10,12,11,1192,994,2186,2203
3405-000,2016,10,12,12,1102,987,2089,2186
3405-000,2016,10,12,13,1012,872,1884,2089
3405-000,2016,10,12,14,1061,973,2034,1884
3405-000,2016,10,12,15,1253,1098,2351,2034
3405-000,2016,10,12,16,1240,965,2205,2351
3405-000,2016,10,12,17,1326,1012,2338,2205
3405-000,2016,10,12,18,1510,1057,2567,2338
3405-000,2016,10,12,19,1258,1084,2342,2567
3405-000,2016,10,12,20,885,692,1577,2342
3405-000,2016,10,12,21,562,548,1110,1577
3405-000,2016,10,12,22,427,403,830,1110
3405-000,2016,10,12,23,313,237,550,830
3405-000,2016,10,12,24,141,201,342,550
3405-000,2016,10,13,1,100,109,209,342
3405-000,2016,10,13,2,53,79,132,209
3405-000,2016,10,13,3,88,74,162,132
3405-000,2016,10,13,4,92,71,163,162
3405-000,2016,10,13,5,106,105,211,163
3405-000,2016,10,13,6,256,217,473,211
3405-000,2016,10,13,7,595,509,1104,473
3405-000,2016,10,13,8,1135,1373,2508,1104
3405-000,2016,10,13,9,1421,1415,2836,2508
3405-000,2016,10,13,10,1309,997,2306,2836
3405-000,2016,10,13,11,1297,1003,2300,2306
3405-000,2016,10,13,12,1111,996,2107,2300
3405-000,2016,10,13,13,1036,895,1931,2107
3405-000,2016,10,13,14,1094,1043,2137,1931
3405-000,2016,10,13,15,1235,1057,2292,2137
3405-000,2016,10,13,16,1308,1044,2352,2292
3405-000,2016,10,13,17,1215,1080,2295,2352
3405-000,2016,10,13,18,1373,973,2346,2295
3405-000,2016,10,13,19,1287,1035,2322,2346
3405-000,2016,10,13,20,852,659,1511,2322
3405-000,2016,10,13,21,611,591,1202,1511
3405-000,2016,10,13,22,439,405,844,1202
3405-000,2016,10,13,23,290,241,531,844
3405-000,2016,10,13,24,158,174,332,531
3405-000,2016,10,14,1,112,106,218,332
3405-000,2016,10,14,2,51,61,112,218
3405-000,2016,10,14,3,68,68,136,112
3405-000,2016,10,14,4,67,76,143,136
3405-000,2016,10,14,5,120,113,233,143
3405-000,2016,10,14,6,272,210,482,233
3405-000,2016,10,14,7,626,490,1116,482
3405-000,2016,10,14,8,1136,1364,2500,1116
3405-000,2016,10,14,9,1387,1303,2690,2500
3405-000,2016,10,14,10,1243,1037,2280,2690
3405-000,2016,10,14,11,1271,1093,2364,2280
3405-000,2016,10,14,12,1256,1020,2276,2364
3405-000,2016,10,14,13,1103,905,2008,2276
3405-000,2016,10,14,14,1224,1079,2303,2008
3405-000,2016,10,14,15,1291,1125,2416,2303
3405-000,2016,10,14,16,1345,1063,2408,2416
3405-000,2016,10,14,17,1345,1060,2405,2408
3405-000,2016,10,14,18,1509,1222,2731,2405
3405-000,2016,10,14,19,1593,1218,2811,2731
3405-000,2016,10,14,20,1141,840,1981,2811
3405-000,2016,10,14,21,901,624,1525,1981
3405-000,2016,10,14,22,611,412,1023,1525
3405-000,2016,10,14,23,352,256,608,1023
3405-000,2016,10,14,24,193,210,403,608
3405-000,2016,10,15,1,120,115,235,403
3405-000,2016,10,15,2,81,74,155,235
3405-000,2016,10,15,3,78,63,141,155
3405-000,2016,10,15,4,68,87,155,141
3405-000,2016,10,15,5,133,106,239,155
3405-000,2016,10,15,6,197,166,363,239
3405-000,2016,10,15,7,515,397,912,363
3405-000,2016,10,15,8,857,695,1552,912
3405-000,2016,10,15,9,1001,729,1730,1552
3405-000,2016,10,15,10,1092,831,1923,1730
3405-000,2016,10,15,11,1192,890,2082,1923
3405-000,2016,10,15,12,1505,867,2372,2082
3405-000,2016,10,15,13,964,896,1860,2372
3405-000,2016,10,15,14,1099,864,1963,1860
3405-000,2016,10,15,15,1054,837,1891,1963
3405-000,2016,10,15,16,1007,896,1903,1891
3405-000,2016,10,15,17,1002,891,1893,1903
3405-000,2016,10,15,18,1199,1024,2223,1893
3405-000,2016,10,15,19,1041,856,1897,2223
3405-000,2016,10,15,20,730,662,1392,1897
3405-000,2016,10,15,21,500,537,1037,1392
3405-000,2016,10,15,22,374,326,700,1037
3405-000,2016,10,15,23,213,208,421,700
3405-000,2016,10,15,24,155,160,315,421
3405-000,2016,10,16,1,96,98,194,315
3405-000,2016,10,16,2,52,69,121,194
3405-000,2016,10,16,3,34,50,84,121
3405-000,2016,10,16,4,35,39,74,84
3405-000,2016,10,16,5,50,44,94,74
3405-000,2016,10,16,6,113,79,192,94
3405-000,2016,10,16,7,262,179,441,192
3405-000,2016,10,16,8,359,310,669,441
3405-000,2016,10,16,9,517,364,881,669
3405-000,2016,10,16,10,560,391,951,881
3405-000,2016,10,16,11,626,484,1110,951
3405-000,2016,10,16,12,602,529,1131,1110
3405-000,2016,10,16,13,634,571,1205,1131
3405-000,2016,10,16,14,642,570,1212,1205
3405-000,2016,10,16,15,748,586,1334,1212
3405-000,2016,10,16,16,867,649,1516,1334
3405-000,2016,10,16,17,885,662,1547,1516
3405-000,2016,10,16,18,813,671,1484,1547
3405-000,2016,10,16,19,750,644,1394,1484
3405-000,2016,10,16,20,569,569,1138,1394
3405-000,2016,10,16,21,401,514,915,1138
3405-000,2016,10,16,22,306,361,667,915
3405-000,2016,10,16,23,219,297,516,667
3405-000,2016,10,16,24,144,187,331,516
3405-000,2016,10,17,1,63,109,172,331
3405-000,2016,10,17,2,56,55,111,172
3405-000,2016,10,17,3,33,46,79,111
3405-000,2016,10,17,4,47,75,122,79
3405-000,2016,10,17,5,112,106,218,122
3405-000,2016,10,17,6,298,250,548,218
3405-000,2016,10,17,7,661,648,1309,548
3405-000,2016,10,17,8,1182,1561,2743,1309
3405-000,2016,10,17,9,1355,1449,2804,2743
3405-000,2016,10,17,10,1096,931,2027,2804
3405-000,2016,10,17,11,1131,929,2060,2027
3405-000,2016,10,17,12,1039,903,1942,2060
3405-000,2016,10,17,13,945,842,1787,1942
3405-000,2016,10,17,14,1079,999,2078,1787
3405-000,2016,10,17,15,1215,1031,2246,2078
3405-000,2016,10,17,16,1165,976,2141,2246
3405-000,2016,10,17,17,1167,1054,2221,2141
3405-000,2016,10,17,18,1251,1056,2307,2221
3405-000,2016,10,17,19,1239,984,2223,2307
3405-000,2016,10,17,20,791,646,1437,2223
3405-000,2016,10,17,21,654,603,1257,1437
3405-000,2016,10,17,22,444,405,849,1257
3405-000,2016,10,17,23,287,233,520,849
3405-000,2016,10,17,24,140,184,324,520
3405-000,2016,10,18,1,114,124,238,324
3405-000,2016,10,18,2,52,66,118,238
3405-000,2016,10,18,3,60,70,130,118
3405-000,2016,10,18,4,71,92,163,130
3405-000,2016,10,18,5,124,104,228,163
3405-000,2016,10,18,6,266,234,500,228
3405-000,2016,10,18,7,560,491,1051,500
3405-000,2016,10,18,8,1109,1345,2454,1051
3405-000,2016,10,18,9,1400,1369,2769,2454
3405-000,2016,10,18,10,1246,1060,2306,2769
3405-000,2016,10,18,11,1267,1057,2324,2306
3405-000,2016,10,18,12,1185,944,2129,2324
3405-000,2016,10,18,13,972,871,1843,2129
3405-000,2016,10,18,14,1089,1017,2106,1843
3405-000,2016,10,18,15,1257,1043,2300,2106
3405-000,2016,10,18,16,1209,1046,2255,2300
3405-000,2016,10,18,17,1262,996,2258,2255
3405-000,2016,10,18,18,1272,1117,2389,2258
3405-000,2016,10,18,19,1252,1054,2306,2389
3405-000,2016,10,18,20,831,683,1514,2306
3405-000,2016,10,18,21,690,625,1315,1514
3405-000,2016,10,18,22,450,439,889,1315
3405-000,2016,10,18,23,282,260,542,889
3405-000,2016,10,18,24,170,175,345,542
3405-000,2016,10,19,1,109,95,204,345
3405-000,2016,10,19,2,56,63,119,204
3405-000,2016,10,19,3,53,72,125,119
3405-000,2016,10,19,4,74,80,154,125
3405-000,2016,10,19,5,109,95,204,154
3405-000,2016,10,19,6,256,215,471,204
3405-000,2016,10,19,7,564,507,1071,471
3405-000,2016,10,19,8,1063,1345,2408,1071
3405-000,2016,10,19,9,1385,1343,2728,2408
3405-000,2016,10,19,10,1178,1026,2204,2728
3405-000,2016,10,19,11,1228,1155,2383,2204
3405-000,2016,10,19,12,1175,945,2120,2383
3405-000,2016,10,19,13,999,792,1791,2120
3405-000,2016,10,19,14,1085,1059,2144,1791
3405-000,2016,10,19,15,1244,1067,2311,2144
3405-000,2016,10,19,16,1224,1060,2284,2311
3405-000,2016,10,19,17,1276,1016,2292,2284
3405-000,2016,10,19,18,1417,1089,2506,2292
3405-000,2016,10,19,19,1376,1066,2442,2506
3405-000,2016,10,19,20,875,726,1601,2442
3405-000,2016,10,19,21,583,540,1123,1601
3405-000,2016,10,19,22,426,425,851,1123
3405-000,2016,10,19,23,287,233,520,851
3405-000,2016,10,19,24,153,188,341,520
3405-000,2016,10,20,1,124,120,244,341
3405-000,2016,10,20,2,69,77,146,244
3405-000,2016,10,20,3,62,65,127,146
3405-000,2016,10,20,4,75,76,151,127
3405-000,2016,10,20,5,143,106,249,151
3405-000,2016,10,20,6,254,204,458,249
3405-000,2016,10,20,7,568,511,1079,458
3405-000,2016,10,20,8,1081,1388,2469,1079
3405-000,2016,10,20,9,1402,1405,2807,2469
3405-000,2016,10,20,10,1185,1023,2208,2807
3405-000,2016,10,20,11,1254,973,2227,2208
3405-000,2016,10,20,12,1177,970,2147,2227
3405-000,2016,10,20,13,1029,826,1855,2147
3405-000,2016,10,20,14,1068,1008,2076,1855
3405-000,2016,10,20,15,1270,1138,2408,2076
3405-000,2016,10,20,16,1327,1000,2327,2408
3405-000,2016,10,20,17,1277,936,2213,2327
3405-000,2016,10,20,18,1405,1057,2462,2213
3405-000,2016,10,20,19,1238,1018,2256,2462
3405-000,2016,10,20,20,810,706,1516,2256
3405-000,2016,10,20,21,683,580,1263,1516
3405-000,2016,10,20,22,432,444,876,1263
3405-000,2016,10,20,23,301,282,583,876
3405-000,2016,10,20,24,182,179,361,583
3405-000,2016,10,21,1,117,127,244,361
3405-000,2016,10,21,2,68,88,156,244
3405-000,2016,10,21,3,53,56,109,156
3405-000,2016,10,21,4,78,90,168,109
3405-000,2016,10,21,5,136,107,243,168
3405-000,2016,10,21,6,246,227,473,243
3405-000,2016,10,21,7,580,454,1034,473
3405-000,2016,10,21,8,1069,1339,2408,1034
3405-000,2016,10,21,9,1409,1320,2729,2408
3405-000,2016,10,21,10,1268,976,2244,2729
3405-000,2016,10,21,11,1280,1000,2280,2244
3405-000,2016,10,21,12,1200,1006,2206,2280
3405-000,2016,10,21,13,1109,918,2027,2206
3405-000,2016,10,21,14,1091,1040,2131,2027
3405-000,2016,10,21,15,1301,1066,2367,2131
3405-000,2016,10,21,16,1353,1038,2391,2367
3405-000,2016,10,21,17,1306,1056,2362,2391
3405-000,2016,10,21,18,1529,1227,2756,2362
3405-000,2016,10,21,19,1672,1243,2915,2756
3405-000,2016,10,21,20,1306,883,2189,2915
3405-000,2016,10,21,21,757,596,1353,2189
3405-000,2016,10,21,22,508,428,936,1353
3405-000,2016,10,21,23,337,277,614,936
3405-000,2016,10,21,24,188,187,375,614
3405-000,2016,10,22,1,122,106,228,375
3405-000,2016,10,22,2,90,73,163,228
3405-000,2016,10,22,3,60,74,134,163
3405-000,2016,10,22,4,85,69,154,134
3405-000,2016,10,22,5,132,102,234,154
3405-000,2016,10,22,6,267,187,454,234
3405-000,2016,10,22,7,497,404,901,454
3405-000,2016,10,22,8,774,717,1491,901
3405-000,2016,10,22,9,1126,818,1944,1491
3405-000,2016,10,22,10,1047,817,1864,1944
3405-000,2016,10,22,11,1120,796,1916,1864
3405-000,2016,10,22,12,1128,793,1921,1916
3405-000,2016,10,22,13,1006,818,1824,1921
3405-000,2016,10,22,14,994,835,1829,1824
3405-000,2016,10,22,15,1004,776,1780,1829
3405-000,2016,10,22,16,959,787,1746,1780
3405-000,2016,10,22,17,932,848,1780,1746
3405-000,2016,10,22,18,1236,982,2218,1780
3405-000,2016,10,22,19,1035,786,1821,2218
3405-000,2016,10,22,20,676,589,1265,1821
3405-000,2016,10,22,21,465,442,907,1265
3405-000,2016,10,22,22,334,292,626,907
3405-000,2016,10,22,23,270,228,498,626
3405-000,2016,10,22,24,125,155,280,498
3405-000,2016,10,23,1,109,84,193,280
3405-000,2016,10,23,2,76,67,143,193
3405-000,2016,10,23,3,50,36,86,143
3405-000,2016,10,23,4,28,42,70,86
3405-000,2016,10,23,5,67,45,112,70
3405-000,2016,10,23,6,119,85,204,112
3405-000,2016,10,23,7,268,187,455,204
3405-000,2016,10,23,8,415,292,707,455
3405-000,2016,10,23,9,499,390,889,707
3405-000,2016,10,23,10,595,414,1009,889
3405-000,2016,10,23,11,662,491,1153,1009
3405-000,2016,10,23,12,635,503,1138,1153
3405-000,2016,10,23,13,624,458,1082,1138
3405-000,2016,10,23,14,646,539,1185,1082
3405-000,2016,10,23,15,672,651,1323,1185
3405-000,2016,10,23,16,846,627,1473,1323
3405-000,2016,10,23,17,934,630,1564,1473
3405-000,2016,10,23,18,909,683,1592,1564
3405-000,2016,10,23,19,813,659,1472,1592
3405-000,2016,10,23,20,627,592,1219,1472
3405-000,2016,10,23,21,497,560,1057,1219
3405-000,2016,10,23,22,357,493,850,1057
3405-000,2016,10,23,23,213,429,642,850
3405-000,2016,10,23,24,143,178,321,642
3405-000,2016,10,24,1,68,111,179,321
3405-000,2016,10,24,2,61,77,138,179
3405-000,2016,10,24,3,50,57,107,138
3405-000,2016,10,24,4,65,89,154,107
3405-000,2016,10,24,5,117,114,231,154
3405-000,2016,10,24,6,285,271,556,231
3405-000,2016,10,24,7,651,649,1300,556
3405-000,2016,10,24,8,1259,1642,2901,1300
3405-000,2016,10,24,9,1385,1494,2879,2901
3405-000,2016,10,24,10,1122,991,2113,2879
3405-000,2016,10,24,11,1198,890,2088,2113
3405-000,2016,10,24,12,1185,949,2134,2088
3405-000,2016,10,24,13,996,955,1951,2134
3405-000,2016,10,24,14,1048,983,2031,1951
3405-000,2016,10,24,15,1210,1093,2303,2031
3405-000,2016,10,24,16,1296,1091,2387,2303
3405-000,2016,10,24,17,1256,1028,2284,2387
3405-000,2016,10,24,18,1366,1086,2452,2284
3405-000,2016,10,24,19,1309,1024,2333,2452
3405-000,2016,10,24,20,874,712,1586,2333
3405-000,2016,10,24,21,630,618,1248,1586
3405-000,2016,10,24,22,451,460,911,1248
3405-000,2016,10,24,23,309,266,575,911
3405-000,2016,10,24,24,164,192,356,575
3405-000,2016,10,25,1,97,105,202,356
3405-000,2016,10,25,2,68,91,159,202
3405-000,2016,10,25,3,56,55,111,159
3405-000,2016,10,25,4,70,93,163,111
3405-000,2016,10,25,5,107,96,203,163
3405-000,2016,10,25,6,225,209,434,203
3405-000,2016,10,25,7,482,424,906,434
3405-000,2016,10,25,8,992,1130,2122,906
3405-000,2016,10,25,9,1346,1294,2640,2122
3405-000,2016,10,25,10,1070,1008,2078,2640
3405-000,2016,10,25,11,1081,974,2055,2078
3405-000,2016,10,25,12,1118,909,2027,2055
3405-000,2016,10,25,13,963,802,1765,2027
3405-000,2016,10,25,14,1081,956,2037,1765
3405-000,2016,10,25,15,1234,1080,2314,2037
3405-000,2016,10,25,16,1197,940,2137,2314
3405-000,2016,10,25,17,1182,932,2114,2137
3405-000,2016,10,25,18,1237,996,2233,2114
3405-000,2016,10,25,19,1172,990,2162,2233
3405-000,2016,10,25,20,757,652,1409,2162
3405-000,2016,10,25,21,607,577,1184,1409
3405-000,2016,10,25,22,461,399,860,1184
3405-000,2016,10,25,23,299,243,542,860
3405-000,2016,10,25,24,168,171,339,542
3405-000,2016,10,26,1,87,92,179,339
3405-000,2016,10,26,2,64,82,146,179
3405-000,2016,10,26,3,65,70,135,146
3405-000,2016,10,26,4,66,76,142,135
3405-000,2016,10,26,5,123,91,214,142
3405-000,2016,10,26,6,275,228,503,214
3405-000,2016,10,26,7,499,498,997,503
3405-000,2016,10,26,8,1051,1309,2360,997
3405-000,2016,10,26,9,1350,1332,2682,2360
3405-000,2016,10,26,10,1160,1014,2174,2682
3405-000,2016,10,26,11,1239,1010,2249,2174
3405-000,2016,10,26,12,1151,1005,2156,2249
3405-000,2016,10,26,13,1012,869,1881,2156
3405-000,2016,10,26,14,1080,1018,2098,1881
3405-000,2016,10,26,15,1301,1123,2424,2098
3405-000,2016,10,26,16,1311,1039,2350,2424
3405-000,2016,10,26,17,1216,1069,2285,2350
3405-000,2016,10,26,18,1319,1152,2471,2285
3405-000,2016,10,26,19,1319,977,2296,2471
3405-000,2016,10,26,20,834,650,1484,2296
3405-000,2016,10,26,21,563,531,1094,1484
3405-000,2016,10,26,22,459,389,848,1094
3405-000,2016,10,26,23,303,272,575,848
3405-000,2016,10,26,24,184,177,361,575
3405-000,2016,10,27,1,95,109,204,361
3405-000,2016,10,27,2,62,70,132,204
3405-000,2016,10,27,3,62,71,133,132
3405-000,2016,10,27,4,83,70,153,133
3405-000,2016,10,27,5,113,123,236,153
3405-000,2016,10,27,6,248,199,447,236
3405-000,2016,10,27,7,529,515,1044,447
3405-000,2016,10,27,8,1082,1318,2400,1044
3405-000,2016,10,27,9,1382,1300,2682,2400
3405-000,2016,10,27,10,1145,1012,2157,2682
3405-000,2016,10,27,11,1170,1087,2257,2157
3405-000,2016,10,27,12,1158,940,2098,2257
3405-000,2016,10,27,13,1000,828,1828,2098
3405-000,2016,10,27,14,1081,1030,2111,1828
3405-000,2016,10,27,15,1259,1023,2282,2111
3405-000,2016,10,27,16,1241,1015,2256,2282
3405-000,2016,10,27,17,1264,1008,2272,2256
3405-000,2016,10,27,18,1267,1146,2413,2272
3405-000,2016,10,27,19,1238,1025,2263,2413
3405-000,2016,10,27,20,839,698,1537,2263
3405-000,2016,10,27,21,717,587,1304,1537
3405-000,2016,10,27,22,444,432,876,1304
3405-000,2016,10,27,23,311,272,583,876
3405-000,2016,10,27,24,191,213,404,583
3405-000,2016,10,28,1,101,120,221,404
3405-000,2016,10,28,2,84,96,180,221
3405-000,2016,10,28,3,73,74,147,180
3405-000,2016,10,28,4,79,89,168,147
3405-000,2016,10,28,5,127,99,226,168
3405-000,2016,10,28,6,223,201,424,226
3405-000,2016,10,28,7,519,414,933,424
3405-000,2016,10,28,8,1028,1193,2221,933
3405-000,2016,10,28,9,1397,1373,2770,2221
3405-000,2016,10,28,10,1145,1013,2158,2770
3405-000,2016,10,28,11,1229,963,2192,2158
3405-000,2016,10,28,12,1123,965,2088,2192
3405-000,2016,10,28,13,995,846,1841,2088
3405-000,2016,10,28,14,1086,949,2035,1841
3405-000,2016,10,28,15,1258,977,2235,2035
3405-000,2016,10,28,16,1300,1061,2361,2235
3405-000,2016,10,28,17,1286,912,2198,2361
3405-000,2016,10,28,18,1559,1070,2629,2198
3405-000,2016,10,28,19,1619,1163,2782,2629
3405-000,2016,10,28,20,1079,827,1906,2782
3405-000,2016,10,28,21,871,655,1526,1906
3405-000,2016,10,28,22,606,439,1045,1526
3405-000,2016,10,28,23,309,303,612,1045
3405-000,2016,10,28,24,204,181,385,612
3405-000,2016,10,29,1,118,137,255,385
3405-000,2016,10,29,2,96,72,168,255
3405-000,2016,10,29,3,73,57,130,168
3405-000,2016,10,29,4,69,79,148,130
3405-000,2016,10,29,5,113,96,209,148
3405-000,2016,10,29,6,223,175,398,209
3405-000,2016,10,29,7,503,373,876,398
3405-000,2016,10,29,8,761,714,1475,876
3405-000,2016,10,29,9,1127,782,1909,1475
3405-000,2016,10,29,10,1074,787,1861,1909
3405-000,2016,10,29,11,1077,897,1974,1861
3405-000,2016,10,29,12,1178,928,2106,1974
3405-000,2016,10,29,13,1102,850,1952,2106
3405-000,2016,10,29,14,936,881,1817,1952
3405-000,2016,10,29,15,993,982,1975,1817
3405-000,2016,10,29,16,993,779,1772,1975
3405-000,2016,10,29,17,982,815,1797,1772
3405-000,2016,10,29,18,1146,1008,2154,1797
3405-000,2016,10,29,19,1048,843,1891,2154
3405-000,2016,10,29,20,619,699,1318,1891
3405-000,2016,10,29,21,417,383,800,1318
3405-000,2016,10,29,22,345,339,684,800
3405-000,2016,10,29,23,202,212,414,684
3405-000,2016,10,29,24,135,175,310,414
3405-000,2016,10,30,1,78,88,166,310
3405-000,2016,10,30,2,46,60,106,166
3405-000,2016,10,30,3,35,39,74,106
3405-000,2016,10,30,4,45,36,81,74
3405-000,2016,10,30,5,57,59,116,81
3405-000,2016,10,30,6,110,68,178,116
3405-000,2016,10,30,7,249,172,421,178
3405-000,2016,10,30,8,350,306,656,421
3405-000,2016,10,30,9,495,351,846,656
3405-000,2016,10,30,10,519,376,895,846
3405-000,2016,10,30,11,659,498,1157,895
3405-000,2016,10,30,12,668,477,1145,1157
3405-000,2016,10,30,13,583,516,1099,1145
3405-000,2016,10,30,14,663,605,1268,1099
3405-000,2016,10,30,15,735,622,1357,1268
3405-000,2016,10,30,16,738,664,1402,1357
3405-000,2016,10,30,17,840,687,1527,1402
3405-000,2016,10,30,18,927,738,1665,1527
3405-000,2016,10,30,19,751,852,1603,1665
3405-000,2016,10,30,20,591,991,1582,1603
3405-000,2016,10,30,21,443,595,1038,1582
3405-000,2016,10,30,22,315,476,791,1038
3405-000,2016,10,30,23,231,338,569,791
3405-000,2016,10,30,24,132,202,334,569
3405-000,2016,10,31,1,79,114,193,334
3405-000,2016,10,31,2,61,83,144,193
3405-000,2016,10,31,3,48,57,105,144
3405-000,2016,10,31,4,51,71,122,105
3405-000,2016,10,31,5,100,100,200,122
3405-000,2016,10,31,6,259,256,515,200
3405-000,2016,10,31,7,639,602,1241,515
3405-000,2016,10,31,8,1151,1599,2750,1241
3405-000,2016,10,31,9,1400,1435,2835,2750
3405-000,2016,10,31,10,1054,918,1972,2835
3405-000,2016,10,31,11,1176,1014,2190,1972
3405-000,2016,10,31,12,1076,964,2040,2190
3405-000,2016,10,31,13,933,848,1781,2040
3405-000,2016,10,31,14,1081,953,2034,1781
3405-000,2016,10,31,15,1220,1038,2258,2034
3405-000,2016,10,31,16,1199,1030,2229,2258
3405-000,2016,10,31,17,1293,1019,2312,2229
3405-000,2016,10,31,18,1207,1084,2291,2312
3405-000,2016,10,31,19,1204,1037,2241,2291
3405-000,2016,10,31,20,802,632,1434,2241
3405-000,2016,10,31,21,678,589,1267,1434
3405-000,2016,10,31,22,424,390,814,1267
3405-000,2016,10,31,23,239,275,514,814
3405-000,2016,10,31,24,169,172,341,514
3405-000,2016,11,1,1,98,94,192,341
3405-000,2016,11,1,2,64,83,147,192
3405-000,2016,11,1,3,49,56,105,147
3405-000,2016,11,1,4,61,79,140,105
3405-000,2016,11,1,5,103,106,209,140
3405-000,2016,11,1,6,264,221,485,209
3405-000,2016,11,1,7,529,471,1000,485
3405-000,2016,11,1,8,1120,1305,2425,1000
3405-000,2016,11,1,9,1415,1316,2731,2425
3405-000,2016,11,1,10,1126,1073,2199,2731
3405-000,2016,11,1,11,1172,1035,2207,2199
3405-000,2016,11,1,12,1198,1033,2231,2207
3405-000,2016,11,1,13,953,865,1818,2231
3405-000,2016,11,1,14,1026,1072,2098,1818
3405-000,2016,11,1,15,1250,1016,2266,2098
3405-000,2016,11,1,16,1232,1004,2236,2266
3405-000,2016,11,1,17,1248,999,2247,2236
3405-000,2016,11,1,18,1394,1035,2429,2247
3405-000,2016,11,1,19,1178,1015,2193,2429
3405-000,2016,11,1,20,847,683,1530,2193
3405-000,2016,11,1,21,602,579,1181,1530
3405-000,2016,11,1,22,413,402,815,1181
3405-000,2016,11,1,23,289,257,546,815
3405-000,2016,11,1,24,182,174,356,546
3405-000,2016,11,2,1,96,116,212,356
3405-000,2016,11,2,2,80,71,151,212
3405-000,2016,11,2,3,62,69,131,151
3405-000,2016,11,2,4,73,86,159,131
3405-000,2016,11,2,5,107,98,205,159
3405-000,2016,11,2,6,243,212,455,205
3405-000,2016,11,2,7,533,483,1016,455
3405-000,2016,11,2,8,1092,1278,2370,1016
3405-000,2016,11,2,9,1440,1305,2745,2370
3405-000,2016,11,2,10,1176,998,2174,2745
3405-000,2016,11,2,11,1121,1097,2218,2174
3405-000,2016,11,2,12,1120,1030,2150,2218
3405-000,2016,11,2,13,1006,807,1813,2150
3405-000,2016,11,2,14,1125,961,2086,1813
3405-000,2016,11,2,15,1301,1052,2353,2086
3405-000,2016,11,2,16,1280,1058,2338,2353
3405-000,2016,11,2,17,1267,1039,2306,2338
3405-000,2016,11,2,18,1394,1108,2502,2306
3405-000,2016,11,2,19,1269,1061,2330,2502
3405-000,2016,11,2,20,828,624,1452,2330
3405-000,2016,11,2,21,583,539,1122,1452
3405-000,2016,11,2,22,444,372,816,1122
3405-000,2016,11,2,23,318,239,557,816
3405-000,2016,11,2,24,162,162,324,557
3405-000,2016,11,3,1,91,84,175,324
3405-000,2016,11,3,2,60,79,139,175
3405-000,2016,11,3,3,56,55,111,139
3405-000,2016,11,3,4,68,76,144,111
3405-000,2016,11,3,5,99,111,210,144
3405-000,2016,11,3,6,248,192,440,210
3405-000,2016,11,3,7,509,477,986,440
3405-000,2016,11,3,8,1078,1254,2332,986
3405-000,2016,11,3,9,1414,1345,2759,2332
3405-000,2016,11,3,10,1138,945,2083,2759
3405-000,2016,11,3,11,1181,1013,2194,2083
3405-000,2016,11,3,12,1188,934,2122,2194
3405-000,2016,11,3,13,963,882,1845,2122
3405-000,2016,11,3,14,1060,937,1997,1845
3405-000,2016,11,3,15,1254,894,2148,1997
3405-000,2016,11,3,16,1272,922,2194,2148
3405-000,2016,11,3,17,1253,992,2245,2194
3405-000,2016,11,3,18,1385,1086,2471,2245
3405-000,2016,11,3,19,1247,1046,2293,2471
3405-000,2016,11,3,20,735,716,1451,2293
3405-000,2016,11,3,21,656,571,1227,1451
3405-000,2016,11,3,22,430,426,856,1227
3405-000,2016,11,3,23,329,264,593,856
3405-000,2016,11,3,24,185,171,356,593
3405-000,2016,11,4,1,97,106,203,356
3405-000,2016,11,4,2,67,69,136,203
3405-000,2016,11,4,3,63,69,132,136
3405-000,2016,11,4,4,55,73,128,132
3405-000,2016,11,4,5,116,111,227,128
3405-000,2016,11,4,6,234,211,445,227
3405-000,2016,11,4,7,541,462,1003,445
3405-000,2016,11,4,8,1113,1272,2385,1003
3405-000,2016,11,4,9,1456,1253,2709,2385
3405-000,2016,11,4,10,1217,1040,2257,2709
3405-000,2016,11,4,11,1166,984,2150,2257
3405-000,2016,11,4,12,1221,937,2158,2150
3405-000,2016,11,4,13,1112,846,1958,2158
3405-000,2016,11,4,14,1108,940,2048,1958
3405-000,2016,11,4,15,1290,1052,2342,2048
3405-000,2016,11,4,16,1408,1087,2495,2342
3405-000,2016,11,4,17,1367,1061,2428,2495
3405-000,2016,11,4,18,1452,1197,2649,2428
3405-000,2016,11,4,19,1488,1150,2638,2649
3405-000,2016,11,4,20,1155,829,1984,2638
3405-000,2016,11,4,21,735,654,1389,1984
3405-000,2016,11,4,22,559,470,1029,1389
3405-000,2016,11,4,23,371,292,663,1029
3405-000,2016,11,4,24,184,185,369,663
3405-000,2016,11,5,1,136,109,245,369
3405-000,2016,11,5,2,88,83,171,245
3405-000,2016,11,5,3,69,60,129,171
3405-000,2016,11,5,4,68,100,168,129
3405-000,2016,11,5,5,111,109,220,168
3405-000,2016,11,5,6,234,183,417,220
3405-000,2016,11,5,7,472,350,822,417
3405-000,2016,11,5,8,824,670,1494,822
3405-000,2016,11,5,9,1103,810,1913,1494
3405-000,2016,11,5,10,1045,868,1913,1913
3405-000,2016,11,5,11,1158,944,2102,1913
3405-000,2016,11,5,12,1272,834,2106,2102
3405-000,2016,11,5,13,1098,802,1900,2106
3405-000,2016,11,5,14,980,789,1769,1900
3405-000,2016,11,5,15,1026,887,1913,1769
3405-000,2016,11,5,16,1027,876,1903,1913
3405-000,2016,11,5,17,960,997,1957,1903
3405-000,2016,11,5,18,1230,1103,2333,1957
3405-000,2016,11,5,19,1061,740,1801,2333
3405-000,2016,11,5,20,682,648,1330,1801
3405-000,2016,11,5,21,425,464,889,1330
3405-000,2016,11,5,22,350,342,692,889
3405-000,2016,11,5,23,241,233,474,692
3405-000,2016,11,5,24,150,162,312,474
3405-000,2016,11,6,1,101,104,205,312
3405-000,2016,11,6,2,55,52,107,205
3405-000,2016,11,6,3,69,40,109,107
3405-000,2016,11,6,4,32,37,69,109
3405-000,2016,11,6,5,46,41,87,69
3405-000,2016,11,6,6,116,75,191,87
3405-000,2016,11,6,7,235,187,422,191
3405-000,2016,11,6,8,356,303,659,422
3405-000,2016,11,6,9,584,370,954,659
3405-000,2016,11,6,10,634,426,1060,954
3405-000,2016,11,6,11,673,475,1148,1060
3405-000,2016,11,6,12,664,481,1145,1148
3405-000,2016,11,6,13,612,515,1127,1145
3405-000,2016,11,6,14,650,600,1250,1127
3405-000,2016,11,6,15,739,609,1348,1250
3405-000,2016,11,6,16,795,706,1501,1348
3405-000,2016,11,6,17,784,728,1512,1501
3405-000,2016,11,6,18,870,765,1635,1512
3405-000,2016,11,6,19,733,740,1473,1635
3405-000,2016,11,6,20,672,607,1279,1473
3405-000,2016,11,6,21,610,492,1102,1279
3405-000,2016,11,6,22,351,470,821,1102
3405-000,2016,11,6,23,251,425,676,821
3405-000,2016,11,6,24,162,204,366,676
3405-000,2016,11,7,1,78,104,182,366
3405-000,2016,11,7,2,53,67,120,182
3405-000,2016,11,7,3,45,53,98,120
3405-000,2016,11,7,4,46,72,118,98
3405-000,2016,11,7,5,102,108,210,118
3405-000,2016,11,7,6,268,273,541,210
3405-000,2016,11,7,7,598,608,1206,541
3405-000,2016,11,7,8,1151,1584,2735,1206
3405-000,2016,11,7,9,1406,1379,2785,2735
3405-000,2016,11,7,10,1137,1014,2151,2785
3405-000,2016,11,7,11,1200,1030,2230,2151
3405-000,2016,11,7,12,1156,1020,2176,2230
3405-000,2016,11,7,13,984,931,1915,2176
3405-000,2016,11,7,14,1059,1055,2114,1915
3405-000,2016,11,7,15,1209,1071,2280,2114
3405-000,2016,11,7,16,1194,1071,2265,2280
3405-000,2016,11,7,17,1159,1012,2171,2265
3405-000,2016,11,7,18,1309,1037,2346,2171
3405-000,2016,11,7,19,1191,950,2141,2346
3405-000,2016,11,7,20,770,674,1444,2141
3405-000,2016,11,7,21,588,584,1172,1444
3405-000,2016,11,7,22,434,465,899,1172
3405-000,2016,11,7,23,276,233,509,899
3405-000,2016,11,7,24,137,140,277,509
3405-000,2016,11,8,1,102,89,191,277
3405-000,2016,11,8,2,55,67,122,191
3405-000,2016,11,8,3,63,74,137,122
3405-000,2016,11,8,4,57,74,131,137
3405-000,2016,11,8,5,104,92,196,131
3405-000,2016,11,8,6,220,202,422,196
3405-000,2016,11,8,7,537,433,970,422
3405-000,2016,11,8,8,1038,1355,2393,970
3405-000,2016,11,8,9,1462,1371,2833,2393
3405-000,2016,11,8,10,1152,1049,2201,2833
3405-000,2016,11,8,11,1175,1017,2192,2201
3405-000,2016,11,8,12,1134,1089,2223,2192
3405-000,2016,11,8,13,955,865,1820,2223
3405-000,2016,11,8,14,1048,1009,2057,1820
3405-000,2016,11,8,15,1220,1045,2265,2057
3405-000,2016,11,8,16,1192,1003,2195,2265
3405-000,2016,11,8,17,1192,925,2117,2195
3405-000,2016,11,8,18,1384,1060,2444,2117
3405-000,2016,11,8,19,1261,1015,2276,2444
3405-000,2016,11,8,20,839,651,1490,2276
3405-000,2016,11,8,21,600,607,1207,1490
3405-000,2016,11,8,22,447,430,877,1207
3405-000,2016,11,8,23,281,237,518,877
3405-000,2016,11,8,24,150,195,345,518
3405-000,2016,11,9,1,112,113,225,345
3405-000,2016,11,9,2,57,80,137,225
3405-000,2016,11,9,3,76,60,136,137
3405-000,2016,11,9,4,53,82,135,136
3405-000,2016,11,9,5,130,96,226,135
3405-000,2016,11,9,6,235,208,443,226
3405-000,2016,11,9,7,502,477,979,443
3405-000,2016,11,9,8,1087,1273,2360,979
3405-000,2016,11,9,9,1406,1331,2737,2360
3405-000,2016,11,9,10,1164,1065,2229,2737
3405-000,2016,11,9,11,1268,1130,2398,2229
3405-000,2016,11,9,12,1130,950,2080,2398
3405-000,2016,11,9,13,948,879,1827,2080
3405-000,2016,11,9,14,988,993,1981,1827
3405-000,2016,11,9,15,1210,997,2207,1981
3405-000,2016,11,9,16,1284,1011,2295,2207
3405-000,2016,11,9,17,1310,1033,2343,2295
3405-000,2016,11,9,18,1464,1131,2595,2343
3405-000,2016,11,9,19,1174,1002,2176,2595
3405-000,2016,11,9,20,839,648,1487,2176
3405-000,2016,11,9,21,530,506,1036,1487
3405-000,2016,11,9,22,412,369,781,1036
3405-000,2016,11,9,23,322,256,578,781
3405-000,2016,11,9,24,165,168,333,578
3405-000,2016,11,10,1,96,102,198,333
3405-000,2016,11,10,2,67,69,136,198
3405-000,2016,11,10,3,63,60,123,136
3405-000,2016,11,10,4,65,74,139,123
3405-000,2016,11,10,5,127,118,245,139
3405-000,2016,11,10,6,260,223,483,245
3405-000,2016,11,10,7,570,495,1065,483
3405-000,2016,11,10,8,1106,1391,2497,1065
3405-000,2016,11,10,9,1426,1366,2792,2497
3405-000,2016,11,10,10,1194,1041,2235,2792
3405-000,2016,11,10,11,1210,1044,2254,2235
3405-000,2016,11,10,12,1164,947,2111,2254
3405-000,2016,11,10,13,952,889,1841,2111
3405-000,2016,11,10,14,1058,1026,2084,1841
3405-000,2016,11,10,15,1187,1079,2266,2084
3405-000,2016,11,10,16,1274,1058,2332,2266
3405-000,2016,11,10,17,1296,1016,2312,2332
3405-000,2016,11,10,18,1293,1032,2325,2312
3405-000,2016,11,10,19,1132,985,2117,2325
3405-000,2016,11,10,20,775,697,1472,2117
3405-000,2016,11,10,21,626,583,1209,1472
3405-000,2016,11,10,22,429,390,819,1209
3405-000,2016,11,10,23,293,242,535,819
3405-000,2016,11,10,24,173,157,330,535
3405-000,2016,11,11,1,109,113,222,330
3405-000,2016,11,11,2,74,86,160,222
3405-000,2016,11,11,3,56,65,121,160
3405-000,2016,11,11,4,67,78,145,121
3405-000,2016,11,11,5,98,111,209,145
3405-000,2016,11,11,6,244,211,455,209
3405-000,2016,11,11,7,519,451,970,455
3405-000,2016,11,11,8,1125,1310,2435,970
3405-000,2016,11,11,9,1424,1305,2729,2435
3405-000,2016,11,11,10,1203,1001,2204,2729
3405-000,2016,11,11,11,1138,999,2137,2204
3405-000,2016,11,11,12,1139,953,2092,2137
3405-000,2016,11,11,13,1014,920,1934,2092
3405-000,2016,11,11,14,1126,984,2110,1934
3405-000,2016,11,11,15,1290,1045,2335,2110
3405-000,2016,11,11,16,1322,1054,2376,2335
3405-000,2016,11,11,17,1319,1041,2360,2376
3405-000,2016,11,11,18,1502,1137,2639,2360
3405-000,2016,11,11,19,1558,1018,2576,2639
3405-000,2016,11,11,20,1069,835,1904,2576
3405-000,2016,11,11,21,713,620,1333,1904
3405-000,2016,11,11,22,539,418,957,1333
3405-000,2016,11,11,23,356,284,640,957
3405-000,2016,11,11,24,228,198,426,640
3405-000,2016,11,12,1,124,145,269,426
3405-000,2016,11,12,2,95,72,167,269
3405-000,2016,11,12,3,55,64,119,167
3405-000,2016,11,12,4,60,87,147,119
3405-000,2016,11,12,5,114,84,198,147
3405-000,2016,11,12,6,261,192,453,198
3405-000,2016,11,12,7,440,342,782,453
3405-000,2016,11,12,8,803,672,1475,782
3405-000,2016,11,12,9,958,782,1740,1475
3405-000,2016,11,12,10,969,807,1776,1740
3405-000,2016,11,12,11,1051,888,1939,1776
3405-000,2016,11,12,12,884,1060,1944,1939
3405-000,2016,11,12,13,814,796,1610,1944
3405-000,2016,11,12,14,885,801,1686,1610
3405-000,2016,11,12,15,1016,798,1814,1686
3405-000,2016,11,12,16,1055,881,1936,1814
3405-000,2016,11,12,17,1050,788,1838,1936
3405-000,2016,11,12,18,1183,923,2106,1838
3405-000,2016,11,12,19,1046,787,1833,2106
3405-000,2016,11,12,20,660,592,1252,1833
3405-000,2016,11,12,21,423,460,883,1252
3405-000,2016,11,12,22,336,303,639,883
3405-000,2016,11,12,23,231,207,438,639
3405-000,2016,11,12,24,140,149,289,438
3405-000,2016,11,13,1,90,86,176,289
3405-000,2016,11,13,2,64,54,118,176
3405-000,2016,11,13,3,44,46,90,118
3405-000,2016,11,13,4,50,38,88,90
3405-000,2016,11,13,5,56,50,106,88
3405-000,2016,11,13,6,132,99,231,106
3405-000,2016,11,13,7,276,177,453,231
3405-000,2016,11,13,8,379,313,692,453
3405-000,2016,11,13,9,540,387,927,692
3405-000,2016,11,13,10,594,425,1019,927
3405-000,2016,11,13,11,633,503,1136,1019
3405-000,2016,11,13,12,623,499,1122,1136
3405-000,2016,11,13,13,674,474,1148,1122
3405-000,2016,11,13,14,669,570,1239,1148
3405-000,2016,11,13,15,828,687,1515,1239
3405-000,2016,11,13,16,834,730,1564,1515
3405-000,2016,11,13,17,1000,748,1748,1564
3405-000,2016,11,13,18,966,813,1779,1748
3405-000,2016,11,13,19,732,699,1431,1779
3405-000,2016,11,13,20,685,633,1318,1431
3405-000,2016,11,13,21,524,491,1015,1318
3405-000,2016,11,13,22,360,599,959,1015
3405-000,2016,11,13,23,238,412,650,959
3405-000,2016,11,13,24,133,195,328,650
3405-000,2016,11,14,1,70,105,175,328
3405-000,2016,11,14,2,57,72,129,175
3405-000,2016,11,14,3,52,79,131,129
3405-000,2016,11,14,4,40,70,110,131
3405-000,2016,11,14,5,98,122,220,110
3405-000,2016,11,14,6,281,257,538,220
3405-000,2016,11,14,7,659,706,1365,538
3405-000,2016,11,14,8,1245,1637,2882,1365
3405-000,2016,11,14,9,1404,1410,2814,2882
3405-000,2016,11,14,10,1106,945,2051,2814
3405-000,2016,11,14,11,1115,927,2042,2051
3405-000,2016,11,14,12,1076,939,2015,2042
3405-000,2016,11,14,13,971,821,1792,2015
3405-000,2016,11,14,14,1087,1014,2101,1792
3405-000,2016,11,14,15,1131,1110,2241,2101
3405-000,2016,11,14,16,1262,1045,2307,2241
3405-000,2016,11,14,17,1227,1013,2240,2307
3405-000,2016,11,14,18,1231,1144,2375,2240
3405-000,2016,11,14,19,1155,1012,2167,2375
3405-000,2016,11,14,20,818,670,1488,2167
3405-000,2016,11,14,21,620,569,1189,1488
3405-000,2016,11,14,22,407,421,828,1189
3405-000,2016,11,14,23,275,227,502,828
3405-000,2016,11,14,24,170,172,342,502
3405-000,2016,11,15,1,96,115,211,342
3405-000,2016,11,15,2,68,83,151,211
3405-000,2016,11,15,3,50,65,115,151
3405-000,2016,11,15,4,76,98,174,115
3405-000,2016,11,15,5,108,121,229,174
3405-000,2016,11,15,6,270,227,497,229
3405-000,2016,11,15,7,559,504,1063,497
3405-000,2016,11,15,8,1179,1308,2487,1063
3405-000,2016,11,15,9,1415,1417,2832,2487
3405-000,2016,11,15,10,1164,1038,2202,2832
3405-000,2016,11,15,11,1172,988,2160,2202
3405-000,2016,11,15,12,1183,940,2123,2160
3405-000,2016,11,15,13,991,884,1875,2123
3405-000,2016,11,15,14,1089,1002,2091,1875
3405-000,2016,11,15,15,1199,1033,2232,2091
3405-000,2016,11,15,16,1253,1019,2272,2232
3405-000,2016,11,15,17,1189,1098,2287,2272
3405-000,2016,11,15,18,1354,1104,2458,2287
3405-000,2016,11,15,19,1062,1034,2096,2458
3405-000,2016,11,15,20,775,665,1440,2096
3405-000,2016,11,15,21,637,606,1243,1440
3405-000,2016,11,15,22,394,434,828,1243
3405-000,2016,11,15,23,317,269,586,828
3405-000,2016,11,15,24,154,153,307,586
3405-000,2016,11,16,1,103,99,202,307
3405-000,2016,11,16,2,53,87,140,202
3405-000,2016,11,16,3,66,79,145,140
3405-000,2016,11,16,4,75,86,161,145
3405-000,2016,11,16,5,124,109,233,161
3405-000,2016,11,16,6,250,240,490,233
3405-000,2016,11,16,7,573,506,1079,490
3405-000,2016,11,16,8,1152,1406,2558,1079
3405-000,2016,11,16,9,1448,1392,2840,2558
3405-000,2016,11,16,10,1172,987,2159,2840
3405-000,2016,11,16,11,1189,1113,2302,2159
3405-000,2016,11,16,12,1183,989,2172,2302
3405-000,2016,11,16,13,1023,903,1926,2172
3405-000,2016,11,16,14,1063,1033,2096,1926
3405-000,2016,11,16,15,1298,1027,2325,2096
3405-000,2016,11,16,16,1240,1082,2322,2325
3405-000,2016,11,16,17,1207,1047,2254,2322
3405-000,2016,11,16,18,1457,1110,2567,2254
3405-000,2016,11,16,19,1277,1002,2279,2567
3405-000,2016,11,16,20,801,651,1452,2279
3405-000,2016,11,16,21,562,547,1109,1452
3405-000,2016,11,16,22,406,416,822,1109
3405-000,2016,11,16,23,243,234,477,822
3405-000,2016,11,16,24,167,146,313,477
3405-000,2016,11,17,1,98,120,218,313
3405-000,2016,11,17,2,54,71,125,218
3405-000,2016,11,17,3,46,73,119,125
3405-000,2016,11,17,4,60,75,135,119
3405-000,2016,11,17,5,129,110,239,135
3405-000,2016,11,17,6,245,222,467,239
3405-000,2016,11,17,7,590,504,1094,467
3405-000,2016,11,17,8,1150,1445,2595,1094
3405-000,2016,11,17,9,1433,1385,2818,2595
3405-000,2016,11,17,10,1200,1067,2267,2818
3405-000,2016,11,17,11,1235,1117,2352,2267
3405-000,2016,11,17,12,1159,985,2144,2352
3405-000,2016,11,17,13,963,936,1899,2144
3405-000,2016,11,17,14,1120,1093,2213,1899
3405-000,2016,11,17,15,1219,1091,2310,2213
3405-000,2016,11,17,16,1244,1082,2326,2310
3405-000,2016,11,17,17,1250,985,2235,2326
3405-000,2016,11,17,18,1365,1015,2380,2235
3405-000,2016,11,17,19,1254,983,2237,2380
3405-000,2016,11,17,20,799,651,1450,2237
3405-000,2016,11,17,21,655,561,1216,1450
3405-000,2016,11,17,22,439,478,917,1216
3405-000,2016,11,17,23,269,276,545,917
3405-000,2016,11,17,24,163,179,342,545
3405-000,2016,11,18,1,117,107,224,342
3405-000,2016,11,18,2,65,76,141,224
3405-000,2016,11,18,3,69,76,145,141
3405-000,2016,11,18,4,63,78,141,145
3405-000,2016,11,18,5,124,111,235,141
3405-000,2016,11,18,6,265,216,481,235
3405-000,2016,11,18,7,567,536,1103,481
3405-000,2016,11,18,8,1130,1386,2516,1103
3405-000,2016,11,18,9,1440,1337,2777,2516
3405-000,2016,11,18,10,1204,1060,2264,2777
3405-000,2016,11,18,11,1186,1019,2205,2264
3405-000,2016,11,18,12,1187,959,2146,2205
3405-000,2016,11,18,13,997,863,1860,2146
3405-000,2016,11,18,14,1161,1053,2214,1860
3405-000,2016,11,18,15,1309,1231,2540,2214
3405-000,2016,11,18,16,1391,1168,2559,2540
3405-000,2016,11,18,17,1389,990,2379,2559
3405-000,2016,11,18,18,1510,1176,2686,2379
3405-000,2016,11,18,19,1739,1114,2853,2686
3405-000,2016,11,18,20,1114,921,2035,2853
3405-000,2016,11,18,21,801,901,1702,2035
3405-000,2016,11,18,22,570,557,1127,1702
3405-000,2016,11,18,23,316,381,697,1127
3405-000,2016,11,18,24,203,197,400,697
3405-000,2016,11,19,1,134,112,246,400
3405-000,2016,11,19,2,95,75,170,246
3405-000,2016,11,19,3,66,74,140,170
3405-000,2016,11,19,4,65,76,141,140
3405-000,2016,11,19,5,104,92,196,141
3405-000,2016,11,19,6,233,181,414,196
3405-000,2016,11,19,7,438,367,805,414
3405-000,2016,11,19,8,744,655,1399,805
3405-000,2016,11,19,9,983,829,1812,1399
3405-000,2016,11,19,10,977,790,1767,1812
3405-000,2016,11,19,11,1102,1045,2147,1767
3405-000,2016,11,19,12,1076,913,1989,2147
3405-000,2016,11,19,13,911,845,1756,1989
3405-000,2016,11,19,14,969,936,1905,1756
3405-000,2016,11,19,15,936,940,1876,1905
3405-000,2016,11,19,16,905,873,1778,1876
3405-000,2016,11,19,17,955,871,1826,1778
3405-000,2016,11,19,18,1149,993,2142,1826
3405-000,2016,11,19,19,962,753,1715,2142
3405-000,2016,11,19,20,565,435,1000,1715
3405-000,2016,11,19,21,375,323,698,1000
3405-000,2016,11,19,22,341,300,641,698
3405-000,2016,11,19,23,248,208,456,641
3405-000,2016,11,19,24,142,144,286,456
3405-000,2016,11,20,1,95,77,172,286
3405-000,2016,11,20,2,54,70,124,172
3405-000,2016,11,20,3,56,51,107,124
3405-000,2016,11,20,4,45,40,85,107
3405-000,2016,11,20,5,55,50,105,85
3405-000,2016,11,20,6,111,66,177,105
3405-000,2016,11,20,7,228,171,399,177
3405-000,2016,11,20,8,370,316,686,399
3405-000,2016,11,20,9,510,371,881,686
3405-000,2016,11,20,10,548,399,947,881
3405-000,2016,11,20,11,674,470,1144,947
3405-000,2016,11,20,12,610,560,1170,1144
3405-000,2016,11,20,13,678,506,1184,1170
3405-000,2016,11,20,14,719,615,1334,1184
3405-000,2016,11,20,15,765,684,1449,1334
3405-000,2016,11,20,16,775,642,1417,1449
3405-000,2016,11,20,17,840,775,1615,1417
3405-000,2016,11,20,18,800,882,1682,1615
3405-000,2016,11,20,19,723,754,1477,1682
3405-000,2016,11,20,20,542,621,1163,1477
3405-000,2016,11,20,21,382,545,927,1163
3405-000,2016,11,20,22,299,386,685,927
3405-000,2016,11,20,23,210,279,489,685
3405-000,2016,11,20,24,130,185,315,489
3405-000,2016,11,21,1,84,125,209,315
3405-000,2016,11,21,2,68,77,145,209
3405-000,2016,11,21,3,39,55,94,145
3405-000,2016,11,21,4,53,68,121,94
3405-000,2016,11,21,5,120,100,220,121
3405-000,2016,11,21,6,260,283,543,220
3405-000,2016,11,21,7,637,670,1307,543
3405-000,2016,11,21,8,1192,1544,2736,1307
3405-000,2016,11,21,9,1436,1360,2796,2736
3405-000,2016,11,21,10,1076,1021,2097,2796
3405-000,2016,11,21,11,1140,972,2112,2097
3405-000,2016,11,21,12,1076,963,2039,2112
3405-000,2016,11,21,13,942,800,1742,2039
3405-000,2016,11,21,14,1036,992,2028,1742
3405-000,2016,11,21,15,1184,1037,2221,2028
3405-000,2016,11,21,16,1167,1041,2208,2221
3405-000,2016,11,21,17,1144,988,2132,2208
3405-000,2016,11,21,18,1251,1026,2277,2132
3405-000,2016,11,21,19,1048,981,2029,2277
3405-000,2016,11,21,20,710,657,1367,2029
3405-000,2016,11,21,21,603,615,1218,1367
3405-000,2016,11,21,22,400,453,853,1218
3405-000,2016,11,21,23,250,233,483,853
3405-000,2016,11,21,24,142,162,304,483
3405-000,2016,11,22,1,111,105,216,304
3405-000,2016,11,22,2,68,62,130,216
3405-000,2016,11,22,3,39,52,91,130
3405-000,2016,11,22,4,69,60,129,91
3405-000,2016,11,22,5,105,107,212,129
3405-000,2016,11,22,6,245,225,470,212
3405-000,2016,11,22,7,553,473,1026,470
3405-000,2016,11,22,8,1069,1228,2297,1026
3405-000,2016,11,22,9,1365,1315,2680,2297
3405-000,2016,11,22,10,1147,958,2105,2680
3405-000,2016,11,22,11,1158,1098,2256,2105
3405-000,2016,11,22,12,1051,932,1983,2256
3405-000,2016,11,22,13,865,829,1694,1983
3405-000,2016,11,22,14,1048,973,2021,1694
3405-000,2016,11,22,15,1227,1085,2312,2021
3405-000,2016,11,22,16,1172,990,2162,2312
3405-000,2016,11,22,17,1209,1100,2309,2162
3405-000,2016,11,22,18,1280,1045,2325,2309
3405-000,2016,11,22,19,1062,1013,2075,2325
3405-000,2016,11,22,20,725,634,1359,2075
3405-000,2016,11,22,21,584,620,1204,1359
3405-000,2016,11,22,22,425,435,860,1204
3405-000,2016,11,22,23,263,274,537,860
3405-000,2016,11,22,24,158,173,331,537
3405-000,2016,11,23,1,111,109,220,331
3405-000,2016,11,23,2,61,76,137,220
3405-000,2016,11,23,3,51,63,114,137
3405-000,2016,11,23,4,67,70,137,114
3405-000,2016,11,23,5,104,92,196,137
3405-000,2016,11,23,6,236,204,440,196
3405-000,2016,11,23,7,514,478,992,440
3405-000,2016,11,23,8,1086,1287,2373,992
3405-000,2016,11,23,9,1423,1301,2724,2373
3405-000,2016,11,23,10,1148,966,2114,2724
3405-000,2016,11,23,11,1095,1011,2106,2114
3405-000,2016,11,23,12,1114,979,2093,2106
3405-000,2016,11,23,13,934,847,1781,2093
3405-000,2016,11,23,14,1004,900,1904,1781
3405-000,2016,11,23,15,1129,1040,2169,1904
3405-000,2016,11,23,16,1211,1018,2229,2169
3405-000,2016,11,23,17,1191,972,2163,2229
3405-000,2016,11,23,18,1264,1050,2314,2163
3405-000,2016,11,23,19,1083,995,2078,2314
3405-000,2016,11,23,20,692,633,1325,2078
3405-000,2016,11,23,21,564,503,1067,1325
3405-000,2016,11,23,22,383,416,799,1067
3405-000,2016,11,23,23,274,234,508,799
3405-000,2016,11,23,24,150,154,304,508
3405-000,2016,11,24,1,106,157,263,304
3405-000,2016,11,24,2,69,93,162,263
3405-000,2016,11,24,3,54,82,136,162
3405-000,2016,11,24,4,70,66,136,136
3405-000,2016,11,24,5,107,106,213,136
3405-000,2016,11,24,6,238,186,424,213
3405-000,2016,11,24,7,538,452,990,424
3405-000,2016,11,24,8,1080,1263,2343,990
3405-000,2016,11,24,9,1396,1261,2657,2343
3405-000,2016,11,24,10,1097,1031,2128,2657
3405-000,2016,11,24,11,1135,964,2099,2128
3405-000,2016,11,24,12,1150,938,2088,2099
3405-000,2016,11,24,13,936,789,1725,2088
3405-000,2016,11,24,14,1022,991,2013,1725
3405-000,2016,11,24,15,1180,999,2179,2013
3405-000,2016,11,24,16,1128,973,2101,2179
3405-000,2016,11,24,17,1157,1006,2163,2101
3405-000,2016,11,24,18,1187,1021,2208,2163
3405-000,2016,11,24,19,1088,896,1984,2208
3405-000,2016,11,24,20,745,606,1351,1984
3405-000,2016,11,24,21,598,563,1161,1351
3405-000,2016,11,24,22,422,457,879,1161
3405-000,2016,11,24,23,303,231,534,879
3405-000,2016,11,24,24,165,173,338,534
3405-000,2016,11,25,1,107,100,207,338
3405-000,2016,11,25,2,65,77,142,207
3405-000,2016,11,25,3,56,68,124,142
3405-000,2016,11,25,4,54,75,129,124
3405-000,2016,11,25,5,117,96,213,129
3405-000,2016,11,25,6,229,200,429,213
3405-000,2016,11,25,7,528,495,1023,429
3405-000,2016,11,25,8,1076,1258,2334,1023
3405-000,2016,11,25,9,1385,1236,2621,2334
3405-000,2016,11,25,10,1186,932,2118,2621
3405-000,2016,11,25,11,1109,1001,2110,2118
3405-000,2016,11,25,12,1097,908,2005,2110
3405-000,2016,11,25,13,973,836,1809,2005
3405-000,2016,11,25,14,1156,910,2066,1809
3405-000,2016,11,25,15,1269,1108,2377,2066
3405-000,2016,11,25,16,1209,1133,2342,2377
3405-000,2016,11,25,17,1329,1043,2372,2342
3405-000,2016,11,25,18,1513,1129,2642,2372
3405-000,2016,11,25,19,1469,1175,2644,2642
3405-000,2016,11,25,20,1065,907,1972,2644
3405-000,2016,11,25,21,828,820,1648,1972
3405-000,2016,11,25,22,593,455,1048,1648
3405-000,2016,11,25,23,323,273,596,1048
3405-000,2016,11,25,24,219,195,414,596
3405-000,2016,11,26,1,136,130,266,414
3405-000,2016,11,26,2,88,87,175,266
3405-000,2016,11,26,3,60,61,121,175
3405-000,2016,11,26,4,64,81,145,121
3405-000,2016,11,26,5,128,84,212,145
3405-000,2016,11,26,6,199,186,385,212
3405-000,2016,11,26,7,426,359,785,385
3405-000,2016,11,26,8,776,691,1467,785
3405-000,2016,11,26,9,1009,859,1868,1467
3405-000,2016,11,26,10,902,782,1684,1868
3405-000,2016,11,26,11,960,827,1787,1684
3405-000,2016,11,26,12,914,905,1819,1787
3405-000,2016,11,26,13,813,872,1685,1819
3405-000,2016,11,26,14,815,705,1520,1685
3405-000,2016,11,26,15,870,753,1623,1520
3405-000,2016,11,26,16,936,814,1750,1623
3405-000,2016,11,26,17,962,792,1754,1750
3405-000,2016,11,26,18,1031,951,1982,1754
3405-000,2016,11,26,19,806,647,1453,1982
3405-000,2016,11,26,20,530,440,970,1453
3405-000,2016,11,26,21,415,314,729,970
3405-000,2016,11,26,22,280,233,513,729
3405-000,2016,11,26,23,220,185,405,513
3405-000,2016,11,26,24,122,148,270,405
3405-000,2016,11,27,1,87,83,170,270
3405-000,2016,11,27,2,61,65,126,170
3405-000,2016,11,27,3,42,33,75,126
3405-000,2016,11,27,4,45,27,72,75
3405-000,2016,11,27,5,44,28,72,72
3405-000,2016,11,27,6,99,80,179,72
3405-000,2016,11,27,7,172,160,332,179
3405-000,2016,11,27,8,333,260,593,332
3405-000,2016,11,27,9,422,380,802,593
3405-000,2016,11,27,10,535,341,876,802
3405-000,2016,11,27,11,562,464,1026,876
3405-000,2016,11,27,12,612,462,1074,1026
3405-000,2016,11,27,13,547,509,1056,1074
3405-000,2016,11,27,14,586,579,1165,1056
3405-000,2016,11,27,15,679,610,1289,1165
3405-000,2016,11,27,16,807,649,1456,1289
3405-000,2016,11,27,17,722,648,1370,1456
3405-000,2016,11,27,18,746,650,1396,1370
3405-000,2016,11,27,19,580,590,1170,1396
3405-000,2016,11,27,20,425,456,881,1170
3405-000,2016,11,27,21,301,389,690,881
3405-000,2016,11,27,22,263,501,764,690
3405-000,2016,11,27,23,196,264,460,764
3405-000,2016,11,27,24,129,153,282,460
3405-000,2016,11,28,1,70,102,172,282
3405-000,2016,11,28,2,31,68,99,172
3405-000,2016,11,28,3,33,58,91,99
3405-000,2016,11,28,4,54,77,131,91
3405-000,2016,11,28,5,97,117,214,131
3405-000,2016,11,28,6,250,256,506,214
3405-000,2016,11,28,7,510,551,1061,506
3405-000,2016,11,28,8,1081,1383,2464,1061
3405-000,2016,11,28,9,1473,1387,2860,2464
3405-000,2016,11,28,10,1075,926,2001,2860
3405-000,2016,11,28,11,1117,998,2115,2001
3405-000,2016,11,28,12,1121,913,2034,2115
3405-000,2016,11,28,13,903,844,1747,2034
3405-000,2016,11,28,14,1017,1004,2021,1747
3405-000,2016,11,28,15,1117,1041,2158,2021
3405-000,2016,11,28,16,1153,1023,2176,2158
3405-000,2016,11,28,17,1203,965,2168,2176
3405-000,2016,11,28,18,1298,1095,2393,2168
3405-000,2016,11,28,19,1108,941,2049,2393
3405-000,2016,11,28,20,771,639,1410,2049
3405-000,2016,11,28,21,575,572,1147,1410
3405-000,2016,11,28,22,426,384,810,1147
3405-000,2016,11,28,23,256,236,492,810
3405-000,2016,11,28,24,155,164,319,492
3405-000,2016,11,29,1,93,93,186,319
3405-000,2016,11,29,2,51,66,117,186
3405-000,2016,11,29,3,54,65,119,117
3405-000,2016,11,29,4,62,78,140,119
3405-000,2016,11,29,5,109,110,219,140
3405-000,2016,11,29,6,227,191,418,219
3405-000,2016,11,29,7,523,481,1004,418
3405-000,2016,11,29,8,1074,1265,2339,1004
3405-000,2016,11,29,9,1390,1257,2647,2339
3405-000,2016,11,29,10,1109,1027,2136,2647
3405-000,2016,11,29,11,1174,1004,2178,2136
3405-000,2016,11,29,12,1072,903,1975,2178
3405-000,2016,11,29,13,914,879,1793,1975
3405-000,2016,11,29,14,1025,989,2014,1793
3405-000,2016,11,29,15,1229,960,2189,2014
3405-000,2016,11,29,16,1167,986,2153,2189
3405-000,2016,11,29,17,1164,1001,2165,2153
3405-000,2016,11,29,18,1248,985,2233,2165
3405-000,2016,11,29,19,1010,943,1953,2233
3405-000,2016,11,29,20,704,627,1331,1953
3405-000,2016,11,29,21,580,547,1127,1331
3405-000,2016,11,29,22,413,401,814,1127
3405-000,2016,11,29,23,275,228,503,814
3405-000,2016,11,29,24,161,175,336,503
3405-000,2016,11,30,1,105,102,207,336
3405-000,2016,11,30,2,61,87,148,207
3405-000,2016,11,30,3,51,62,113,148
3405-000,2016,11,30,4,74,74,148,113
3405-000,2016,11,30,5,133,100,233,148
3405-000,2016,11,30,6,226,195,421,233
3405-000,2016,11,30,7,536,438,974,421
3405-000,2016,11,30,8,1053,1227,2280,974
3405-000,2016,11,30,9,1326,1230,2556,2280
3405-000,2016,11,30,10,1106,1006,2112,2556
3405-000,2016,11,30,11,1195,1032,2227,2112
3405-000,2016,11,30,12,1109,977,2086,2227
3405-000,2016,11,30,13,901,852,1753,2086
3405-000,2016,11,30,14,1009,960,1969,1753
3405-000,2016,11,30,15,1180,939,2119,1969
3405-000,2016,11,30,16,1120,1027,2147,2119
3405-000,2016,11,30,17,1100,973,2073,2147
3405-000,2016,11,30,18,1228,1040,2268,2073
3405-000,2016,11,30,19,1071,895,1966,2268
3405-000,2016,11,30,20,713,660,1373,1966
3405-000,2016,11,30,21,540,527,1067,1373
3405-000,2016,11,30,22,391,369,760,1067
3405-000,2016,11,30,23,268,238,506,760
3405-000,2016,11,30,24,154,133,287,506
3405-000,2016,12,1,1,102,101,203,287
3405-000,2016,12,1,2,58,76,134,203
3405-000,2016,12,1,3,61,68,129,134
3405-000,2016,12,1,4,61,70,131,129
3405-000,2016,12,1,5,124,101,225,131
3405-000,2016,12,1,6,252,211,463,225
3405-000,2016,12,1,7,503,441,944,463
3405-000,2016,12,1,8,1055,1308,2363,944
3405-000,2016,12,1,9,1365,1217,2582,2363
3405-000,2016,12,1,10,1145,973,2118,2582
3405-000,2016,12,1,11,1147,984,2131,2118
3405-000,2016,12,1,12,1071,919,1990,2131
3405-000,2016,12,1,13,884,832,1716,1990
3405-000,2016,12,1,14,1014,986,2000,1716
3405-000,2016,12,1,15,1159,1045,2204,2000
3405-000,2016,12,1,16,1133,965,2098,2204
3405-000,2016,12,1,17,1148,1021,2169,2098
3405-000,2016,12,1,18,1245,980,2225,2169
3405-000,2016,12,1,19,1066,910,1976,2225
3405-000,2016,12,1,20,707,637,1344,1976
3405-000,2016,12,1,21,579,579,1158,1344
3405-000,2016,12,1,22,413,409,822,1158
3405-000,2016,12,1,23,272,245,517,822
3405-000,2016,12,1,24,149,147,296,517
3405-000,2016,12,2,1,95,120,215,296
3405-000,2016,12,2,2,74,76,150,215
3405-000,2016,12,2,3,42,68,110,150
3405-000,2016,12,2,4,71,68,139,110
3405-000,2016,12,2,5,107,92,199,139
3405-000,2016,12,2,6,233,200,433,199
3405-000,2016,12,2,7,513,453,966,433
3405-000,2016,12,2,8,1096,1260,2356,966
3405-000,2016,12,2,9,1375,1215,2590,2356
3405-000,2016,12,2,10,1103,885,1988,2590
3405-000,2016,12,2,11,1160,938,2098,1988
3405-000,2016,12,2,12,1074,964,2038,2098
3405-000,2016,12,2,13,1005,814,1819,2038
3405-000,2016,12,2,14,1033,954,1987,1819
3405-000,2016,12,2,15,1180,971,2151,1987
3405-000,2016,12,2,16,1258,999,2257,2151
3405-000,2016,12,2,17,1386,910,2296,2257
3405-000,2016,12,2,18,1497,1021,2518,2296
3405-000,2016,12,2,19,1456,1189,2645,2518
3405-000,2016,12,2,20,977,855,1832,2645
3405-000,2016,12,2,21,658,562,1220,1832
3405-000,2016,12,2,22,512,646,1158,1220
3405-000,2016,12,2,23,314,266,580,1158
3405-000,2016,12,2,24,169,146,315,580
3405-000,2016,12,3,1,107,124,231,315
3405-000,2016,12,3,2,89,75,164,231
3405-000,2016,12,3,3,56,71,127,164
3405-000,2016,12,3,4,77,75,152,127
3405-000,2016,12,3,5,80,106,186,152
3405-000,2016,12,3,6,191,162,353,186
3405-000,2016,12,3,7,411,390,801,353
3405-000,2016,12,3,8,691,666,1357,801
3405-000,2016,12,3,9,991,775,1766,1357
3405-000,2016,12,3,10,945,703,1648,1766
3405-000,2016,12,3,11,930,731,1661,1648
3405-000,2016,12,3,12,837,779,1616,1661
3405-000,2016,12,3,13,823,680,1503,1616
3405-000,2016,12,3,14,868,732,1600,1503
3405-000,2016,12,3,15,903,756,1659,1600
3405-000,2016,12,3,16,949,768,1717,1659
3405-000,2016,12,3,17,985,789,1774,1717
3405-000,2016,12,3,18,1122,860,1982,1774
3405-000,2016,12,3,19,888,677,1565,1982
3405-000,2016,12,3,20,535,440,975,1565
3405-000,2016,12,3,21,414,338,752,975
3405-000,2016,12,3,22,290,244,534,752
3405-000,2016,12,3,23,228,207,435,534
3405-000,2016,12,3,24,140,142,282,435
3405-000,2016,12,4,1,95,93,188,282
3405-000,2016,12,4,2,58,72,130,188
3405-000,2016,12,4,3,52,28,80,130
3405-000,2016,12,4,4,36,34,70,80
3405-000,2016,12,4,5,58,51,109,70
3405-000,2016,12,4,6,105,64,169,109
3405-000,2016,12,4,7,168,166,334,169
3405-000,2016,12,4,8,323,263,586,334
3405-000,2016,12,4,9,444,354,798,586
3405-000,2016,12,4,10,468,373,841,798
3405-000,2016,12,4,11,519,413,932,841
3405-000,2016,12,4,12,539,496,1035,932
3405-000,2016,12,4,13,465,502,967,1035
3405-000,2016,12,4,14,592,568,1160,967
3405-000,2016,12,4,15,619,621,1240,1160
3405-000,2016,12,4,16,672,677,1349,1240
3405-000,2016,12,4,17,735,620,1355,1349
3405-000,2016,12,4,18,758,705,1463,1355
3405-000,2016,12,4,19,550,539,1089,1463
3405-000,2016,12,4,20,416,437,853,1089
3405-000,2016,12,4,21,336,374,710,853
3405-000,2016,12,4,22,271,328,599,710
3405-000,2016,12,4,23,167,277,444,599
3405-000,2016,12,4,24,122,168,290,444
3405-000,2016,12,5,1,53,94,147,290
3405-000,2016,12,5,2,43,47,90,147
3405-000,2016,12,5,3,29,55,84,90
3405-000,2016,12,5,4,40,61,101,84
3405-000,2016,12,5,5,115,82,197,101
3405-000,2016,12,5,6,244,234,478,197
3405-000,2016,12,5,7,579,600,1179,478
3405-000,2016,12,5,8,1110,1416,2526,1179
3405-000,2016,12,5,9,1324,1326,2650,2526
3405-000,2016,12,5,10,1028,964,1992,2650
3405-000,2016,12,5,11,1148,964,2112,1992
3405-000,2016,12,5,12,1071,935,2006,2112
3405-000,2016,12,5,13,866,860,1726,2006
3405-000,2016,12,5,14,998,955,1953,1726
3405-000,2016,12,5,15,1126,1000,2126,1953
3405-000,2016,12,5,16,1215,1068,2283,2126
3405-000,2016,12,5,17,1034,1055,2089,2283
3405-000,2016,12,5,18,1120,990,2110,2089
3405-000,2016,12,5,19,1096,922,2018,2110
3405-000,2016,12,5,20,677,642,1319,2018
3405-000,2016,12,5,21,602,532,1134,1319
3405-000,2016,12,5,22,419,437,856,1134
3405-000,2016,12,5,23,249,244,493,856
3405-000,2016,12,5,24,144,143,287,493
3405-000,2016,12,6,1,98,100,198,287
3405-000,2016,12,6,2,43,78,121,198
3405-000,2016,12,6,3,53,72,125,121
3405-000,2016,12,6,4,67,72,139,125
3405-000,2016,12,6,5,96,103,199,139
3405-000,2016,12,6,6,234,203,437,199
3405-000,2016,12,6,7,499,504,1003,437
3405-000,2016,12,6,8,1134,1206,2340,1003
3405-000,2016,12,6,9,1408,1274,2682,2340
3405-000,2016,12,6,10,1059,958,2017,2682
3405-000,2016,12,6,11,1147,1037,2184,2017
3405-000,2016,12,6,12,1205,1019,2224,2184
3405-000,2016,12,6,13,932,818,1750,2224
3405-000,2016,12,6,14,1016,963,1979,1750
3405-000,2016,12,6,15,1360,896,2256,1979
3405-000,2016,12,6,16,1220,937,2157,2256
3405-000,2016,12,6,17,1162,935,2097,2157
3405-000,2016,12,6,18,1200,986,2186,2097
3405-000,2016,12,6,19,1034,969,2003,2186
3405-000,2016,12,6,20,740,645,1385,2003
3405-000,2016,12,6,21,551,569,1120,1385
3405-000,2016,12,6,22,452,445,897,1120
3405-000,2016,12,6,23,273,264,537,897
3405-000,2016,12,6,24,143,180,323,537
3405-000,2016,12,7,1,117,123,240,323
3405-000,2016,12,7,2,60,81,141,240
3405-000,2016,12,7,3,33,69,102,141
3405-000,2016,12,7,4,63,71,134,102
3405-000,2016,12,7,5,115,93,208,134
3405-000,2016,12,7,6,216,167,383,208
3405-000,2016,12,7,7,516,450,966,383
3405-000,2016,12,7,8,1031,1139,2170,966
3405-000,2016,12,7,9,1345,1233,2578,2170
3405-000,2016,12,7,10,1128,972,2100,2578
3405-000,2016,12,7,11,1129,970,2099,2100
3405-000,2016,12,7,12,1019,918,1937,2099
3405-000,2016,12,7,13,949,833,1782,1937
3405-000,2016,12,7,14,1021,955,1976,1782
3405-000,2016,12,7,15,1230,922,2152,1976
3405-000,2016,12,7,16,1144,987,2131,2152
3405-000,2016,12,7,17,1118,1006,2124,2131
3405-000,2016,12,7,18,1251,1011,2262,2124
3405-000,2016,12,7,19,1068,993,2061,2262
3405-000,2016,12,7,20,723,636,1359,2061
3405-000,2016,12,7,21,535,489,1024,1359
3405-000,2016,12,7,22,350,388,738,1024
3405-000,2016,12,7,23,283,252,535,738
3405-000,2016,12,7,24,155,190,345,535
3405-000,2016,12,8,1,108,93,201,345
3405-000,2016,12,8,2,61,78,139,201
3405-000,2016,12,8,3,39,65,104,139
3405-000,2016,12,8,4,73,67,140,104
3405-000,2016,12,8,5,93,100,193,140
3405-000,2016,12,8,6,217,161,378,193
3405-000,2016,12,8,7,496,475,971,378
3405-000,2016,12,8,8,1080,1230,2310,971
3405-000,2016,12,8,9,1433,1254,2687,2310
3405-000,2016,12,8,10,1112,1024,2136,2687
3405-000,2016,12,8,11,1127,956,2083,2136
3405-000,2016,12,8,12,985,1028,2013,2083
3405-000,2016,12,8,13,846,818,1664,2013
3405-000,2016,12,8,14,1018,1017,2035,1664
3405-000,2016,12,8,15,1205,978,2183,2035
3405-000,2016,12,8,16,1191,992,2183,2183
3405-000,2016,12,8,17,1197,993,2190,2183
3405-000,2016,12,8,18,1248,1060,2308,2190
3405-000,2016,12,8,19,1013,907,1920,2308
3405-000,2016,12,8,20,703,610,1313,1920
3405-000,2016,12,8,21,551,542,1093,1313
3405-000,2016,12,8,22,413,400,813,1093
3405-000,2016,12,8,23,268,239,507,813
3405-000,2016,12,8,24,150,168,318,507
3405-000,2016,12,9,1,96,92,188,318
3405-000,2016,12,9,2,57,71,128,188
3405-000,2016,12,9,3,40,72,112,128
3405-000,2016,12,9,4,53,64,117,112
3405-000,2016,12,9,5,101,100,201,117
3405-000,2016,12,9,6,200,182,382,201
3405-000,2016,12,9,7,488,428,916,382
3405-000,2016,12,9,8,1053,1130,2183,916
3405-000,2016,12,9,9,1334,1243,2577,2183
3405-000,2016,12,9,10,1085,992,2077,2577
3405-000,2016,12,9,11,1059,978,2037,2077
3405-000,2016,12,9,12,1082,893,1975,2037
3405-000,2016,12,9,13,903,882,1785,1975
3405-000,2016,12,9,14,991,967,1958,1785
3405-000,2016,12,9,15,1203,1010,2213,1958
3405-000,2016,12,9,16,1256,949,2205,2213
3405-000,2016,12,9,17,1239,1092,2331,2205
3405-000,2016,12,9,18,1341,1088,2429,2331
3405-000,2016,12,9,19,1318,1053,2371,2429
3405-000,2016,12,9,20,921,697,1618,2371
3405-000,2016,12,9,21,659,555,1214,1618
3405-000,2016,12,9,22,455,393,848,1214
3405-000,2016,12,9,23,278,222,500,848
3405-000,2016,12,9,24,181,151,332,500
3405-000,2016,12,10,1,132,110,242,332
3405-000,2016,12,10,2,95,84,179,242
3405-000,2016,12,10,3,58,73,131,179
3405-000,2016,12,10,4,58,71,129,131
3405-000,2016,12,10,5,93,115,208,129
3405-000,2016,12,10,6,191,139,330,208
3405-000,2016,12,10,7,340,318,658,330
3405-000,2016,12,10,8,704,609,1313,658
3405-000,2016,12,10,9,977,767,1744,1313
3405-000,2016,12,10,10,882,678,1560,1744
3405-000,2016,12,10,11,1035,739,1774,1560
3405-000,2016,12,10,12,875,701,1576,1774
3405-000,2016,12,10,13,710,675,1385,1576
3405-000,2016,12,10,14,776,765,1541,1385
3405-000,2016,12,10,15,950,734,1684,1541
3405-000,2016,12,10,16,939,787,1726,1684
3405-000,2016,12,10,17,969,823,1792,1726
3405-000,2016,12,10,18,1153,846,1999,1792
3405-000,2016,12,10,19,828,681,1509,1999
3405-000,2016,12,10,20,501,443,944,1509
3405-000,2016,12,10,21,414,326,740,944
3405-000,2016,12,10,22,285,238,523,740
3405-000,2016,12,10,23,224,196,420,523
3405-000,2016,12,10,24,131,145,276,420
3405-000,2016,12,11,1,91,92,183,276
3405-000,2016,12,11,2,66,77,143,183
3405-000,2016,12,11,3,44,56,100,143
3405-000,2016,12,11,4,35,37,72,100
3405-000,2016,12,11,5,50,46,96,72
3405-000,2016,12,11,6,90,69,159,96
3405-000,2016,12,11,7,173,110,283,159
3405-000,2016,12,11,8,327,259,586,283
3405-000,2016,12,11,9,445,331,776,586
3405-000,2016,12,11,10,473,326,799,776
3405-000,2016,12,11,11,567,455,1022,799
3405-000,2016,12,11,12,515,509,1024,1022
3405-000,2016,12,11,13,538,518,1056,1024
3405-000,2016,12,11,14,557,542,1099,1056
3405-000,2016,12,11,15,611,559,1170,1099
3405-000,2016,12,11,16,684,624,1308,1170
3405-000,2016,12,11,17,661,594,1255,1308
3405-000,2016,12,11,18,965,638,1603,1255
3405-000,2016,12,11,19,735,570,1305,1603
3405-000,2016,12,11,20,424,424,848,1305
3405-000,2016,12,11,21,314,395,709,848
3405-000,2016,12,11,22,242,355,597,709
3405-000,2016,12,11,23,230,230,460,597
3405-000,2016,12,11,24,112,163,275,460
3405-000,2016,12,12,1,61,111,172,275
3405-000,2016,12,12,2,47,54,101,172
3405-000,2016,12,12,3,33,52,85,101
3405-000,2016,12,12,4,51,58,109,85
3405-000,2016,12,12,5,83,106,189,109
3405-000,2016,12,12,6,235,224,459,189
3405-000,2016,12,12,7,541,587,1128,459
3405-000,2016,12,12,8,1108,1376,2484,1128
3405-000,2016,12,12,9,1326,1243,2569,2484
3405-000,2016,12,12,10,1091,851,1942,2569
3405-000,2016,12,12,11,1050,942,1992,1942
3405-000,2016,12,12,12,1083,891,1974,1992
3405-000,2016,12,12,13,896,799,1695,1974
3405-000,2016,12,12,14,934,897,1831,1695
3405-000,2016,12,12,15,1155,993,2148,1831
3405-000,2016,12,12,16,1135,984,2119,2148
3405-000,2016,12,12,17,1170,1020,2190,2119
3405-000,2016,12,12,18,1180,982,2162,2190
3405-000,2016,12,12,19,976,937,1913,2162
3405-000,2016,12,12,20,746,614,1360,1913
3405-000,2016,12,12,21,657,561,1218,1360
3405-000,2016,12,12,22,438,415,853,1218
3405-000,2016,12,12,23,234,243,477,853
3405-000,2016,12,12,24,159,154,313,477
3405-000,2016,12,13,1,92,94,186,313
3405-000,2016,12,13,2,53,56,109,186
3405-000,2016,12,13,3,36,65,101,109
3405-000,2016,12,13,4,63,71,134,101
3405-000,2016,12,13,5,104,89,193,134
3405-000,2016,12,13,6,182,191,373,193
3405-000,2016,12,13,7,454,462,916,373
3405-000,2016,12,13,8,1058,1200,2258,916
3405-000,2016,12,13,9,1397,1295,2692,2258
3405-000,2016,12,13,10,1125,947,2072,2692
3405-000,2016,12,13,11,1126,941,2067,2072
3405-000,2016,12,13,12,1074,960,2034,2067
3405-000,2016,12,13,13,903,788,1691,2034
3405-000,2016,12,13,14,1041,892,1933,1691
3405-000,2016,12,13,15,1156,999,2155,1933
3405-000,2016,12,13,16,1170,981,2151,2155
3405-000,2016,12,13,17,1164,954,2118,2151
3405-000,2016,12,13,18,1160,974,2134,2118
3405-000,2016,12,13,19,989,867,1856,2134
3405-000,2016,12,13,20,671,657,1328,1856
3405-000,2016,12,13,21,563,541,1104,1328
3405-000,2016,12,13,22,419,377,796,1104
3405-000,2016,12,13,23,264,216,480,796
3405-000,2016,12,13,24,143,170,313,480
3405-000,2016,12,14,1,111,103,214,313
3405-000,2016,12,14,2,54,108,162,214
3405-000,2016,12,14,3,51,65,116,162
3405-000,2016,12,14,4,52,65,117,116
3405-000,2016,12,14,5,95,101,196,117
3405-000,2016,12,14,6,232,193,425,196
3405-000,2016,12,14,7,460,417,877,425
3405-000,2016,12,14,8,985,1161,2146,877
3405-000,2016,12,14,9,1376,1275,2651,2146
3405-000,2016,12,14,10,1111,973,2084,2651
3405-000,2016,12,14,11,1085,941,2026,2084
3405-000,2016,12,14,12,1074,954,2028,2026
3405-000,2016,12,14,13,935,790,1725,2028
3405-000,2016,12,14,14,999,908,1907,1725
3405-000,2016,12,14,15,1141,949,2090,1907
3405-000,2016,12,14,16,1186,961,2147,2090
3405-000,2016,12,14,17,1155,914,2069,2147
3405-000,2016,12,14,18,1253,988,2241,2069
3405-000,2016,12,14,19,1034,898,1932,2241
3405-000,2016,12,14,20,643,592,1235,1932
3405-000,2016,12,14,21,520,464,984,1235
3405-000,2016,12,14,22,346,363,709,984
3405-000,2016,12,14,23,290,206,496,709
3405-000,2016,12,14,24,198,169,367,496
3405-000,2016,12,15,1,103,106,209,367
3405-000,2016,12,15,2,61,66,127,209
3405-000,2016,12,15,3,38,61,99,127
3405-000,2016,12,15,4,55,72,127,99
3405-000,2016,12,15,5,103,92,195,127
3405-000,2016,12,15,6,204,196,400,195
3405-000,2016,12,15,7,465,397,862,400
3405-000,2016,12,15,8,993,1133,2126,862
3405-000,2016,12,15,9,1353,1204,2557,2126
3405-000,2016,12,15,10,1069,978,2047,2557
3405-000,2016,12,15,11,1019,938,1957,2047
3405-000,2016,12,15,12,1055,913,1968,1957
3405-000,2016,12,15,13,876,811,1687,1968
3405-000,2016,12,15,14,1028,938,1966,1687
3405-000,2016,12,15,15,1146,972,2118,1966
3405-000,2016,12,15,16,1136,952,2088,2118
3405-000,2016,12,15,17,1195,932,2127,2088
3405-000,2016,12,15,18,1217,1022,2239,2127
3405-000,2016,12,15,19,1078,880,1958,2239
3405-000,2016,12,15,20,673,615,1288,1958
3405-000,2016,12,15,21,585,570,1155,1288
3405-000,2016,12,15,22,390,411,801,1155
3405-000,2016,12,15,23,292,260,552,801
3405-000,2016,12,15,24,178,153,331,552
3405-000,2016,12,16,1,115,126,241,331
3405-000,2016,12,16,2,64,78,142,241
3405-000,2016,12,16,3,52,74,126,142
3405-000,2016,12,16,4,68,75,143,126
3405-000,2016,12,16,5,97,80,177,143
3405-000,2016,12,16,6,189,169,358,177
3405-000,2016,12,16,7,444,400,844,358
3405-000,2016,12,16,8,1024,1140,2164,844
3405-000,2016,12,16,9,1306,1177,2483,2164
3405-000,2016,12,16,10,1141,980,2121,2483
3405-000,2016,12,16,11,1079,921,2000,2121
3405-000,2016,12,16,12,1072,871,1943,2000
3405-000,2016,12,16,13,906,826,1732,1943
3405-000,2016,12,16,14,1059,947,2006,1732
3405-000,2016,12,16,15,1227,941,2168,2006
3405-000,2016,12,16,16,1222,951,2173,2168
3405-000,2016,12,16,17,1180,957,2137,2173
3405-000,2016,12,16,18,1414,1081,2495,2137
3405-000,2016,12,16,19,1354,1029,2383,2495
3405-000,2016,12,16,20,828,694,1522,2383
3405-000,2016,12,16,21,694,506,1200,1522
3405-000,2016,12,16,22,515,380,895,1200
3405-000,2016,12,16,23,307,237,544,895
3405-000,2016,12,16,24,173,193,366,544
3405-000,2016,12,17,1,122,107,229,366
3405-000,2016,12,17,2,75,80,155,229
3405-000,2016,12,17,3,62,63,125,155
3405-000,2016,12,17,4,67,63,130,125
3405-000,2016,12,17,5,93,92,185,130
3405-000,2016,12,17,6,169,123,292,185
3405-000,2016,12,17,7,355,296,651,292
3405-000,2016,12,17,8,624,603,1227,651
3405-000,2016,12,17,9,947,723,1670,1227
3405-000,2016,12,17,10,879,694,1573,1670
3405-000,2016,12,17,11,927,714,1641,1573
3405-000,2016,12,17,12,849,792,1641,1641
3405-000,2016,12,17,13,766,911,1677,1641
3405-000,2016,12,17,14,805,825,1630,1677
3405-000,2016,12,17,15,844,815,1659,1630
3405-000,2016,12,17,16,925,772,1697,1659
3405-000,2016,12,17,17,955,754,1709,1697
3405-000,2016,12,17,18,1086,898,1984,1709
3405-000,2016,12,17,19,765,651,1416,1984
3405-000,2016,12,17,20,521,392,913,1416
3405-000,2016,12,17,21,375,318,693,913
3405-000,2016,12,17,22,270,246,516,693
3405-000,2016,12,17,23,237,170,407,516
3405-000,2016,12,17,24,140,157,297,407
3405-000,2016,12,18,1,98,107,205,297
3405-000,2016,12,18,2,64,58,122,205
3405-000,2016,12,18,3,41,42,83,122
3405-000,2016,12,18,4,29,53,82,83
3405-000,2016,12,18,5,45,50,95,82
3405-000,2016,12,18,6,76,72,148,95
3405-000,2016,12,18,7,190,149,339,148
3405-000,2016,12,18,8,341,273,614,339
3405-000,2016,12,18,9,477,394,871,614
3405-000,2016,12,18,10,524,383,907,871
3405-000,2016,12,18,11,595,472,1067,907
3405-000,2016,12,18,12,599,513,1112,1067
3405-000,2016,12,18,13,508,556,1064,1112
3405-000,2016,12,18,14,612,553,1165,1064
3405-000,2016,12,18,15,644,606,1250,1165
3405-000,2016,12,18,16,709,616,1325,1250
3405-000,2016,12,18,17,661,652,1313,1325
3405-000,2016,12,18,18,703,784,1487,1313
3405-000,2016,12,18,19,532,566,1098,1487
3405-000,2016,12,18,20,399,388,787,1098
3405-000,2016,12,18,21,350,352,702,787
3405-000,2016,12,18,22,295,286,581,702
3405-000,2016,12,18,23,181,243,424,581
3405-000,2016,12,18,24,131,164,295,424
3405-000,2016,12,19,1,74,117,191,295
3405-000,2016,12,19,2,52,65,117,191
3405-000,2016,12,19,3,39,54,93,117
3405-000,2016,12,19,4,42,53,95,93
3405-000,2016,12,19,5,82,98,180,95
3405-000,2016,12,19,6,207,206,413,180
3405-000,2016,12,19,7,547,470,1017,413
3405-000,2016,12,19,8,1048,1329,2377,1017
3405-000,2016,12,19,9,1312,1247,2559,2377
3405-000,2016,12,19,10,1038,874,1912,2559
3405-000,2016,12,19,11,1016,923,1939,1912
3405-000,2016,12,19,12,1059,914,1973,1939
3405-000,2016,12,19,13,887,786,1673,1973
3405-000,2016,12,19,14,892,887,1779,1673
3405-000,2016,12,19,15,1142,975,2117,1779
3405-000,2016,12,19,16,1065,902,1967,2117
3405-000,2016,12,19,17,1103,892,1995,1967
3405-000,2016,12,19,18,1052,864,1916,1995
3405-000,2016,12,19,19,983,934,1917,1916
3405-000,2016,12,19,20,693,621,1314,1917
3405-000,2016,12,19,21,533,523,1056,1314
3405-000,2016,12,19,22,435,423,858,1056
3405-000,2016,12,19,23,286,235,521,858
3405-000,2016,12,19,24,129,152,281,521
3405-000,2016,12,20,1,92,111,203,281
3405-000,2016,12,20,2,61,81,142,203
3405-000,2016,12,20,3,54,54,108,142
3405-000,2016,12,20,4,56,64,120,108
3405-000,2016,12,20,5,101,100,201,120
3405-000,2016,12,20,6,223,195,418,201
3405-000,2016,12,20,7,510,419,929,418
3405-000,2016,12,20,8,1059,1185,2244,929
3405-000,2016,12,20,9,1300,1189,2489,2244
3405-000,2016,12,20,10,1126,888,2014,2489
3405-000,2016,12,20,11,1075,987,2062,2014
3405-000,2016,12,20,12,1033,906,1939,2062
3405-000,2016,12,20,13,894,802,1696,1939
3405-000,2016,12,20,14,1018,953,1971,1696
3405-000,2016,12,20,15,1148,932,2080,1971
3405-000,2016,12,20,16,1147,957,2104,2080
3405-000,2016,12,20,17,1100,900,2000,2104
3405-000,2016,12,20,18,1223,962,2185,2000
3405-000,2016,12,20,19,1061,949,2010,2185
3405-000,2016,12,20,20,736,625,1361,2010
3405-000,2016,12,20,21,591,490,1081,1361
3405-000,2016,12,20,22,418,441,859,1081
3405-000,2016,12,20,23,300,230,530,859
3405-000,2016,12,20,24,160,149,309,530
3405-000,2016,12,21,1,114,115,229,309
3405-000,2016,12,21,2,61,75,136,229
3405-000,2016,12,21,3,58,69,127,136
3405-000,2016,12,21,4,65,83,148,127
3405-000,2016,12,21,5,109,87,196,148
3405-000,2016,12,21,6,185,182,367,196
3405-000,2016,12,21,7,478,409,887,367
3405-000,2016,12,21,8,1035,1148,2183,887
3405-000,2016,12,21,9,1364,1239,2603,2183
3405-000,2016,12,21,10,1117,980,2097,2603
3405-000,2016,12,21,11,1139,994,2133,2097
3405-000,2016,12,21,12,1069,828,1897,2133
3405-000,2016,12,21,13,924,856,1780,1897
3405-000,2016,12,21,14,1030,895,1925,1780
3405-000,2016,12,21,15,1162,941,2103,1925
3405-000,2016,12,21,16,1183,794,1977,2103
3405-000,2016,12,21,17,1141,652,1793,1977
3405-000,2016,12,21,18,1137,973,2110,1793
3405-000,2016,12,21,19,1119,959,2078,2110
3405-000,2016,12,21,20,701,645,1346,2078
3405-000,2016,12,21,21,534,444,978,1346
3405-000,2016,12,21,22,391,370,761,978
3405-000,2016,12,21,23,257,204,461,761
3405-000,2016,12,21,24,136,163,299,461
3405-000,2016,12,22,1,100,101,201,299
3405-000,2016,12,22,2,72,68,140,201
3405-000,2016,12,22,3,46,77,123,140
3405-000,2016,12,22,4,53,67,120,123
3405-000,2016,12,22,5,67,95,162,120
3405-000,2016,12,22,6,172,183,355,162
3405-000,2016,12,22,7,422,355,777,355
3405-000,2016,12,22,8,916,863,1779,777
3405-000,2016,12,22,9,1293,1040,2333,1779
3405-000,2016,12,22,10,1049,896,1945,2333
3405-000,2016,12,22,11,997,929,1926,1945
3405-000,2016,12,22,12,997,872,1869,1926
3405-000,2016,12,22,13,844,780,1624,1869
3405-000,2016,12,22,14,989,882,1871,1624
3405-000,2016,12,22,15,1043,880,1923,1871
3405-000,2016,12,22,16,1095,852,1947,1923
3405-000,2016,12,22,17,1068,894,1962,1947
3405-000,2016,12,22,18,1012,850,1862,1962
3405-000,2016,12,22,19,920,836,1756,1862
3405-000,2016,12,22,20,618,547,1165,1756
3405-000,2016,12,22,21,533,470,1003,1165
3405-000,2016,12,22,22,413,366,779,1003
3405-000,2016,12,22,23,255,239,494,779
3405-000,2016,12,22,24,149,164,313,494
3405-000,2016,12,23,1,112,119,231,313
3405-000,2016,12,23,2,70,68,138,231
3405-000,2016,12,23,3,56,65,121,138
3405-000,2016,12,23,4,56,67,123,121
3405-000,2016,12,23,5,87,87,174,123
3405-000,2016,12,23,6,167,136,303,174
3405-000,2016,12,23,7,413,342,755,303
3405-000,2016,12,23,8,923,1002,1925,755
3405-000,2016,12,23,9,1241,1061,2302,1925
3405-000,2016,12,23,10,949,778,1727,2302
3405-000,2016,12,23,11,1004,857,1861,1727
3405-000,2016,12,23,12,1010,769,1779,1861
3405-000,2016,12,23,13,929,714,1643,1779
3405-000,2016,12,23,14,962,868,1830,1643
3405-000,2016,12,23,15,1070,825,1895,1830
3405-000,2016,12,23,16,1096,831,1927,1895
3405-000,2016,12,23,17,1028,814,1842,1927
3405-000,2016,12,23,18,1158,946,2104,1842
3405-000,2016,12,23,19,1226,940,2166,2104
3405-000,2016,12,23,20,766,586,1352,2166
3405-000,2016,12,23,21,628,466,1094,1352
3405-000,2016,12,23,22,426,365,791,1094
3405-000,2016,12,23,23,271,207,478,791
3405-000,2016,12,23,24,167,138,305,478
3405-000,2016,12,24,1,122,119,241,305
3405-000,2016,12,24,2,78,87,165,241
3405-000,2016,12,24,3,70,56,126,165
3405-000,2016,12,24,4,76,67,143,126
3405-000,2016,12,24,5,85,80,165,143
3405-000,2016,12,24,6,153,140,293,165
3405-000,2016,12,24,7,307,272,579,293
3405-000,2016,12,24,8,572,490,1062,579
3405-000,2016,12,24,9,828,612,1440,1062
3405-000,2016,12,24,10,660,568,1228,1440
3405-000,2016,12,24,11,737,648,1385,1228
3405-000,2016,12,24,12,697,679,1376,1385
3405-000,2016,12,24,13,630,631,1261,1376
3405-000,2016,12,24,14,693,665,1358,1261
3405-000,2016,12,24,15,741,618,1359,1358
3405-000,2016,12,24,16,791,646,1437,1359
3405-000,2016,12,24,17,885,627,1512,1437
3405-000,2016,12,24,18,1103,696,1799,1512
3405-000,2016,12,24,19,933,527,1460,1799
3405-000,2016,12,24,20,446,341,787,1460
3405-000,2016,12,24,21,310,252,562,787
3405-000,2016,12,24,22,242,211,453,562
3405-000,2016,12,24,23,184,166,350,453
3405-000,2016,12,24,24,131,144,275,350
3405-000,2016,12,25,1,95,100,195,275
3405-000,2016,12,25,2,65,68,133,195
3405-000,2016,12,25,3,43,49,92,133
3405-000,2016,12,25,4,32,45,77,92
3405-000,2016,12,25,5,48,48,96,77
3405-000,2016,12,25,6,83,71,154,96
3405-000,2016,12,25,7,182,130,312,154
3405-000,2016,12,25,8,334,266,600,312
3405-000,2016,12,25,9,461,363,824,600
3405-000,2016,12,25,10,499,355,854,824
3405-000,2016,12,25,11,581,464,1045,854
3405-000,2016,12,25,12,557,511,1068,1045
3405-000,2016,12,25,13,523,537,1060,1068
3405-000,2016,12,25,14,585,548,1133,1060
3405-000,2016,12,25,15,628,583,1211,1133
3405-000,2016,12,25,16,697,620,1317,1211
3405-000,2016,12,25,17,661,623,1284,1317
3405-000,2016,12,25,18,834,711,1545,1284
3405-000,2016,12,25,19,634,568,1202,1545
3405-000,2016,12,25,20,412,406,818,1202
3405-000,2016,12,25,21,332,374,706,818
3405-000,2016,12,25,22,269,321,590,706
3405-000,2016,12,25,23,206,237,443,590
3405-000,2016,12,25,24,122,164,286,443
3405-000,2016,12,26,1,68,114,182,286
3405-000,2016,12,26,2,50,60,110,182
3405-000,2016,12,26,3,36,53,89,110
3405-000,2016,12,26,4,47,56,103,89
3405-000,2016,12,26,5,83,102,185,103
3405-000,2016,12,26,6,221,215,436,185
3405-000,2016,12,26,7,544,529,1073,436
3405-000,2016,12,26,8,1078,1353,2431,1073
3405-000,2016,12,26,9,1319,1245,2564,2431
3405-000,2016,12,26,10,1065,863,1928,2564
3405-000,2016,12,26,11,1033,933,1966,1928
3405-000,2016,12,26,12,1071,903,1974,1966
3405-000,2016,12,26,13,892,793,1685,1974
3405-000,2016,12,26,14,913,892,1805,1685
3405-000,2016,12,26,15,1149,984,2133,1805
3405-000,2016,12,26,16,1100,943,2043,2133
3405-000,2016,12,26,17,1137,956,2093,2043
3405-000,2016,12,26,18,1116,923,2039,2093
3405-000,2016,12,26,19,980,936,1916,2039
3405-000,2016,12,26,20,720,618,1338,1916
3405-000,2016,12,26,21,595,542,1137,1338
3405-000,2016,12,26,22,437,419,856,1137
3405-000,2016,12,26,23,260,239,499,856
3405-000,2016,12,26,24,144,153,297,499
3405-000,2016,12,27,1,92,103,195,297
3405-000,2016,12,27,2,57,69,126,195
3405-000,2016,12,27,3,45,60,105,126
3405-000,2016,12,27,4,60,68,128,105
3405-000,2016,12,27,5,103,95,198,128
3405-000,2016,12,27,6,203,193,396,198
3405-000,2016,12,27,7,482,441,923,396
3405-000,2016,12,27,8,1059,1193,2252,923
3405-000,2016,12,27,9,1349,1242,2591,2252
3405-000,2016,12,27,10,1126,918,2044,2591
3405-000,2016,12,27,11,1101,964,2065,2044
3405-000,2016,12,27,12,1054,933,1987,2065
3405-000,2016,12,27,13,899,795,1694,1987
3405-000,2016,12,27,14,1030,923,1953,1694
3405-000,2016,12,27,15,1152,966,2118,1953
3405-000,2016,12,27,16,1159,969,2128,2118
3405-000,2016,12,27,17,1132,927,2059,2128
3405-000,2016,12,27,18,1192,968,2160,2059
3405-000,2016,12,27,19,1025,908,1933,2160
3405-000,2016,12,27,20,704,641,1345,1933
3405-000,2016,12,27,21,577,516,1093,1345
3405-000,2016,12,27,22,419,409,828,1093
3405-000,2016,12,27,23,282,223,505,828
3405-000,2016,12,27,24,152,160,312,505
3405-000,2016,12,28,1,132,107,239,312
3405-000,2016,12,28,2,70,66,136,239
3405-000,2016,12,28,3,46,58,104,136
3405-000,2016,12,28,4,60,64,124,104
3405-000,2016,12,28,5,108,83,191,124
3405-000,2016,12,28,6,154,155,309,191
3405-000,2016,12,28,7,494,315,809,309
3405-000,2016,12,28,8,936,1144,2080,809
3405-000,2016,12,28,9,1326,1260,2586,2080
3405-000,2016,12,28,10,1081,946,2027,2586
3405-000,2016,12,28,11,1037,990,2027,2027
3405-000,2016,12,28,12,1052,855,1907,2027
3405-000,2016,12,28,13,888,799,1687,1907
3405-000,2016,12,28,14,1044,939,1983,1687
3405-000,2016,12,28,15,1147,930,2077,1983
3405-000,2016,12,28,16,1177,890,2067,2077
3405-000,2016,12,28,17,1130,940,2070,2067
3405-000,2016,12,28,18,1245,1069,2314,2070
3405-000,2016,12,28,19,1095,956,2051,2314
3405-000,2016,12,28,20,659,564,1223,2051
3405-000,2016,12,28,21,507,453,960,1223
3405-000,2016,12,28,22,403,360,763,960
3405-000,2016,12,28,23,248,211,459,763
3405-000,2016,12,28,24,160,160,320,459
3405-000,2016,12,29,1,109,109,218,320
3405-000,2016,12,29,2,80,86,166,218
3405-000,2016,12,29,3,65,70,135,166
3405-000,2016,12,29,4,62,70,132,135
3405-000,2016,12,29,5,97,99,196,132
3405-000,2016,12,29,6,167,151,318,196
3405-000,2016,12,29,7,409,356,765,318
3405-000,2016,12,29,8,902,1013,1915,765
3405-000,2016,12,29,9,1263,1190,2453,1915
3405-000,2016,12,29,10,949,955,1904,2453
3405-000,2016,12,29,11,1083,899,1982,1904
3405-000,2016,12,29,12,1019,796,1815,1982
3405-000,2016,12,29,13,855,755,1610,1815
3405-000,2016,12,29,14,993,855,1848,1610
3405-000,2016,12,29,15,1194,978,2172,1848
3405-000,2016,12,29,16,1169,851,2020,2172
3405-000,2016,12,29,17,1119,871,1990,2020
3405-000,2016,12,29,18,1079,914,1993,1990
3405-000,2016,12,29,19,1265,812,2077,1993
3405-000,2016,12,29,20,651,542,1193,2077
3405-000,2016,12,29,21,522,428,950,1193
3405-000,2016,12,29,22,409,363,772,950
3405-000,2016,12,29,23,290,231,521,772
3405-000,2016,12,29,24,164,173,337,521
3405-000,2016,12,30,1,135,115,250,337
3405-000,2016,12,30,2,83,82,165,250
3405-000,2016,12,30,3,47,52,99,165
3405-000,2016,12,30,4,60,67,127,99
3405-000,2016,12,30,5,88,95,183,127
3405-000,2016,12,30,6,177,183,360,183
3405-000,2016,12,30,7,356,344,700,360
3405-000,2016,12,30,8,959,1061,2020,700
3405-000,2016,12,30,9,1228,1019,2247,2020
3405-000,2016,12,30,10,978,810,1788,2247
3405-000,2016,12,30,11,1017,860,1877,1788
3405-000,2016,12,30,12,977,845,1822,1877
3405-000,2016,12,30,13,907,749,1656,1822
3405-000,2016,12,30,14,1049,890,1939,1656
3405-000,2016,12,30,15,1150,831,1981,1939
3405-000,2016,12,30,16,1204,949,2153,1981
3405-000,2016,12,30,17,1186,913,2099,2153
3405-000,2016,12,30,18,1338,1011,2349,2099
3405-000,2016,12,30,19,1251,850,2101,2349
3405-000,2016,12,30,20,721,563,1284,2101
3405-000,2016,12,30,21,549,428,977,1284
3405-000,2016,12,30,22,432,321,753,977
3405-000,2016,12,30,23,281,210,491,753
3405-000,2016,12,30,24,179,135,314,491
3405-000,2016,12,31,1,107,114,221,314
3405-000,2016,12,31,2,92,68,160,221
3405-000,2016,12,31,3,68,55,123,160
3405-000,2016,12,31,4,61,57,118,123
3405-000,2016,12,31,5,74,75,149,118
3405-000,2016,12,31,6,137,102,239,149
3405-000,2016,12,31,7,246,210,456,239
3405-000,2016,12,31,8,480,387,867,456
3405-000,2016,12,31,9,680,516,1196,867
3405-000,2016,12,31,10,720,537,1257,1196
3405-000,2016,12,31,11,803,611,1414,1257
3405-000,2016,12,31,12,883,642,1525,1414
3405-000,2016,12,31,13,789,682,1471,1525
3405-000,2016,12,31,14,807,616,1423,1471
3405-000,2016,12,31,15,879,700,1579,1423
3405-000,2016,12,31,16,887,656,1543,1579
3405-000,2016,12,31,17,894,689,1583,1543
3405-000,2016,12,31,18,880,659,1539,1583
3405-000,2016,12,31,19,710,498,1208,1539
3405-000,2016,12,31,20,461,346,807,1208
3405-000,2016,12,31,21,295,235,530,807
3405-000,2016,12,31,22,241,213,454,530
3405-000,2016,12,31,23,189,156,345,454
3405-000,2016,12,31,24,118,128,246,345
3405-000,2017,1,1,1,109,74,183,246
3405-000,2017,1,1,2,73,71,144,183
3405-000,2017,1,1,3,64,57,121,144
3405-000,2017,1,1,4,47,46,93,121
3405-000,2017,1,1,5,52,53,105,93
3405-000,2017,1,1,6,84,58,142,105
3405-000,2017,1,1,7,126,95,221,142
3405-000,2017,1,1,8,192,114,306,221
3405-000,2017,1,1,9,264,199,463,306
3405-000,2017,1,1,10,350,244,594,463
3405-000,2017,1,1,11,429,322,751,594
3405-000,2017,1,1,12,506,365,871,751
3405-000,2017,1,1,13,517,464,981,871
3405-000,2017,1,1,14,550,539,1089,981
3405-000,2017,1,1,15,599,549,1148,1089
3405-000,2017,1,1,16,633,595,1228,1148
3405-000,2017,1,1,17,609,621,1230,1228
3405-000,2017,1,1,18,615,622,1237,1230
3405-000,2017,1,1,19,454,549,1003,1237
3405-000,2017,1,1,20,395,447,842,1003
3405-000,2017,1,1,21,315,449,764,842
3405-000,2017,1,1,22,258,345,603,764
3405-000,2017,1,1,23,195,306,501,603
3405-000,2017,1,1,24,102,203,305,501
3405-000,2017,1,2,1,64,128,192,305
3405-000,2017,1,2,2,53,60,113,192
3405-000,2017,1,2,3,33,45,78,113
3405-000,2017,1,2,4,42,45,87,78
3405-000,2017,1,2,5,81,75,156,87
3405-000,2017,1,2,6,175,194,369,156
3405-000,2017,1,2,7,492,466,958,369
3405-000,2017,1,2,8,986,1231,2217,958
3405-000,2017,1,2,9,1234,1227,2461,2217
3405-000,2017,1,2,10,889,715,1604,2461
3405-000,2017,1,2,11,908,817,1725,1604
3405-000,2017,1,2,12,896,821,1717,1725
3405-000,2017,1,2,13,770,660,1430,1717
3405-000,2017,1,2,14,887,806,1693,1430
3405-000,2017,1,2,15,1000,850,1850,1693
3405-000,2017,1,2,16,952,906,1858,1850
3405-000,2017,1,2,17,979,893,1872,1858
3405-000,2017,1,2,18,1001,936,1937,1872
3405-000,2017,1,2,19,876,877,1753,1937
3405-000,2017,1,2,20,578,561,1139,1753
3405-000,2017,1,2,21,434,489,923,1139
3405-000,2017,1,2,22,344,350,694,923
3405-000,2017,1,2,23,224,185,409,694
3405-000,2017,1,2,24,132,129,261,409
3405-000,2017,1,3,1,86,110,196,261
3405-000,2017,1,3,2,55,58,113,196
3405-000,2017,1,3,3,45,61,106,113
3405-000,2017,1,3,4,57,82,139,106
3405-000,2017,1,3,5,96,97,193,139
3405-000,2017,1,3,6,189,170,359,193
3405-000,2017,1,3,7,430,423,853,359
3405-000,2017,1,3,8,1006,1155,2161,853
3405-000,2017,1,3,9,1299,1213,2512,2161
3405-000,2017,1,3,10,1090,879,1969,2512
3405-000,2017,1,3,11,1097,936,2033,1969
3405-000,2017,1,3,12,1072,905,1977,2033
3405-000,2017,1,3,13,893,826,1719,1977
3405-000,2017,1,3,14,1011,893,1904,1719
3405-000,2017,1,3,15,1186,933,2119,1904
3405-000,2017,1,3,16,1133,964,2097,2119
3405-000,2017,1,3,17,1071,904,1975,2097
3405-000,2017,1,3,18,1167,947,2114,1975
3405-000,2017,1,3,19,997,931,1928,2114
3405-000,2017,1,3,20,694,601,1295,1928
3405-000,2017,1,3,21,525,539,1064,1295
3405-000,2017,1,3,22,411,387,798,1064
3405-000,2017,1,3,23,259,204,463,798
3405-000,2017,1,3,24,131,142,273,463
3405-000,2017,1,4,1,90,100,190,273
3405-000,2017,1,4,2,50,62,112,190
3405-000,2017,1,4,3,54,58,112,112
3405-000,2017,1,4,4,53,69,122,112
3405-000,2017,1,4,5,88,98,186,122
3405-000,2017,1,4,6,185,165,350,186
3405-000,2017,1,4,7,444,411,855,350
3405-000,2017,1,4,8,1012,1151,2163,855
3405-000,2017,1,4,9,1349,1180,2529,2163
3405-000,2017,1,4,10,1036,948,1984,2529
3405-000,2017,1,4,11,1097,936,2033,1984
3405-000,2017,1,4,12,997,880,1877,2033
3405-000,2017,1,4,13,877,734,1611,1877
3405-000,2017,1,4,14,948,883,1831,1611
3405-000,2017,1,4,15,1188,946,2134,1831
3405-000,2017,1,4,16,1186,924,2110,2134
3405-000,2017,1,4,17,1074,859,1933,2110
3405-000,2017,1,4,18,1192,1005,2197,1933
3405-000,2017,1,4,19,1094,1029,2123,2197
3405-000,2017,1,4,20,656,598,1254,2123
3405-000,2017,1,4,21,469,638,1107,1254
3405-000,2017,1,4,22,363,530,893,1107
3405-000,2017,1,4,23,230,202,432,893
3405-000,2017,1,4,24,150,143,293,432
3405-000,2017,1,5,1,101,98,199,293
3405-000,2017,1,5,2,54,61,115,199
3405-000,2017,1,5,3,48,57,105,115
3405-000,2017,1,5,4,68,70,138,105
3405-000,2017,1,5,5,86,74,160,138
3405-000,2017,1,5,6,193,181,374,160
3405-000,2017,1,5,7,450,400,850,374
3405-000,2017,1,5,8,999,1132,2131,850
3405-000,2017,1,5,9,1326,1235,2561,2131
3405-000,2017,1,5,10,1086,914,2000,2561
3405-000,2017,1,5,11,1098,883,1981,2000
3405-000,2017,1,5,12,1067,909,1976,1981
3405-000,2017,1,5,13,845,801,1646,1976
3405-000,2017,1,5,14,977,896,1873,1646
3405-000,2017,1,5,15,1133,924,2057,1873
3405-000,2017,1,5,16,1135,842,1977,2057
3405-000,2017,1,5,17,1057,875,1932,1977
3405-000,2017,1,5,18,1183,962,2145,1932
3405-000,2017,1,5,19,1019,895,1914,2145
3405-000,2017,1,5,20,654,574,1228,1914
3405-000,2017,1,5,21,551,508,1059,1228
3405-000,2017,1,5,22,376,416,792,1059
3405-000,2017,1,5,23,248,205,453,792
3405-000,2017,1,5,24,133,144,277,453
3405-000,2017,1,6,1,120,112,232,277
3405-000,2017,1,6,2,68,77,145,232
3405-000,2017,1,6,3,50,58,108,145
3405-000,2017,1,6,4,62,75,137,108
3405-000,2017,1,6,5,88,94,182,137
3405-000,2017,1,6,6,183,186,369,182
3405-000,2017,1,6,7,403,368,771,369
3405-000,2017,1,6,8,984,1114,2098,771
3405-000,2017,1,6,9,1282,1088,2370,2098
3405-000,2017,1,6,10,1029,858,1887,2370
3405-000,2017,1,6,11,1053,918,1971,1887
3405-000,2017,1,6,12,1042,866,1908,1971
3405-000,2017,1,6,13,910,766,1676,1908
3405-000,2017,1,6,14,1020,886,1906,1676
3405-000,2017,1,6,15,1015,881,1896,1906
3405-000,2017,1,6,16,1196,966,2162,1896
3405-000,2017,1,6,17,1193,971,2164,2162
3405-000,2017,1,6,18,1349,1067,2416,2164
3405-000,2017,1,6,19,1324,1058,2382,2416
3405-000,2017,1,6,20,909,718,1627,2382
3405-000,2017,1,6,21,677,572,1249,1627
3405-000,2017,1,6,22,401,404,805,1249
3405-000,2017,1,6,23,323,235,558,805
3405-000,2017,1,6,24,184,175,359,558
3405-000,2017,1,7,1,123,107,230,359
3405-000,2017,1,7,2,72,76,148,230
3405-000,2017,1,7,3,60,56,116,148
3405-000,2017,1,7,4,54,76,130,116
3405-000,2017,1,7,5,68,100,168,130
3405-000,2017,1,7,6,167,146,313,168
3405-000,2017,1,7,7,354,337,691,313
3405-000,2017,1,7,8,679,570,1249,691
3405-000,2017,1,7,9,889,659,1548,1249
3405-000,2017,1,7,10,857,648,1505,1548
3405-000,2017,1,7,11,894,724,1618,1505
3405-000,2017,1,7,12,897,702,1599,1618
3405-000,2017,1,7,13,771,699,1470,1599
3405-000,2017,1,7,14,767,652,1419,1470
3405-000,2017,1,7,15,894,741,1635,1419
3405-000,2017,1,7,16,891,749,1640,1635
3405-000,2017,1,7,17,897,724,1621,1640
3405-000,2017,1,7,18,1027,912,1939,1621
3405-000,2017,1,7,19,784,602,1386,1939
3405-000,2017,1,7,20,468,394,862,1386
3405-000,2017,1,7,21,351,305,656,862
3405-000,2017,1,7,22,270,255,525,656
3405-000,2017,1,7,23,200,208,408,525
3405-000,2017,1,7,24,132,148,280,408
3405-000,2017,1,8,1,89,103,192,280
3405-000,2017,1,8,2,69,57,126,192
3405-000,2017,1,8,3,49,44,93,126
3405-000,2017,1,8,4,30,35,65,93
3405-000,2017,1,8,5,36,47,83,65
3405-000,2017,1,8,6,83,72,155,83
3405-000,2017,1,8,7,162,122,284,155
3405-000,2017,1,8,8,248,269,517,284
3405-000,2017,1,8,9,399,309,708,517
3405-000,2017,1,8,10,473,311,784,708
3405-000,2017,1,8,11,493,399,892,784
3405-000,2017,1,8,12,473,457,930,892
3405-000,2017,1,8,13,471,472,943,930
3405-000,2017,1,8,14,504,501,1005,943
3405-000,2017,1,8,15,558,523,1081,1005
3405-000,2017,1,8,16,664,587,1251,1081
3405-000,2017,1,8,17,659,559,1218,1251
3405-000,2017,1,8,18,602,630,1232,1218
3405-000,2017,1,8,19,432,510,942,1232
3405-000,2017,1,8,20,336,383,719,942
3405-000,2017,1,8,21,306,326,632,719
3405-000,2017,1,8,22,242,303,545,632
3405-000,2017,1,8,23,150,242,392,545
3405-000,2017,1,8,24,98,131,229,392
3405-000,2017,1,9,1,63,101,164,229
3405-000,2017,1,9,2,44,60,104,164
3405-000,2017,1,9,3,30,51,81,104
3405-000,2017,1,9,4,49,77,126,81
3405-000,2017,1,9,5,113,91,204,126
3405-000,2017,1,9,6,195,203,398,204
3405-000,2017,1,9,7,540,554,1094,398
3405-000,2017,1,9,8,1110,1445,2555,1094
3405-000,2017,1,9,9,1334,1289,2623,2555
3405-000,2017,1,9,10,995,902,1897,2623
3405-000,2017,1,9,11,1026,841,1867,1897
3405-000,2017,1,9,12,969,896,1865,1867
3405-000,2017,1,9,13,824,859,1683,1865
3405-000,2017,1,9,14,928,887,1815,1683
3405-000,2017,1,9,15,1110,963,2073,1815
3405-000,2017,1,9,16,1126,959,2085,2073
3405-000,2017,1,9,17,1065,907,1972,2085
3405-000,2017,1,9,18,1139,966,2105,1972
3405-000,2017,1,9,19,987,895,1882,2105
3405-000,2017,1,9,20,687,641,1328,1882
3405-000,2017,1,9,21,512,548,1060,1328
3405-000,2017,1,9,22,397,408,805,1060
3405-000,2017,1,9,23,228,203,431,805
3405-000,2017,1,9,24,152,141,293,431
3405-000,2017,1,10,1,87,99,186,293
3405-000,2017,1,10,2,53,62,115,186
3405-000,2017,1,10,3,73,46,119,115
3405-000,2017,1,10,4,88,69,157,119
3405-000,2017,1,10,5,92,95,187,157
3405-000,2017,1,10,6,200,174,374,187
3405-000,2017,1,10,7,454,447,901,374
3405-000,2017,1,10,8,1073,1162,2235,901
3405-000,2017,1,10,9,1352,1178,2530,2235
3405-000,2017,1,10,10,1093,1030,2123,2530
3405-000,2017,1,10,11,975,964,1939,2123
3405-000,2017,1,10,12,1130,923,2053,1939
3405-000,2017,1,10,13,841,733,1574,2053
3405-000,2017,1,10,14,1006,994,2000,1574
3405-000,2017,1,10,15,1152,1007,2159,2000
3405-000,2017,1,10,16,1161,970,2131,2159
3405-000,2017,1,10,17,1081,914,1995,2131
3405-000,2017,1,10,18,1089,921,2010,1995
3405-000,2017,1,10,19,959,864,1823,2010
3405-000,2017,1,10,20,661,604,1265,1823
3405-000,2017,1,10,21,567,551,1118,1265
3405-000,2017,1,10,22,391,398,789,1118
3405-000,2017,1,10,23,264,201,465,789
3405-000,2017,1,10,24,127,146,273,465
3405-000,2017,1,11,1,98,113,211,273
3405-000,2017,1,11,2,52,68,120,211
3405-000,2017,1,11,3,37,57,94,120
3405-000,2017,1,11,4,50,85,135,94
3405-000,2017,1,11,5,91,95,186,135
3405-000,2017,1,11,6,192,184,376,186
3405-000,2017,1,11,7,468,423,891,376
3405-000,2017,1,11,8,1070,1108,2178,891
3405-000,2017,1,11,9,1350,1227,2577,2178
3405-000,2017,1,11,10,1085,951,2036,2577
3405-000,2017,1,11,11,1079,989,2068,2036
3405-000,2017,1,11,12,1082,942,2024,2068
3405-000,2017,1,11,13,859,810,1669,2024
3405-000,2017,1,11,14,1014,977,1991,1669
3405-000,2017,1,11,15,1169,1029,2198,1991
3405-000,2017,1,11,16,1114,943,2057,2198
3405-000,2017,1,11,17,1128,911,2039,2057
3405-000,2017,1,11,18,1218,960,2178,2039
3405-000,2017,1,11,19,1069,951,2020,2178
3405-000,2017,1,11,20,646,607,1253,2020
3405-000,2017,1,11,21,502,482,984,1253
3405-000,2017,1,11,22,384,386,770,984
3405-000,2017,1,11,23,278,178,456,770
3405-000,2017,1,11,24,143,145,288,456
3405-000,2017,1,12,1,87,98,185,288
3405-000,2017,1,12,2,50,71,121,185
3405-000,2017,1,12,3,42,54,96,121
3405-000,2017,1,12,4,52,76,128,96
3405-000,2017,1,12,5,79,85,164,128
3405-000,2017,1,12,6,197,186,383,164
3405-000,2017,1,12,7,445,385,830,383
3405-000,2017,1,12,8,1028,1147,2175,830
3405-000,2017,1,12,9,1271,1135,2406,2175
3405-000,2017,1,12,10,929,814,1743,2406
3405-000,2017,1,12,11,1031,895,1926,1743
3405-000,2017,1,12,12,1005,890,1895,1926
3405-000,2017,1,12,13,832,756,1588,1895
3405-000,2017,1,12,14,923,918,1841,1588
3405-000,2017,1,12,15,1052,977,2029,1841
3405-000,2017,1,12,16,1150,858,2008,2029
3405-000,2017,1,12,17,1046,926,1972,2008
3405-000,2017,1,12,18,1099,844,1943,1972
3405-000,2017,1,12,19,1015,885,1900,1943
3405-000,2017,1,12,20,631,621,1252,1900
3405-000,2017,1,12,21,536,510,1046,1252
3405-000,2017,1,12,22,365,387,752,1046
3405-000,2017,1,12,23,262,218,480,752
3405-000,2017,1,12,24,132,147,279,480
3405-000,2017,1,13,1,104,108,212,279
3405-000,2017,1,13,2,53,72,125,212
3405-000,2017,1,13,3,53,63,116,125
3405-000,2017,1,13,4,64,83,147,116
3405-000,2017,1,13,5,89,93,182,147
3405-000,2017,1,13,6,189,189,378,182
3405-000,2017,1,13,7,450,391,841,378
3405-000,2017,1,13,8,1008,1168,2176,841
3405-000,2017,1,13,9,1336,1156,2492,2176
3405-000,2017,1,13,10,1080,907,1987,2492
3405-000,2017,1,13,11,1089,977,2066,1987
3405-000,2017,1,13,12,1107,886,1993,2066
3405-000,2017,1,13,13,913,783,1696,1993
3405-000,2017,1,13,14,992,881,1873,1696
3405-000,2017,1,13,15,1210,1000,2210,1873
3405-000,2017,1,13,16,1105,942,2047,2210
3405-000,2017,1,13,17,1118,945,2063,2047
3405-000,2017,1,13,18,1262,971,2233,2063
3405-000,2017,1,13,19,1247,974,2221,2233
3405-000,2017,1,13,20,834,689,1523,2221
3405-000,2017,1,13,21,590,560,1150,1523
3405-000,2017,1,13,22,403,371,774,1150
3405-000,2017,1,13,23,268,216,484,774
3405-000,2017,1,13,24,163,148,311,484
3405-000,2017,1,14,1,109,111,220,311
3405-000,2017,1,14,2,70,64,134,220
3405-000,2017,1,14,3,50,47,97,134
3405-000,2017,1,14,4,56,72,128,97
3405-000,2017,1,14,5,78,86,164,128
3405-000,2017,1,14,6,176,141,317,164
3405-000,2017,1,14,7,289,256,545,317
3405-000,2017,1,14,8,623,542,1165,545
3405-000,2017,1,14,9,929,633,1562,1165
3405-000,2017,1,14,10,792,698,1490,1562
3405-000,2017,1,14,11,860,665,1525,1490
3405-000,2017,1,14,12,848,808,1656,1525
3405-000,2017,1,14,13,787,713,1500,1656
3405-000,2017,1,14,14,800,671,1471,1500
3405-000,2017,1,14,15,796,647,1443,1471
3405-000,2017,1,14,16,888,693,1581,1443
3405-000,2017,1,14,17,999,695,1694,1581
3405-000,2017,1,14,18,1017,779,1796,1694
3405-000,2017,1,14,19,801,604,1405,1796
3405-000,2017,1,14,20,455,412,867,1405
3405-000,2017,1,14,21,328,254,582,867
3405-000,2017,1,14,22,289,245,534,582
3405-000,2017,1,14,23,178,157,335,534
3405-000,2017,1,14,24,110,125,235,335
3405-000,2017,1,15,1,83,83,166,235
3405-000,2017,1,15,2,32,53,85,166
3405-000,2017,1,15,3,55,47,102,85
3405-000,2017,1,15,4,26,29,55,102
3405-000,2017,1,15,5,32,42,74,55
3405-000,2017,1,15,6,88,63,151,74
3405-000,2017,1,15,7,143,121,264,151
3405-000,2017,1,15,8,273,259,532,264
3405-000,2017,1,15,9,347,285,632,532
3405-000,2017,1,15,10,364,288,652,632
3405-000,2017,1,15,11,495,406,901,652
3405-000,2017,1,15,12,483,416,899,901
3405-000,2017,1,15,13,477,462,939,899
3405-000,2017,1,15,14,579,509,1088,939
3405-000,2017,1,15,15,599,525,1124,1088
3405-000,2017,1,15,16,660,587,1247,1124
3405-000,2017,1,15,17,612,638,1250,1247
3405-000,2017,1,15,18,592,629,1221,1250
3405-000,2017,1,15,19,465,443,908,1221
3405-000,2017,1,15,20,370,384,754,908
3405-000,2017,1,15,21,291,345,636,754
3405-000,2017,1,15,22,264,301,565,636
3405-000,2017,1,15,23,175,225,400,565
3405-000,2017,1,15,24,135,154,289,400
3405-000,2017,1,16,1,67,100,167,289
3405-000,2017,1,16,2,42,63,105,167
3405-000,2017,1,16,3,27,43,70,105
3405-000,2017,1,16,4,48,59,107,70
3405-000,2017,1,16,5,99,101,200,107
3405-000,2017,1,16,6,204,214,418,200
3405-000,2017,1,16,7,514,535,1049,418
3405-000,2017,1,16,8,1140,1379,2519,1049
3405-000,2017,1,16,9,1290,1308,2598,2519
3405-000,2017,1,16,10,1063,890,1953,2598
3405-000,2017,1,16,11,1085,980,2065,1953
3405-000,2017,1,16,12,1065,871,1936,2065
3405-000,2017,1,16,13,872,812,1684,1936
3405-000,2017,1,16,14,1001,983,1984,1684
3405-000,2017,1,16,15,1180,988,2168,1984
3405-000,2017,1,16,16,1208,996,2204,2168
3405-000,2017,1,16,17,1110,949,2059,2204
3405-000,2017,1,16,18,1186,986,2172,2059
3405-000,2017,1,16,19,1068,896,1964,2172
3405-000,2017,1,16,20,709,617,1326,1964
3405-000,2017,1,16,21,558,567,1125,1326
3405-000,2017,1,16,22,366,394,760,1125
3405-000,2017,1,16,23,234,214,448,760
3405-000,2017,1,16,24,126,147,273,448
3405-000,2017,1,17,1,84,98,182,273
3405-000,2017,1,17,2,52,76,128,182
3405-000,2017,1,17,3,40,52,92,128
3405-000,2017,1,17,4,55,69,124,92
3405-000,2017,1,17,5,89,97,186,124
3405-000,2017,1,17,6,165,171,336,186
3405-000,2017,1,17,7,477,412,889,336
3405-000,2017,1,17,8,1070,1173,2243,889
3405-000,2017,1,17,9,1330,1236,2566,2243
3405-000,2017,1,17,10,1078,966,2044,2566
3405-000,2017,1,17,11,1093,881,1974,2044
3405-000,2017,1,17,12,1081,877,1958,1974
3405-000,2017,1,17,13,923,890,1813,1958
3405-000,2017,1,17,14,1129,965,2094,1813
3405-000,2017,1,17,15,1120,986,2106,2094
3405-000,2017,1,17,16,1222,1012,2234,2106
3405-000,2017,1,17,17,1114,933,2047,2234
3405-000,2017,1,17,18,1168,1006,2174,2047
3405-000,2017,1,17,19,1062,879,1941,2174
3405-000,2017,1,17,20,722,647,1369,1941
3405-000,2017,1,17,21,544,562,1106,1369
3405-000,2017,1,17,22,396,382,778,1106
3405-000,2017,1,17,23,266,214,480,778
3405-000,2017,1,17,24,128,184,312,480
3405-000,2017,1,18,1,100,91,191,312
3405-000,2017,1,18,2,62,71,133,191
3405-000,2017,1,18,3,50,47,97,133
3405-000,2017,1,18,4,54,72,126,97
3405-000,2017,1,18,5,88,86,174,126
3405-000,2017,1,18,6,205,170,375,174
3405-000,2017,1,18,7,462,433,895,375
3405-000,2017,1,18,8,1041,1198,2239,895
3405-000,2017,1,18,9,1429,1273,2702,2239
3405-000,2017,1,18,10,1099,974,2073,2702
3405-000,2017,1,18,11,1068,1112,2180,2073
3405-000,2017,1,18,12,1129,873,2002,2180
3405-000,2017,1,18,13,910,799,1709,2002
3405-000,2017,1,18,14,1109,965,2074,1709
3405-000,2017,1,18,15,1178,1008,2186,2074
3405-000,2017,1,18,16,1132,990,2122,2186
3405-000,2017,1,18,17,1065,967,2032,2122
3405-000,2017,1,18,18,1206,1020,2226,2032
3405-000,2017,1,18,19,1076,933,2009,2226
3405-000,2017,1,18,20,652,611,1263,2009
3405-000,2017,1,18,21,482,479,961,1263
3405-000,2017,1,18,22,400,384,784,961
3405-000,2017,1,18,23,262,220,482,784
3405-000,2017,1,18,24,146,146,292,482
3405-000,2017,1,19,1,97,98,195,292
3405-000,2017,1,19,2,68,68,136,195
3405-000,2017,1,19,3,46,53,99,136
3405-000,2017,1,19,4,56,75,131,99
3405-000,2017,1,19,5,84,93,177,131
3405-000,2017,1,19,6,177,186,363,177
3405-000,2017,1,19,7,480,425,905,363
3405-000,2017,1,19,8,1068,1216,2284,905
3405-000,2017,1,19,9,1334,1236,2570,2284
3405-000,2017,1,19,10,1102,941,2043,2570
3405-000,2017,1,19,11,1121,945,2066,2043
3405-000,2017,1,19,12,1140,988,2128,2066
3405-000,2017,1,19,13,923,863,1786,2128
3405-000,2017,1,19,14,1035,969,2004,1786
3405-000,2017,1,19,15,1123,1063,2186,2004
3405-000,2017,1,19,16,1221,992,2213,2186
3405-000,2017,1,19,17,1201,984,2185,2213
3405-000,2017,1,19,18,1236,1039,2275,2185
3405-000,2017,1,19,19,1062,923,1985,2275
3405-000,2017,1,19,20,710,650,1360,1985
3405-000,2017,1,19,21,582,569,1151,1360
3405-000,2017,1,19,22,425,433,858,1151
3405-000,2017,1,19,23,265,232,497,858
3405-000,2017,1,19,24,177,178,355,497
3405-000,2017,1,20,1,99,118,217,355
3405-000,2017,1,20,2,55,85,140,217
3405-000,2017,1,20,3,36,66,102,140
3405-000,2017,1,20,4,56,68,124,102
3405-000,2017,1,20,5,65,79,144,124
3405-000,2017,1,20,6,144,130,274,144
3405-000,2017,1,20,7,363,294,657,274
3405-000,2017,1,20,8,793,786,1579,657
3405-000,2017,1,20,9,1025,933,1958,1579
3405-000,2017,1,20,10,799,753,1552,1958
3405-000,2017,1,20,11,806,774,1580,1552
3405-000,2017,1,20,12,900,716,1616,1580
3405-000,2017,1,20,13,770,738,1508,1616
3405-000,2017,1,20,14,906,847,1753,1508
3405-000,2017,1,20,15,1094,926,2020,1753
3405-000,2017,1,20,16,1112,822,1934,2020
3405-000,2017,1,20,17,1050,840,1890,1934
3405-000,2017,1,20,18,1161,914,2075,1890
3405-000,2017,1,20,19,1143,879,2022,2075
3405-000,2017,1,20,20,796,580,1376,2022
3405-000,2017,1,20,21,530,455,985,1376
3405-000,2017,1,20,22,318,305,623,985
3405-000,2017,1,20,23,256,208,464,623
3405-000,2017,1,20,24,129,128,257,464
3405-000,2017,1,21,1,110,87,197,257
3405-000,2017,1,21,2,70,64,134,197
3405-000,2017,1,21,3,54,51,105,134
3405-000,2017,1,21,4,47,68,115,105
3405-000,2017,1,21,5,80,87,167,115
3405-000,2017,1,21,6,164,127,291,167
3405-000,2017,1,21,7,328,265,593,291
3405-000,2017,1,21,8,652,552,1204,593
3405-000,2017,1,21,9,868,662,1530,1204
3405-000,2017,1,21,10,847,661,1508,1530
3405-000,2017,1,21,11,866,701,1567,1508
3405-000,2017,1,21,12,889,644,1533,1567
3405-000,2017,1,21,13,767,664,1431,1533
3405-000,2017,1,21,14,771,694,1465,1431
3405-000,2017,1,21,15,889,700,1589,1465
3405-000,2017,1,21,16,877,692,1569,1589
3405-000,2017,1,21,17,901,721,1622,1569
3405-000,2017,1,21,18,994,764,1758,1622
3405-000,2017,1,21,19,697,536,1233,1758
3405-000,2017,1,21,20,405,345,750,1233
3405-000,2017,1,21,21,294,279,573,750
3405-000,2017,1,21,22,212,195,407,573
3405-000,2017,1,21,23,149,120,269,407
3405-000,2017,1,21,24,96,105,201,269
3405-000,2017,1,22,1,45,53,98,201
3405-000,2017,1,22,2,33,31,64,98
3405-000,2017,1,22,3,32,24,56,64
3405-000,2017,1,22,4,22,22,44,56
3405-000,2017,1,22,5,37,42,79,44
3405-000,2017,1,22,6,61,40,101,79
3405-000,2017,1,22,7,116,103,219,101
3405-000,2017,1,22,8,202,185,387,219
3405-000,2017,1,22,9,294,256,550,387
3405-000,2017,1,22,10,292,255,547,550
3405-000,2017,1,22,11,417,307,724,547
3405-000,2017,1,22,12,399,348,747,724
3405-000,2017,1,22,13,450,381,831,747
3405-000,2017,1,22,14,454,452,906,831
3405-000,2017,1,22,15,455,519,974,906
3405-000,2017,1,22,16,472,519,991,974
3405-000,2017,1,22,17,485,482,967,991
3405-000,2017,1,22,18,472,517,989,967
3405-000,2017,1,22,19,418,419,837,989
3405-000,2017,1,22,20,285,323,608,837
3405-000,2017,1,22,21,244,279,523,608
3405-000,2017,1,22,22,206,240,446,523
3405-000,2017,1,22,23,135,184,319,446
3405-000,2017,1,22,24,92,143,235,319
3405-000,2017,1,23,1,46,82,128,235
3405-000,2017,1,23,2,32,65,97,128
3405-000,2017,1,23,3,28,46,74,97
3405-000,2017,1,23,4,54,68,122,74
3405-000,2017,1,23,5,91,93,184,122
3405-000,2017,1,23,6,184,205,389,184
3405-000,2017,1,23,7,506,497,1003,389
3405-000,2017,1,23,8,1011,1340,2351,1003
3405-000,2017,1,23,9,1262,1239,2501,2351
3405-000,2017,1,23,10,1084,914,1998,2501
3405-000,2017,1,23,11,1142,956,2098,1998
3405-000,2017,1,23,12,1078,942,2020,2098
3405-000,2017,1,23,13,962,868,1830,2020
3405-000,2017,1,23,14,1080,990,2070,1830
3405-000,2017,1,23,15,1184,1115,2299,2070
3405-000,2017,1,23,16,1259,991,2250,2299
3405-000,2017,1,23,17,1202,978,2180,2250
3405-000,2017,1,23,18,1242,962,2204,2180
3405-000,2017,1,23,19,1069,948,2017,2204
3405-000,2017,1,23,20,705,651,1356,2017
3405-000,2017,1,23,21,540,571,1111,1356
3405-000,2017,1,23,22,390,370,760,1111
3405-000,2017,1,23,23,242,203,445,760
3405-000,2017,1,23,24,137,149,286,445
3405-000,2017,1,24,1,99,93,192,286
3405-000,2017,1,24,2,52,75,127,192
3405-000,2017,1,24,3,42,64,106,127
3405-000,2017,1,24,4,67,91,158,106
3405-000,2017,1,24,5,82,96,178,158
3405-000,2017,1,24,6,195,170,365,178
3405-000,2017,1,24,7,430,410,840,365
3405-000,2017,1,24,8,1015,1178,2193,840
3405-000,2017,1,24,9,1325,1221,2546,2193
3405-000,2017,1,24,10,1077,975,2052,2546
3405-000,2017,1,24,11,1140,1034,2174,2052
3405-000,2017,1,24,12,1081,940,2021,2174
3405-000,2017,1,24,13,971,882,1853,2021
3405-000,2017,1,24,14,1186,981,2167,1853
3405-000,2017,1,24,15,1176,1097,2273,2167
3405-000,2017,1,24,16,1251,1043,2294,2273
3405-000,2017,1,24,17,1221,990,2211,2294
3405-000,2017,1,24,18,1234,969,2203,2211
3405-000,2017,1,24,19,1060,989,2049,2203
3405-000,2017,1,24,20,754,669,1423,2049
3405-000,2017,1,24,21,551,563,1114,1423
3405-000,2017,1,24,22,401,396,797,1114
3405-000,2017,1,24,23,243,227,470,797
3405-000,2017,1,24,24,175,155,330,470
3405-000,2017,1,25,1,108,107,215,330
3405-000,2017,1,25,2,56,77,133,215
3405-000,2017,1,25,3,46,55,101,133
3405-000,2017,1,25,4,53,82,135,101
3405-000,2017,1,25,5,102,94,196,135
3405-000,2017,1,25,6,189,165,354,196
3405-000,2017,1,25,7,435,416,851,354
3405-000,2017,1,25,8,1046,1152,2198,851
3405-000,2017,1,25,9,1301,1187,2488,2198
3405-000,2017,1,25,10,1090,962,2052,2488
3405-000,2017,1,25,11,1175,1039,2214,2052
3405-000,2017,1,25,12,1134,1005,2139,2214
3405-000,2017,1,25,13,983,862,1845,2139
3405-000,2017,1,25,14,1167,1051,2218,1845
3405-000,2017,1,25,15,1340,1100,2440,2218
3405-000,2017,1,25,16,1300,1030,2330,2440
3405-000,2017,1,25,17,1208,1002,2210,2330
3405-000,2017,1,25,18,1376,1125,2501,2210
3405-000,2017,1,25,19,1233,966,2199,2501
3405-000,2017,1,25,20,832,718,1550,2199
3405-000,2017,1,25,21,557,509,1066,1550
3405-000,2017,1,25,22,414,399,813,1066
3405-000,2017,1,25,23,270,255,525,813
3405-000,2017,1,25,24,174,146,320,525
3405-000,2017,1,26,1,100,112,212,320
3405-000,2017,1,26,2,73,82,155,212
3405-000,2017,1,26,3,50,68,118,155
3405-000,2017,1,26,4,64,77,141,118
3405-000,2017,1,26,5,102,102,204,141
3405-000,2017,1,26,6,169,143,312,204
3405-000,2017,1,26,7,388,333,721,312
3405-000,2017,1,26,8,950,1060,2010,721
3405-000,2017,1,26,9,1201,1118,2319,2010
3405-000,2017,1,26,10,1025,847,1872,2319
3405-000,2017,1,26,11,1080,927,2007,1872
3405-000,2017,1,26,12,1110,901,2011,2007
3405-000,2017,1,26,13,1035,948,1983,2011
3405-000,2017,1,26,14,1063,1157,2220,1983
3405-000,2017,1,26,15,1309,1097,2406,2220
3405-000,2017,1,26,16,1590,1164,2754,2406
3405-000,2017,1,26,17,1540,1158,2698,2754
3405-000,2017,1,26,18,1517,1462,2979,2698
3405-000,2017,1,26,19,1239,1013,2252,2979
3405-000,2017,1,26,20,888,901,1789,2252
3405-000,2017,1,26,21,641,682,1323,1789
3405-000,2017,1,26,22,368,410,778,1323
3405-000,2017,1,26,23,279,225,504,778
3405-000,2017,1,26,24,196,204,400,504
3405-000,2017,1,27,1,130,102,232,400
3405-000,2017,1,27,2,102,97,199,232
3405-000,2017,1,27,3,79,69,148,199
3405-000,2017,1,27,4,75,77,152,148
3405-000,2017,1,27,5,86,77,163,152
3405-000,2017,1,27,6,161,84,245,163
3405-000,2017,1,27,7,226,141,367,245
3405-000,2017,1,27,8,348,223,571,367
3405-000,2017,1,27,9,465,307,772,571
3405-000,2017,1,27,10,566,351,917,772
3405-000,2017,1,27,11,772,431,1203,917
3405-000,2017,1,27,12,755,514,1269,1203
3405-000,2017,1,27,13,764,485,1249,1269
3405-000,2017,1,27,14,645,413,1058,1249
3405-000,2017,1,27,15,584,446,1030,1058
3405-000,2017,1,27,16,567,423,990,1030
3405-000,2017,1,27,17,506,391,897,990
3405-000,2017,1,27,18,473,368,841,897
3405-000,2017,1,27,19,383,334,717,841
3405-000,2017,1,27,20,296,214,510,717
3405-000,2017,1,27,21,235,202,437,510
3405-000,2017,1,27,22,155,152,307,437
3405-000,2017,1,27,23,93,117,210,307
3405-000,2017,1,27,24,76,76,152,210
3405-000,2017,1,28,1,42,38,80,152
3405-000,2017,1,28,2,37,18,55,80
3405-000,2017,1,28,3,14,12,26,55
3405-000,2017,1,28,4,33,17,50,26
3405-000,2017,1,28,5,31,18,49,50
3405-000,2017,1,28,6,117,41,158,49
3405-000,2017,1,28,7,228,119,347,158
3405-000,2017,1,28,8,388,242,630,347
3405-000,2017,1,28,9,409,229,638,630
3405-000,2017,1,28,10,489,240,729,638
3405-000,2017,1,28,11,851,401,1252,729
3405-000,2017,1,28,12,1314,677,1991,1252
3405-000,2017,1,28,13,1075,748,1823,1991
3405-000,2017,1,28,14,1099,837,1936,1823
3405-000,2017,1,28,15,1037,866,1903,1936
3405-000,2017,1,28,16,765,953,1718,1903
3405-000,2017,1,28,17,823,1037,1860,1718
3405-000,2017,1,28,18,788,1011,1799,1860
3405-000,2017,1,28,19,541,613,1154,1799
3405-000,2017,1,28,20,357,462,819,1154
3405-000,2017,1,28,21,281,324,605,819
3405-000,2017,1,28,22,232,312,544,605
3405-000,2017,1,28,23,171,190,361,544
3405-000,2017,1,28,24,127,138,265,361
3405-000,2017,1,29,1,70,102,172,265
3405-000,2017,1,29,2,38,58,96,172
3405-000,2017,1,29,3,28,46,74,96
3405-000,2017,1,29,4,27,30,57,74
3405-000,2017,1,29,5,21,23,44,57
3405-000,2017,1,29,6,51,42,93,44
3405-000,2017,1,29,7,79,53,132,93
3405-000,2017,1,29,8,112,132,244,132
3405-000,2017,1,29,9,233,157,390,244
3405-000,2017,1,29,10,328,232,560,390
3405-000,2017,1,29,11,418,328,746,560
3405-000,2017,1,29,12,494,473,967,746
3405-000,2017,1,29,13,574,500,1074,967
3405-000,2017,1,29,14,554,520,1074,1074
3405-000,2017,1,29,15,614,539,1153,1074
3405-000,2017,1,29,16,642,613,1255,1153
3405-000,2017,1,29,17,698,586,1284,1255
3405-000,2017,1,29,18,562,561,1123,1284
3405-000,2017,1,29,19,422,487,909,1123
3405-000,2017,1,29,20,319,377,696,909
3405-000,2017,1,29,21,287,283,570,696
3405-000,2017,1,29,22,205,216,421,570
3405-000,2017,1,29,23,141,152,293,421
3405-000,2017,1,29,24,105,109,214,293
3405-000,2017,1,30,1,74,60,134,214
3405-000,2017,1,30,2,87,56,143,134
3405-000,2017,1,30,3,38,38,76,143
3405-000,2017,1,30,4,37,30,67,76
3405-000,2017,1,30,5,102,28,130,67
3405-000,2017,1,30,6,125,51,176,130
3405-000,2017,1,30,7,116,87,203,176
3405-000,2017,1,30,8,258,198,456,203
3405-000,2017,1,30,9,375,198,573,456
3405-000,2017,1,30,10,346,210,556,573
3405-000,2017,1,30,11,450,312,762,556
3405-000,2017,1,30,12,505,348,853,762
3405-000,2017,1,30,13,491,477,968,853
3405-000,2017,1,30,14,538,523,1061,968
3405-000,2017,1,30,15,605,558,1163,1061
3405-000,2017,1,30,16,569,552,1121,1163
3405-000,2017,1,30,17,514,587,1101,1121
3405-000,2017,1,30,18,483,635,1118,1101
3405-000,2017,1,30,19,420,471,891,1118
3405-000,2017,1,30,20,331,351,682,891
3405-000,2017,1,30,21,280,312,592,682
3405-000,2017,1,30,22,181,277,458,592
3405-000,2017,1,30,23,156,202,358,458
3405-000,2017,1,30,24,99,158,257,358
3405-000,2017,1,31,1,61,95,156,257
3405-000,2017,1,31,2,35,56,91,156
3405-000,2017,1,31,3,31,44,75,91
3405-000,2017,1,31,4,36,44,80,75
3405-000,2017,1,31,5,75,63,138,80
3405-000,2017,1,31,6,171,139,310,138
3405-000,2017,1,31,7,408,389,797,310
3405-000,2017,1,31,8,934,1114,2048,797
3405-000,2017,1,31,9,1090,1056,2146,2048
3405-000,2017,1,31,10,787,663,1450,2146
3405-000,2017,1,31,11,870,742,1612,1450
3405-000,2017,1,31,12,810,733,1543,1612
3405-000,2017,1,31,13,762,720,1482,1543
3405-000,2017,1,31,14,828,797,1625,1482
3405-000,2017,1,31,15,908,775,1683,1625
3405-000,2017,1,31,16,949,791,1740,1683
3405-000,2017,1,31,17,836,769,1605,1740
3405-000,2017,1,31,18,984,816,1800,1605
3405-000,2017,1,31,19,831,864,1695,1800
3405-000,2017,1,31,20,593,582,1175,1695
3405-000,2017,1,31,21,442,491,933,1175
3405-000,2017,1,31,22,318,373,691,933
3405-000,2017,1,31,23,202,225,427,691
3405-000,2017,1,31,24,133,152,285,427
3405-000,2017,2,1,1,79,92,171,285
3405-000,2017,2,1,2,56,73,129,171
3405-000,2017,2,1,3,40,48,88,129
3405-000,2017,2,1,4,57,67,124,88
3405-000,2017,2,1,5,98,105,203,124
3405-000,2017,2,1,6,174,194,368,203
3405-000,2017,2,1,7,464,452,916,368
3405-000,2017,2,1,8,989,1230,2219,916
3405-000,2017,2,1,9,1254,1175,2429,2219
3405-000,2017,2,1,10,943,886,1829,2429
3405-000,2017,2,1,11,998,879,1877,1829
3405-000,2017,2,1,12,942,876,1818,1877
3405-000,2017,2,1,13,857,760,1617,1818
3405-000,2017,2,1,14,961,834,1795,1617
3405-000,2017,2,1,15,995,946,1941,1795
3405-000,2017,2,1,16,1071,863,1934,1941
3405-000,2017,2,1,17,1037,841,1878,1934
3405-000,2017,2,1,18,1087,930,2017,1878
3405-000,2017,2,1,19,1024,862,1886,2017
3405-000,2017,2,1,20,663,598,1261,1886
3405-000,2017,2,1,21,448,474,922,1261
3405-000,2017,2,1,22,343,326,669,922
3405-000,2017,2,1,23,252,215,467,669
3405-000,2017,2,1,24,137,161,298,467
3405-000,2017,2,2,1,96,123,219,298
3405-000,2017,2,2,2,68,69,137,219
3405-000,2017,2,2,3,45,56,101,137
3405-000,2017,2,2,4,51,51,102,101
3405-000,2017,2,2,5,85,98,183,102
3405-000,2017,2,2,6,175,183,358,183
3405-000,2017,2,2,7,479,426,905,358
3405-000,2017,2,2,8,1057,1233,2290,905
3405-000,2017,2,2,9,1300,1159,2459,2290
3405-000,2017,2,2,10,1020,879,1899,2459
3405-000,2017,2,2,11,1052,923,1975,1899
3405-000,2017,2,2,12,934,890,1824,1975
3405-000,2017,2,2,13,873,754,1627,1824
3405-000,2017,2,2,14,915,938,1853,1627
3405-000,2017,2,2,15,1099,940,2039,1853
3405-000,2017,2,2,16,1102,891,1993,2039
3405-000,2017,2,2,17,1052,857,1909,1993
3405-000,2017,2,2,18,1094,936,2030,1909
3405-000,2017,2,2,19,1043,880,1923,2030
3405-000,2017,2,2,20,663,571,1234,1923
3405-000,2017,2,2,21,528,547,1075,1234
3405-000,2017,2,2,22,384,376,760,1075
3405-000,2017,2,2,23,246,202,448,760
3405-000,2017,2,2,24,141,132,273,448
3405-000,2017,2,3,1,107,103,210,273
3405-000,2017,2,3,2,45,68,113,210
3405-000,2017,2,3,3,46,55,101,113
3405-000,2017,2,3,4,56,50,106,101
3405-000,2017,2,3,5,77,91,168,106
3405-000,2017,2,3,6,169,183,352,168
3405-000,2017,2,3,7,463,403,866,352
3405-000,2017,2,3,8,1025,1201,2226,866
3405-000,2017,2,3,9,1334,1235,2569,2226
3405-000,2017,2,3,10,1051,883,1934,2569
3405-000,2017,2,3,11,1070,981,2051,1934
3405-000,2017,2,3,12,1074,927,2001,2051
3405-000,2017,2,3,13,871,753,1624,2001
3405-000,2017,2,3,14,967,926,1893,1624
3405-000,2017,2,3,15,1186,921,2107,1893
3405-000,2017,2,3,16,1145,870,2015,2107
3405-000,2017,2,3,17,1134,896,2030,2015
3405-000,2017,2,3,18,1340,995,2335,2030
3405-000,2017,2,3,19,1351,1040,2391,2335
3405-000,2017,2,3,20,829,709,1538,2391
3405-000,2017,2,3,21,612,492,1104,1538
3405-000,2017,2,3,22,457,414,871,1104
3405-000,2017,2,3,23,248,239,487,871
3405-000,2017,2,3,24,129,163,292,487
3405-000,2017,2,4,1,92,105,197,292
3405-000,2017,2,4,2,72,71,143,197
3405-000,2017,2,4,3,46,58,104,143
3405-000,2017,2,4,4,63,68,131,104
3405-000,2017,2,4,5,74,101,175,131
3405-000,2017,2,4,6,155,139,294,175
3405-000,2017,2,4,7,335,286,621,294
3405-000,2017,2,4,8,718,542,1260,621
3405-000,2017,2,4,9,931,761,1692,1260
3405-000,2017,2,4,10,850,661,1511,1692
3405-000,2017,2,4,11,903,695,1598,1511
3405-000,2017,2,4,12,820,727,1547,1598
3405-000,2017,2,4,13,752,663,1415,1547
3405-000,2017,2,4,14,794,679,1473,1415
3405-000,2017,2,4,15,822,757,1579,1473
3405-000,2017,2,4,16,819,694,1513,1579
3405-000,2017,2,4,17,909,698,1607,1513
3405-000,2017,2,4,18,951,818,1769,1607
3405-000,2017,2,4,19,736,575,1311,1769
3405-000,2017,2,4,20,426,352,778,1311
3405-000,2017,2,4,21,323,296,619,778
3405-000,2017,2,4,22,210,215,425,619
3405-000,2017,2,4,23,181,171,352,425
3405-000,2017,2,4,24,107,125,232,352
3405-000,2017,2,5,1,75,59,134,232
3405-000,2017,2,5,2,32,42,74,134
3405-000,2017,2,5,3,44,34,78,74
3405-000,2017,2,5,4,30,45,75,78
3405-000,2017,2,5,5,39,35,74,75
3405-000,2017,2,5,6,67,58,125,74
3405-000,2017,2,5,7,136,123,259,125
3405-000,2017,2,5,8,234,206,440,259
3405-000,2017,2,5,9,393,276,669,440
3405-000,2017,2,5,10,429,293,722,669
3405-000,2017,2,5,11,495,406,901,722
3405-000,2017,2,5,12,451,465,916,901
3405-000,2017,2,5,13,461,511,972,916
3405-000,2017,2,5,14,481,484,965,972
3405-000,2017,2,5,15,512,517,1029,965
3405-000,2017,2,5,16,542,526,1068,1029
3405-000,2017,2,5,17,529,531,1060,1068
3405-000,2017,2,5,18,502,544,1046,1060
3405-000,2017,2,5,19,422,454,876,1046
3405-000,2017,2,5,20,320,343,663,876
3405-000,2017,2,5,21,255,252,507,663
3405-000,2017,2,5,22,194,259,453,507
3405-000,2017,2,5,23,146,181,327,453
3405-000,2017,2,5,24,89,138,227,327
3405-000,2017,2,6,1,56,100,156,227
3405-000,2017,2,6,2,33,62,95,156
3405-000,2017,2,6,3,37,47,84,95
3405-000,2017,2,6,4,57,51,108,84
3405-000,2017,2,6,5,83,81,164,108
3405-000,2017,2,6,6,206,217,423,164
3405-000,2017,2,6,7,538,505,1043,423
3405-000,2017,2,6,8,1114,1427,2541,1043
3405-000,2017,2,6,9,1328,1289,2617,2541
3405-000,2017,2,6,10,1006,903,1909,2617
3405-000,2017,2,6,11,1055,953,2008,1909
3405-000,2017,2,6,12,997,914,1911,2008
3405-000,2017,2,6,13,829,783,1612,1911
3405-000,2017,2,6,14,991,967,1958,1612
3405-000,2017,2,6,15,1139,1016,2155,1958
3405-000,2017,2,6,16,1193,938,2131,2155
3405-000,2017,2,6,17,1053,909,1962,2131
3405-000,2017,2,6,18,1160,945,2105,1962
3405-000,2017,2,6,19,990,930,1920,2105
3405-000,2017,2,6,20,665,620,1285,1920
3405-000,2017,2,6,21,535,520,1055,1285
3405-000,2017,2,6,22,360,372,732,1055
3405-000,2017,2,6,23,229,187,416,732
3405-000,2017,2,6,24,124,142,266,416
3405-000,2017,2,7,1,81,98,179,266
3405-000,2017,2,7,2,45,62,107,179
3405-000,2017,2,7,3,33,66,99,107
3405-000,2017,2,7,4,54,59,113,99
3405-000,2017,2,7,5,86,108,194,113
3405-000,2017,2,7,6,166,161,327,194
3405-000,2017,2,7,7,456,385,841,327
3405-000,2017,2,7,8,1073,1241,2314,841
3405-000,2017,2,7,9,1301,1215,2516,2314
3405-000,2017,2,7,10,1098,929,2027,2516
3405-000,2017,2,7,11,1066,944,2010,2027
3405-000,2017,2,7,12,999,840,1839,2010
3405-000,2017,2,7,13,839,819,1658,1839
3405-000,2017,2,7,14,1038,905,1943,1658
3405-000,2017,2,7,15,1059,915,1974,1943
3405-000,2017,2,7,16,1140,942,2082,1974
3405-000,2017,2,7,17,1039,870,1909,2082
3405-000,2017,2,7,18,1149,971,2120,1909
3405-000,2017,2,7,19,992,949,1941,2120
3405-000,2017,2,7,20,671,618,1289,1941
3405-000,2017,2,7,21,547,482,1029,1289
3405-000,2017,2,7,22,370,342,712,1029
3405-000,2017,2,7,23,215,226,441,712
3405-000,2017,2,7,24,140,148,288,441
3405-000,2017,2,8,1,114,111,225,288
3405-000,2017,2,8,2,52,56,108,225
3405-000,2017,2,8,3,48,48,96,108
3405-000,2017,2,8,4,59,71,130,96
3405-000,2017,2,8,5,110,92,202,130
3405-000,2017,2,8,6,183,165,348,202
3405-000,2017,2,8,7,458,462,920,348
3405-000,2017,2,8,8,1075,1179,2254,920
3405-000,2017,2,8,9,1340,1217,2557,2254
3405-000,2017,2,8,10,1042,978,2020,2557
3405-000,2017,2,8,11,1108,956,2064,2020
3405-000,2017,2,8,12,1050,856,1906,2064
3405-000,2017,2,8,13,862,806,1668,1906
3405-000,2017,2,8,14,1089,946,2035,1668
3405-000,2017,2,8,15,1150,946,2096,2035
3405-000,2017,2,8,16,1135,938,2073,2096
3405-000,2017,2,8,17,1056,918,1974,2073
3405-000,2017,2,8,18,1213,977,2190,1974
3405-000,2017,2,8,19,1062,915,1977,2190
3405-000,2017,2,8,20,623,584,1207,1977
3405-000,2017,2,8,21,446,487,933,1207
3405-000,2017,2,8,22,323,345,668,933
3405-000,2017,2,8,23,236,175,411,668
3405-000,2017,2,8,24,147,152,299,411
3405-000,2017,2,9,1,94,104,198,299
3405-000,2017,2,9,2,59,47,106,198
3405-000,2017,2,9,3,42,43,85,106
3405-000,2017,2,9,4,57,78,135,85
3405-000,2017,2,9,5,87,96,183,135
3405-000,2017,2,9,6,201,203,404,183
3405-000,2017,2,9,7,461,429,890,404
3405-000,2017,2,9,8,1057,1177,2234,890
3405-000,2017,2,9,9,1251,1190,2441,2234
3405-000,2017,2,9,10,1020,893,1913,2441
3405-000,2017,2,9,11,1075,919,1994,1913
3405-000,2017,2,9,12,974,856,1830,1994
3405-000,2017,2,9,13,817,791,1608,1830
3405-000,2017,2,9,14,968,837,1805,1608
3405-000,2017,2,9,15,1126,946,2072,1805
3405-000,2017,2,9,16,1090,902,1992,2072
3405-000,2017,2,9,17,1045,929,1974,1992
3405-000,2017,2,9,18,1125,1002,2127,1974
3405-000,2017,2,9,19,937,882,1819,2127
3405-000,2017,2,9,20,639,607,1246,1819
3405-000,2017,2,9,21,543,525,1068,1246
3405-000,2017,2,9,22,383,361,744,1068
3405-000,2017,2,9,23,252,210,462,744
3405-000,2017,2,9,24,161,134,295,462
3405-000,2017,2,10,1,83,97,180,295
3405-000,2017,2,10,2,66,63,129,180
3405-000,2017,2,10,3,40,67,107,129
3405-000,2017,2,10,4,61,76,137,107
3405-000,2017,2,10,5,90,93,183,137
3405-000,2017,2,10,6,187,188,375,183
3405-000,2017,2,10,7,461,385,846,375
3405-000,2017,2,10,8,996,1139,2135,846
3405-000,2017,2,10,9,1295,1234,2529,2135
3405-000,2017,2,10,10,1052,910,1962,2529
3405-000,2017,2,10,11,1058,1029,2087,1962
3405-000,2017,2,10,12,1042,834,1876,2087
3405-000,2017,2,10,13,905,795,1700,1876
3405-000,2017,2,10,14,1013,872,1885,1700
3405-000,2017,2,10,15,1148,944,2092,1885
3405-000,2017,2,10,16,1049,943,1992,2092
3405-000,2017,2,10,17,1164,940,2104,1992
3405-000,2017,2,10,18,1307,990,2297,2104
3405-000,2017,2,10,19,1227,1004,2231,2297
3405-000,2017,2,10,20,804,686,1490,2231
3405-000,2017,2,10,21,601,534,1135,1490
3405-000,2017,2,10,22,422,370,792,1135
3405-000,2017,2,10,23,277,209,486,792
3405-000,2017,2,10,24,167,143,310,486
3405-000,2017,2,11,1,104,106,210,310
3405-000,2017,2,11,2,71,60,131,210
3405-000,2017,2,11,3,50,56,106,131
3405-000,2017,2,11,4,53,67,120,106
3405-000,2017,2,11,5,100,68,168,120
3405-000,2017,2,11,6,136,123,259,168
3405-000,2017,2,11,7,289,279,568,259
3405-000,2017,2,11,8,640,512,1152,568
3405-000,2017,2,11,9,876,633,1509,1152
3405-000,2017,2,11,10,794,611,1405,1509
3405-000,2017,2,11,11,908,665,1573,1405
3405-000,2017,2,11,12,930,690,1620,1573
3405-000,2017,2,11,13,729,735,1464,1620
3405-000,2017,2,11,14,724,642,1366,1464
3405-000,2017,2,11,15,833,641,1474,1366
3405-000,2017,2,11,16,842,631,1473,1474
3405-000,2017,2,11,17,838,680,1518,1473
3405-000,2017,2,11,18,966,748,1714,1518
3405-000,2017,2,11,19,761,579,1340,1714
3405-000,2017,2,11,20,436,383,819,1340
3405-000,2017,2,11,21,360,281,641,819
3405-000,2017,2,11,22,268,237,505,641
3405-000,2017,2,11,23,221,191,412,505
3405-000,2017,2,11,24,120,142,262,412
3405-000,2017,2,12,1,76,85,161,262
3405-000,2017,2,12,2,44,59,103,161
3405-000,2017,2,12,3,22,26,48,103
3405-000,2017,2,12,4,30,41,71,48
3405-000,2017,2,12,5,45,44,89,71
3405-000,2017,2,12,6,84,55,139,89
3405-000,2017,2,12,7,163,128,291,139
3405-000,2017,2,12,8,277,210,487,291
3405-000,2017,2,12,9,376,314,690,487
3405-000,2017,2,12,10,441,318,759,690
3405-000,2017,2,12,11,523,374,897,759
3405-000,2017,2,12,12,494,460,954,897
3405-000,2017,2,12,13,498,421,919,954
3405-000,2017,2,12,14,550,477,1027,919
3405-000,2017,2,12,15,541,571,1112,1027
3405-000,2017,2,12,16,625,615,1240,1112
3405-000,2017,2,12,17,638,702,1340,1240
3405-000,2017,2,12,18,626,644,1270,1340
3405-000,2017,2,12,19,492,528,1020,1270
3405-000,2017,2,12,20,349,423,772,1020
3405-000,2017,2,12,21,277,355,632,772
3405-000,2017,2,12,22,207,354,561,632
3405-000,2017,2,12,23,181,261,442,561
3405-000,2017,2,12,24,119,163,282,442
3405-000,2017,2,13,1,67,103,170,282
3405-000,2017,2,13,2,43,54,97,170
3405-000,2017,2,13,3,30,39,69,97
3405-000,2017,2,13,4,50,64,114,69
3405-000,2017,2,13,5,87,96,183,114
3405-000,2017,2,13,6,262,224,486,183
3405-000,2017,2,13,7,578,552,1130,486
3405-000,2017,2,13,8,1131,1443,2574,1130
3405-000,2017,2,13,9,1339,1267,2606,2574
3405-000,2017,2,13,10,1081,865,1946,2606
3405-000,2017,2,13,11,1018,939,1957,1946
3405-000,2017,2,13,12,978,894,1872,1957
3405-000,2017,2,13,13,813,816,1629,1872
3405-000,2017,2,13,14,983,956,1939,1629
3405-000,2017,2,13,15,1147,1002,2149,1939
3405-000,2017,2,13,16,1125,928,2053,2149
3405-000,2017,2,13,17,1164,927,2091,2053
3405-000,2017,2,13,18,1097,894,1991,2091
3405-000,2017,2,13,19,1011,936,1947,1991
3405-000,2017,2,13,20,687,601,1288,1947
3405-000,2017,2,13,21,560,540,1100,1288
3405-000,2017,2,13,22,362,402,764,1100
3405-000,2017,2,13,23,234,210,444,764
3405-000,2017,2,13,24,143,139,282,444
3405-000,2017,2,14,1,81,94,175,282
3405-000,2017,2,14,2,54,49,103,175
3405-000,2017,2,14,3,48,57,105,103
3405-000,2017,2,14,4,57,66,123,105
3405-000,2017,2,14,5,87,101,188,123
3405-000,2017,2,14,6,200,161,361,188
3405-000,2017,2,14,7,418,382,800,361
3405-000,2017,2,14,8,1068,1169,2237,800
3405-000,2017,2,14,9,1310,1160,2470,2237
3405-000,2017,2,14,10,1081,1008,2089,2470
3405-000,2017,2,14,11,1110,974,2084,2089
3405-000,2017,2,14,12,1080,950,2030,2084
3405-000,2017,2,14,13,879,824,1703,2030
3405-000,2017,2,14,14,1058,975,2033,1703
3405-000,2017,2,14,15,1125,971,2096,2033
3405-000,2017,2,14,16,1093,926,2019,2096
3405-000,2017,2,14,17,1107,917,2024,2019
3405-000,2017,2,14,18,1160,924,2084,2024
3405-000,2017,2,14,19,1062,942,2004,2084
3405-000,2017,2,14,20,737,608,1345,2004
3405-000,2017,2,14,21,601,598,1199,1345
3405-000,2017,2,14,22,385,379,764,1199
3405-000,2017,2,14,23,259,233,492,764
3405-000,2017,2,14,24,155,156,311,492
3405-000,2017,2,15,1,83,106,189,311
3405-000,2017,2,15,2,60,76,136,189
3405-000,2017,2,15,3,46,45,91,136
3405-000,2017,2,15,4,61,59,120,91
3405-000,2017,2,15,5,108,94,202,120
3405-000,2017,2,15,6,167,173,340,202
3405-000,2017,2,15,7,496,455,951,340
3405-000,2017,2,15,8,1065,1253,2318,951
3405-000,2017,2,15,9,1321,1295,2616,2318
3405-000,2017,2,15,10,1116,1002,2118,2616
3405-000,2017,2,15,11,1172,1009,2181,2118
3405-000,2017,2,15,12,1076,960,2036,2181
3405-000,2017,2,15,13,884,869,1753,2036
3405-000,2017,2,15,14,1086,896,1982,1753
3405-000,2017,2,15,15,1125,956,2081,1982
3405-000,2017,2,15,16,1170,963,2133,2081
3405-000,2017,2,15,17,1116,894,2010,2133
3405-000,2017,2,15,18,1189,1091,2280,2010
3405-000,2017,2,15,19,1074,968,2042,2280
3405-000,2017,2,15,20,715,612,1327,2042
3405-000,2017,2,15,21,508,504,1012,1327
3405-000,2017,2,15,22,354,368,722,1012
3405-000,2017,2,15,23,218,220,438,722
3405-000,2017,2,15,24,154,150,304,438
3405-000,2017,2,16,1,98,102,200,304
3405-000,2017,2,16,2,67,57,124,200
3405-000,2017,2,16,3,55,60,115,124
3405-000,2017,2,16,4,76,71,147,115
3405-000,2017,2,16,5,93,88,181,147
3405-000,2017,2,16,6,200,188,388,181
3405-000,2017,2,16,7,487,401,888,388
3405-000,2017,2,16,8,1065,1283,2348,888
3405-000,2017,2,16,9,1330,1210,2540,2348
3405-000,2017,2,16,10,1159,895,2054,2540
3405-000,2017,2,16,11,1098,950,2048,2054
3405-000,2017,2,16,12,1048,969,2017,2048
3405-000,2017,2,16,13,898,791,1689,2017
3405-000,2017,2,16,14,1021,896,1917,1689
3405-000,2017,2,16,15,1223,949,2172,1917
3405-000,2017,2,16,16,1158,969,2127,2172
3405-000,2017,2,16,17,1054,942,1996,2127
3405-000,2017,2,16,18,1183,980,2163,1996
3405-000,2017,2,16,19,1011,938,1949,2163
3405-000,2017,2,16,20,729,612,1341,1949
3405-000,2017,2,16,21,568,575,1143,1341
3405-000,2017,2,16,22,376,379,755,1143
3405-000,2017,2,16,23,251,203,454,755
3405-000,2017,2,16,24,151,154,305,454
3405-000,2017,2,17,1,89,79,168,305
3405-000,2017,2,17,2,62,48,110,168
3405-000,2017,2,17,3,43,47,90,110
3405-000,2017,2,17,4,67,56,123,90
3405-000,2017,2,17,5,91,92,183,123
3405-000,2017,2,17,6,181,158,339,183
3405-000,2017,2,17,7,468,414,882,339
3405-000,2017,2,17,8,1065,1112,2177,882
3405-000,2017,2,17,9,1335,1225,2560,2177
3405-000,2017,2,17,10,1119,947,2066,2560
3405-000,2017,2,17,11,1146,914,2060,2066
3405-000,2017,2,17,12,1032,848,1880,2060
3405-000,2017,2,17,13,890,828,1718,1880
3405-000,2017,2,17,14,937,942,1879,1718
3405-000,2017,2,17,15,1152,979,2131,1879
3405-000,2017,2,17,16,1140,980,2120,2131
3405-000,2017,2,17,17,1114,951,2065,2120
3405-000,2017,2,17,18,1254,1051,2305,2065
3405-000,2017,2,17,19,1280,1029,2309,2305
3405-000,2017,2,17,20,874,688,1562,2309
3405-000,2017,2,17,21,663,569,1232,1562
3405-000,2017,2,17,22,471,391,862,1232
3405-000,2017,2,17,23,271,211,482,862
3405-000,2017,2,17,24,153,158,311,482
3405-000,2017,2,18,1,101,90,191,311
3405-000,2017,2,18,2,66,66,132,191
3405-000,2017,2,18,3,53,49,102,132
3405-000,2017,2,18,4,70,70,140,102
3405-000,2017,2,18,5,81,86,167,140
3405-000,2017,2,18,6,180,123,303,167
3405-000,2017,2,18,7,330,286,616,303
3405-000,2017,2,18,8,699,583,1282,616
3405-000,2017,2,18,9,953,776,1729,1282
3405-000,2017,2,18,10,916,727,1643,1729
3405-000,2017,2,18,11,982,779,1761,1643
3405-000,2017,2,18,12,828,805,1633,1761
3405-000,2017,2,18,13,753,781,1534,1633
3405-000,2017,2,18,14,799,730,1529,1534
3405-000,2017,2,18,15,857,760,1617,1529
3405-000,2017,2,18,16,910,751,1661,1617
3405-000,2017,2,18,17,950,674,1624,1661
3405-000,2017,2,18,18,984,811,1795,1624
3405-000,2017,2,18,19,789,612,1401,1795
3405-000,2017,2,18,20,468,460,928,1401
3405-000,2017,2,18,21,350,314,664,928
3405-000,2017,2,18,22,277,240,517,664
3405-000,2017,2,18,23,215,189,404,517
3405-000,2017,2,18,24,122,154,276,404
3405-000,2017,2,19,1,77,82,159,276
3405-000,2017,2,19,2,53,49,102,159
3405-000,2017,2,19,3,46,37,83,102
3405-000,2017,2,19,4,27,37,64,83
3405-000,2017,2,19,5,34,40,74,64
3405-000,2017,2,19,6,93,63,156,74
3405-000,2017,2,19,7,151,124,275,156
3405-000,2017,2,19,8,283,253,536,275
3405-000,2017,2,19,9,432,331,763,536
3405-000,2017,2,19,10,475,326,801,763
3405-000,2017,2,19,11,526,448,974,801
3405-000,2017,2,19,12,492,501,993,974
3405-000,2017,2,19,13,491,506,997,993
3405-000,2017,2,19,14,538,534,1072,997
3405-000,2017,2,19,15,591,606,1197,1072
3405-000,2017,2,19,16,668,622,1290,1197
3405-000,2017,2,19,17,660,613,1273,1290
3405-000,2017,2,19,18,604,605,1209,1273
3405-000,2017,2,19,19,489,510,999,1209
3405-000,2017,2,19,20,392,417,809,999
3405-000,2017,2,19,21,293,342,635,809
3405-000,2017,2,19,22,216,300,516,635
3405-000,2017,2,19,23,161,239,400,516
3405-000,2017,2,19,24,123,159,282,400
3405-000,2017,2,20,1,63,97,160,282
3405-000,2017,2,20,2,52,67,119,160
3405-000,2017,2,20,3,31,60,91,119
3405-000,2017,2,20,4,62,63,125,91
3405-000,2017,2,20,5,88,94,182,125
3405-000,2017,2,20,6,217,201,418,182
3405-000,2017,2,20,7,541,572,1113,418
3405-000,2017,2,20,8,1160,1469,2629,1113
3405-000,2017,2,20,9,1274,1202,2476,2629
3405-000,2017,2,20,10,1009,898,1907,2476
3405-000,2017,2,20,11,1080,925,2005,1907
3405-000,2017,2,20,12,974,818,1792,2005
3405-000,2017,2,20,13,837,788,1625,1792
3405-000,2017,2,20,14,981,845,1826,1625
3405-000,2017,2,20,15,1317,1014,2331,1826
3405-000,2017,2,20,16,1128,965,2093,2331
3405-000,2017,2,20,17,1048,882,1930,2093
3405-000,2017,2,20,18,1170,973,2143,1930
3405-000,2017,2,20,19,1024,907,1931,2143
3405-000,2017,2,20,20,756,623,1379,1931
3405-000,2017,2,20,21,555,579,1134,1379
3405-000,2017,2,20,22,389,383,772,1134
3405-000,2017,2,20,23,229,216,445,772
3405-000,2017,2,20,24,133,143,276,445
3405-000,2017,2,21,1,86,92,178,276
3405-000,2017,2,21,2,58,66,124,178
3405-000,2017,2,21,3,53,42,95,124
3405-000,2017,2,21,4,48,71,119,95
3405-000,2017,2,21,5,101,98,199,119
3405-000,2017,2,21,6,203,169,372,199
3405-000,2017,2,21,7,461,442,903,372
3405-000,2017,2,21,8,1055,1214,2269,903
3405-000,2017,2,21,9,1314,1201,2515,2269
3405-000,2017,2,21,10,1118,973,2091,2515
3405-000,2017,2,21,11,1163,1000,2163,2091
3405-000,2017,2,21,12,1072,969,2041,2163
3405-000,2017,2,21,13,840,839,1679,2041
3405-000,2017,2,21,14,1033,990,2023,1679
3405-000,2017,2,21,15,1168,982,2150,2023
3405-000,2017,2,21,16,1117,972,2089,2150
3405-000,2017,2,21,17,1108,939,2047,2089
3405-000,2017,2,21,18,1168,999,2167,2047
3405-000,2017,2,21,19,1016,967,1983,2167
3405-000,2017,2,21,20,693,611,1304,1983
3405-000,2017,2,21,21,580,556,1136,1304
3405-000,2017,2,21,22,377,400,777,1136
3405-000,2017,2,21,23,280,201,481,777
3405-000,2017,2,21,24,160,166,326,481
3405-000,2017,2,22,1,97,94,191,326
3405-000,2017,2,22,2,66,74,140,191
3405-000,2017,2,22,3,41,52,93,140
3405-000,2017,2,22,4,74,74,148,93
3405-000,2017,2,22,5,86,70,156,148
3405-000,2017,2,22,6,192,166,358,156
3405-000,2017,2,22,7,434,397,831,358
3405-000,2017,2,22,8,1017,1152,2169,831
3405-000,2017,2,22,9,1363,1194,2557,2169
3405-000,2017,2,22,10,1006,932,1938,2557
3405-000,2017,2,22,11,1034,826,1860,1938
3405-000,2017,2,22,12,883,856,1739,1860
3405-000,2017,2,22,13,823,672,1495,1739
3405-000,2017,2,22,14,913,814,1727,1495
3405-000,2017,2,22,15,1005,817,1822,1727
3405-000,2017,2,22,16,1024,832,1856,1822
3405-000,2017,2,22,17,901,808,1709,1856
3405-000,2017,2,22,18,1019,941,1960,1709
3405-000,2017,2,22,19,953,867,1820,1960
3405-000,2017,2,22,20,616,544,1160,1820
3405-000,2017,2,22,21,458,465,923,1160
3405-000,2017,2,22,22,337,329,666,923
3405-000,2017,2,22,23,202,191,393,666
3405-000,2017,2,22,24,129,134,263,393
3405-000,2017,2,23,1,93,91,184,263
3405-000,2017,2,23,2,55,52,107,184
3405-000,2017,2,23,3,44,49,93,107
3405-000,2017,2,23,4,65,59,124,93
3405-000,2017,2,23,5,78,92,170,124
3405-000,2017,2,23,6,187,169,356,170
3405-000,2017,2,23,7,476,400,876,356
3405-000,2017,2,23,8,1087,1196,2283,876
3405-000,2017,2,23,9,1346,1214,2560,2283
3405-000,2017,2,23,10,1061,915,1976,2560
3405-000,2017,2,23,11,1094,1015,2109,1976
3405-000,2017,2,23,12,1034,852,1886,2109
3405-000,2017,2,23,13,909,787,1696,1886
3405-000,2017,2,23,14,1034,973,2007,1696
3405-000,2017,2,23,15,1115,1035,2150,2007
3405-000,2017,2,23,16,1149,892,2041,2150
3405-000,2017,2,23,17,1128,992,2120,2041
3405-000,2017,2,23,18,1095,994,2089,2120
3405-000,2017,2,23,19,1032,921,1953,2089
3405-000,2017,2,23,20,711,601,1312,1953
3405-000,2017,2,23,21,525,589,1114,1312
3405-000,2017,2,23,22,401,391,792,1114
3405-000,2017,2,23,23,260,201,461,792
3405-000,2017,2,23,24,158,170,328,461
3405-000,2017,2,24,1,84,92,176,328
3405-000,2017,2,24,2,65,84,149,176
3405-000,2017,2,24,3,42,52,94,149
3405-000,2017,2,24,4,82,71,153,94
3405-000,2017,2,24,5,104,94,198,153
3405-000,2017,2,24,6,213,188,401,198
3405-000,2017,2,24,7,490,453,943,401
3405-000,2017,2,24,8,1041,1177,2218,943
3405-000,2017,2,24,9,1319,1160,2479,2218
3405-000,2017,2,24,10,1127,970,2097,2479
3405-000,2017,2,24,11,1165,937,2102,2097
3405-000,2017,2,24,12,1088,871,1959,2102
3405-000,2017,2,24,13,921,815,1736,1959
3405-000,2017,2,24,14,1027,927,1954,1736
3405-000,2017,2,24,15,1193,997,2190,1954
3405-000,2017,2,24,16,1202,954,2156,2190
3405-000,2017,2,24,17,1180,966,2146,2156
3405-000,2017,2,24,18,1361,1108,2469,2146
3405-000,2017,2,24,19,1401,1056,2457,2469
3405-000,2017,2,24,20,867,678,1545,2457
3405-000,2017,2,24,21,667,566,1233,1545
3405-000,2017,2,24,22,413,393,806,1233
3405-000,2017,2,24,23,274,218,492,806
3405-000,2017,2,24,24,147,155,302,492
3405-000,2017,2,25,1,136,109,245,302
3405-000,2017,2,25,2,68,63,131,245
3405-000,2017,2,25,3,66,57,123,131
3405-000,2017,2,25,4,56,71,127,123
3405-000,2017,2,25,5,89,89,178,127
3405-000,2017,2,25,6,183,164,347,178
3405-000,2017,2,25,7,378,315,693,347
3405-000,2017,2,25,8,666,595,1261,693
3405-000,2017,2,25,9,892,657,1549,1261
3405-000,2017,2,25,10,901,680,1581,1549
3405-000,2017,2,25,11,974,736,1710,1581
3405-000,2017,2,25,12,1031,900,1931,1710
3405-000,2017,2,25,13,892,805,1697,1931
3405-000,2017,2,25,14,879,794,1673,1697
3405-000,2017,2,25,15,923,726,1649,1673
3405-000,2017,2,25,16,955,760,1715,1649
3405-000,2017,2,25,17,1000,726,1726,1715
3405-000,2017,2,25,18,1083,895,1978,1726
3405-000,2017,2,25,19,894,791,1685,1978
3405-000,2017,2,25,20,587,416,1003,1685
3405-000,2017,2,25,21,392,392,784,1003
3405-000,2017,2,25,22,304,281,585,784
3405-000,2017,2,25,23,209,199,408,585
3405-000,2017,2,25,24,131,130,261,408
3405-000,2017,2,26,1,102,83,185,261
3405-000,2017,2,26,2,48,51,99,185
3405-000,2017,2,26,3,25,39,64,99
3405-000,2017,2,26,4,29,32,61,64
3405-000,2017,2,26,5,40,36,76,61
3405-000,2017,2,26,6,82,72,154,76
3405-000,2017,2,26,7,171,117,288,154
3405-000,2017,2,26,8,314,267,581,288
3405-000,2017,2,26,9,448,324,772,581
3405-000,2017,2,26,10,513,354,867,772
3405-000,2017,2,26,11,576,447,1023,867
3405-000,2017,2,26,12,564,485,1049,1023
3405-000,2017,2,26,13,545,516,1061,1049
3405-000,2017,2,26,14,543,557,1100,1061
3405-000,2017,2,26,15,659,638,1297,1100
3405-000,2017,2,26,16,645,583,1228,1297
3405-000,2017,2,26,17,655,628,1283,1228
3405-000,2017,2,26,18,701,689,1390,1283
3405-000,2017,2,26,19,561,555,1116,1390
3405-000,2017,2,26,20,378,475,853,1116
3405-000,2017,2,26,21,342,532,874,853
3405-000,2017,2,26,22,241,383,624,874
3405-000,2017,2,26,23,187,284,471,624
3405-000,2017,2,26,24,114,189,303,471
3405-000,2017,2,27,1,70,102,172,303
3405-000,2017,2,27,2,40,71,111,172
3405-000,2017,2,27,3,31,58,89,111
3405-000,2017,2,27,4,51,75,126,89
3405-000,2017,2,27,5,120,98,218,126
3405-000,2017,2,27,6,249,228,477,218
3405-000,2017,2,27,7,594,617,1211,477
3405-000,2017,2,27,8,1160,1423,2583,1211
3405-000,2017,2,27,9,1299,1387,2686,2583
3405-000,2017,2,27,10,1120,959,2079,2686
3405-000,2017,2,27,11,1166,963,2129,2079
3405-000,2017,2,27,12,1183,941,2124,2129
3405-000,2017,2,27,13,900,876,1776,2124
3405-000,2017,2,27,14,1030,1016,2046,1776
3405-000,2017,2,27,15,1267,997,2264,2046
3405-000,2017,2,27,16,1185,974,2159,2264
3405-000,2017,2,27,17,1102,1064,2166,2159
3405-000,2017,2,27,18,1251,1016,2267,2166
3405-000,2017,2,27,19,1053,974,2027,2267
3405-000,2017,2,27,20,691,655,1346,2027
3405-000,2017,2,27,21,573,572,1145,1346
3405-000,2017,2,27,22,430,424,854,1145
3405-000,2017,2,27,23,232,224,456,854
3405-000,2017,2,27,24,151,161,312,456
3405-000,2017,2,28,1,114,99,213,312
3405-000,2017,2,28,2,51,78,129,213
3405-000,2017,2,28,3,51,69,120,129
3405-000,2017,2,28,4,67,78,145,120
3405-000,2017,2,28,5,101,104,205,145
3405-000,2017,2,28,6,184,186,370,205
3405-000,2017,2,28,7,494,460,954,370
3405-000,2017,2,28,8,1102,1280,2382,954
3405-000,2017,2,28,9,1362,1261,2623,2382
3405-000,2017,2,28,10,1146,1030,2176,2623
3405-000,2017,2,28,11,1203,992,2195,2176
3405-000,2017,2,28,12,1111,952,2063,2195
3405-000,2017,2,28,13,904,857,1761,2063
3405-000,2017,2,28,14,1094,970,2064,1761
3405-000,2017,2,28,15,1188,1015,2203,2064
3405-000,2017,2,28,16,1204,1005,2209,2203
3405-000,2017,2,28,17,1124,1012,2136,2209
3405-000,2017,2,28,18,1376,1088,2464,2136
3405-000,2017,2,28,19,1304,1101,2405,2464
3405-000,2017,2,28,20,937,706,1643,2405
3405-000,2017,2,28,21,754,654,1408,1643
3405-000,2017,2,28,22,477,441,918,1408
3405-000,2017,2,28,23,283,215,498,918
3405-000,2017,2,28,24,169,146,315,498
3405-000,2017,3,1,1,112,88,200,315
3405-000,2017,3,1,2,57,65,122,200
3405-000,2017,3,1,3,47,49,96,122
3405-000,2017,3,1,4,60,67,127,96
3405-000,2017,3,1,5,84,71,155,127
3405-000,2017,3,1,6,154,150,304,155
3405-000,2017,3,1,7,389,315,704,304
3405-000,2017,3,1,8,679,615,1294,704
3405-000,2017,3,1,9,810,690,1500,1294
3405-000,2017,3,1,10,807,565,1372,1500
3405-000,2017,3,1,11,863,714,1577,1372
3405-000,2017,3,1,12,820,684,1504,1577
3405-000,2017,3,1,13,741,694,1435,1504
3405-000,2017,3,1,14,773,726,1499,1435
3405-000,2017,3,1,15,865,719,1584,1499
3405-000,2017,3,1,16,845,715,1560,1584
3405-000,2017,3,1,17,871,728,1599,1560
3405-000,2017,3,1,18,918,821,1739,1599
3405-000,2017,3,1,19,717,562,1279,1739
3405-000,2017,3,1,20,463,468,931,1279
3405-000,2017,3,1,21,370,370,740,931
3405-000,2017,3,1,22,245,257,502,740
3405-000,2017,3,1,23,194,188,382,502
3405-000,2017,3,1,24,105,121,226,382
3405-000,2017,3,2,1,58,93,151,226
3405-000,2017,3,2,2,36,59,95,151
3405-000,2017,3,2,3,45,48,93,95
3405-000,2017,3,2,4,46,51,97,93
3405-000,2017,3,2,5,91,79,170,97
3405-000,2017,3,2,6,189,217,406,170
3405-000,2017,3,2,7,489,487,976,406
3405-000,2017,3,2,8,1103,1301,2404,976
3405-000,2017,3,2,9,1279,1307,2586,2404
3405-000,2017,3,2,10,1021,881,1902,2586
3405-000,2017,3,2,11,1097,971,2068,1902
3405-000,2017,3,2,12,1037,920,1957,2068
3405-000,2017,3,2,13,888,777,1665,1957
3405-000,2017,3,2,14,968,946,1914,1665
3405-000,2017,3,2,15,1171,1010,2181,1914
3405-000,2017,3,2,16,1069,935,2004,2181
3405-000,2017,3,2,17,1098,949,2047,2004
3405-000,2017,3,2,18,1190,970,2160,2047
3405-000,2017,3,2,19,1038,895,1933,2160
3405-000,2017,3,2,20,710,640,1350,1933
3405-000,2017,3,2,21,581,576,1157,1350
3405-000,2017,3,2,22,380,369,749,1157
3405-000,2017,3,2,23,232,211,443,749
3405-000,2017,3,2,24,141,144,285,443
3405-000,2017,3,3,1,111,117,228,285
3405-000,2017,3,3,2,51,67,118,228
3405-000,2017,3,3,3,33,55,88,118
3405-000,2017,3,3,4,69,60,129,88
3405-000,2017,3,3,5,96,82,178,129
3405-000,2017,3,3,6,183,207,390,178
3405-000,2017,3,3,7,477,469,946,390
3405-000,2017,3,3,8,1102,1243,2345,946
3405-000,2017,3,3,9,1332,1259,2591,2345
3405-000,2017,3,3,10,1137,927,2064,2591
3405-000,2017,3,3,11,1115,973,2088,2064
3405-000,2017,3,3,12,1053,932,1985,2088
3405-000,2017,3,3,13,896,834,1730,1985
3405-000,2017,3,3,14,1027,931,1958,1730
3405-000,2017,3,3,15,1146,981,2127,1958
3405-000,2017,3,3,16,1142,935,2077,2127
3405-000,2017,3,3,17,1211,935,2146,2077
3405-000,2017,3,3,18,1351,1086,2437,2146
3405-000,2017,3,3,19,1436,1094,2530,2437
3405-000,2017,3,3,20,932,688,1620,2530
3405-000,2017,3,3,21,655,579,1234,1620
3405-000,2017,3,3,22,439,412,851,1234
3405-000,2017,3,3,23,315,232,547,851
3405-000,2017,3,3,24,176,149,325,547
3405-000,2017,3,4,1,112,87,199,325
3405-000,2017,3,4,2,69,63,132,199
3405-000,2017,3,4,3,50,56,106,132
3405-000,2017,3,4,4,49,71,120,106
3405-000,2017,3,4,5,93,94,187,120
3405-000,2017,3,4,6,158,167,325,187
3405-000,2017,3,4,7,393,334,727,325
3405-000,2017,3,4,8,716,641,1357,727
3405-000,2017,3,4,9,927,815,1742,1357
3405-000,2017,3,4,10,839,709,1548,1742
3405-000,2017,3,4,11,949,702,1651,1548
3405-000,2017,3,4,12,851,798,1649,1651
3405-000,2017,3,4,13,766,742,1508,1649
3405-000,2017,3,4,14,793,689,1482,1508
3405-000,2017,3,4,15,816,760,1576,1482
3405-000,2017,3,4,16,881,710,1591,1576
3405-000,2017,3,4,17,956,717,1673,1591
3405-000,2017,3,4,18,1094,841,1935,1673
3405-000,2017,3,4,19,891,614,1505,1935
3405-000,2017,3,4,20,586,417,1003,1505
3405-000,2017,3,4,21,367,346,713,1003
3405-000,2017,3,4,22,275,274,549,713
3405-000,2017,3,4,23,176,199,375,549
3405-000,2017,3,4,24,142,131,273,375
3405-000,2017,3,5,1,87,80,167,273
3405-000,2017,3,5,2,57,42,99,167
3405-000,2017,3,5,3,36,32,68,99
3405-000,2017,3,5,4,30,25,55,68
3405-000,2017,3,5,5,44,42,86,55
3405-000,2017,3,5,6,75,55,130,86
3405-000,2017,3,5,7,181,143,324,130
3405-000,2017,3,5,8,315,267,582,324
3405-000,2017,3,5,9,498,362,860,582
3405-000,2017,3,5,10,464,384,848,860
3405-000,2017,3,5,11,576,459,1035,848
3405-000,2017,3,5,12,577,471,1048,1035
3405-000,2017,3,5,13,533,520,1053,1048
3405-000,2017,3,5,14,543,570,1113,1053
3405-000,2017,3,5,15,574,553,1127,1113
3405-000,2017,3,5,16,668,617,1285,1127
3405-000,2017,3,5,17,698,607,1305,1285
3405-000,2017,3,5,18,707,683,1390,1305
3405-000,2017,3,5,19,610,585,1195,1390
3405-000,2017,3,5,20,406,471,877,1195
3405-000,2017,3,5,21,332,388,720,877
3405-000,2017,3,5,22,246,347,593,720
3405-000,2017,3,5,23,173,244,417,593
3405-000,2017,3,5,24,122,150,272,417
3405-000,2017,3,6,1,75,96,171,272
3405-000,2017,3,6,2,44,62,106,171
3405-000,2017,3,6,3,24,51,75,106
3405-000,2017,3,6,4,47,61,108,75
3405-000,2017,3,6,5,101,108,209,108
3405-000,2017,3,6,6,234,233,467,209
3405-000,2017,3,6,7,588,627,1215,467
3405-000,2017,3,6,8,1174,1545,2719,1215
3405-000,2017,3,6,9,1371,1332,2703,2719
3405-000,2017,3,6,10,1016,891,1907,2703
3405-000,2017,3,6,11,1038,971,2009,1907
3405-000,2017,3,6,12,1049,906,1955,2009
3405-000,2017,3,6,13,835,818,1653,1955
3405-000,2017,3,6,14,966,888,1854,1653
3405-000,2017,3,6,15,1064,991,2055,1854
3405-000,2017,3,6,16,1161,925,2086,2055
3405-000,2017,3,6,17,1071,931,2002,2086
3405-000,2017,3,6,18,1135,925,2060,2002
3405-000,2017,3,6,19,1070,958,2028,2060
3405-000,2017,3,6,20,696,627,1323,2028
3405-000,2017,3,6,21,570,575,1145,1323
3405-000,2017,3,6,22,397,420,817,1145
3405-000,2017,3,6,23,234,233,467,817
3405-000,2017,3,6,24,137,163,300,467
3405-000,2017,3,7,1,78,96,174,300
3405-000,2017,3,7,2,64,61,125,174
3405-000,2017,3,7,3,38,45,83,125
3405-000,2017,3,7,4,65,77,142,83
3405-000,2017,3,7,5,87,89,176,142
3405-000,2017,3,7,6,205,192,397,176
3405-000,2017,3,7,7,498,473,971,397
3405-000,2017,3,7,8,1131,1282,2413,971
3405-000,2017,3,7,9,1342,1305,2647,2413
3405-000,2017,3,7,10,1128,964,2092,2647
3405-000,2017,3,7,11,1119,1024,2143,2092
3405-000,2017,3,7,12,1142,874,2016,2143
3405-000,2017,3,7,13,862,812,1674,2016
3405-000,2017,3,7,14,968,925,1893,1674
3405-000,2017,3,7,15,1128,984,2112,1893
3405-000,2017,3,7,16,1132,990,2122,2112
3405-000,2017,3,7,17,1101,940,2041,2122
3405-000,2017,3,7,18,1099,970,2069,2041
3405-000,2017,3,7,19,1009,976,1985,2069
3405-000,2017,3,7,20,748,666,1414,1985
3405-000,2017,3,7,21,575,598,1173,1414
3405-000,2017,3,7,22,435,442,877,1173
3405-000,2017,3,7,23,250,222,472,877
3405-000,2017,3,7,24,150,162,312,472
3405-000,2017,3,8,1,77,98,175,312
3405-000,2017,3,8,2,65,64,129,175
3405-000,2017,3,8,3,44,52,96,129
3405-000,2017,3,8,4,67,63,130,96
3405-000,2017,3,8,5,85,97,182,130
3405-000,2017,3,8,6,181,189,370,182
3405-000,2017,3,8,7,490,479,969,370
3405-000,2017,3,8,8,1102,1280,2382,969
3405-000,2017,3,8,9,1342,1295,2637,2382
3405-000,2017,3,8,10,1130,968,2098,2637
3405-000,2017,3,8,11,1119,1018,2137,2098
3405-000,2017,3,8,12,979,885,1864,2137
3405-000,2017,3,8,13,856,766,1622,1864
3405-000,2017,3,8,14,993,960,1953,1622
3405-000,2017,3,8,15,1137,1052,2189,1953
3405-000,2017,3,8,16,1099,952,2051,2189
3405-000,2017,3,8,17,1047,965,2012,2051
3405-000,2017,3,8,18,1252,1039,2291,2012
3405-000,2017,3,8,19,1063,981,2044,2291
3405-000,2017,3,8,20,673,618,1291,2044
3405-000,2017,3,8,21,530,503,1033,1291
3405-000,2017,3,8,22,415,376,791,1033
3405-000,2017,3,8,23,234,197,431,791
3405-000,2017,3,8,24,137,158,295,431
3405-000,2017,3,9,1,94,94,188,295
3405-000,2017,3,9,2,57,75,132,188
3405-000,2017,3,9,3,58,55,113,132
3405-000,2017,3,9,4,54,70,124,113
3405-000,2017,3,9,5,99,96,195,124
3405-000,2017,3,9,6,197,183,380,195
3405-000,2017,3,9,7,492,456,948,380
3405-000,2017,3,9,8,1173,1276,2449,948
3405-000,2017,3,9,9,1443,1360,2803,2449
3405-000,2017,3,9,10,1126,1020,2146,2803
3405-000,2017,3,9,11,1110,1069,2179,2146
3405-000,2017,3,9,12,1015,919,1934,2179
3405-000,2017,3,9,13,927,839,1766,1934
3405-000,2017,3,9,14,1012,930,1942,1766
3405-000,2017,3,9,15,1038,963,2001,1942
3405-000,2017,3,9,16,1170,929,2099,2001
3405-000,2017,3,9,17,1073,940,2013,2099
3405-000,2017,3,9,18,1168,985,2153,2013
3405-000,2017,3,9,19,1081,960,2041,2153
3405-000,2017,3,9,20,716,687,1403,2041
3405-000,2017,3,9,21,543,579,1122,1403
3405-000,2017,3,9,22,432,423,855,1122
3405-000,2017,3,9,23,249,204,453,855
3405-000,2017,3,9,24,144,145,289,453
3405-000,2017,3,10,1,101,105,206,289
3405-000,2017,3,10,2,62,74,136,206
3405-000,2017,3,10,3,65,57,122,136
3405-000,2017,3,10,4,50,64,114,122
3405-000,2017,3,10,5,104,96,200,114
3405-000,2017,3,10,6,204,186,390,200
3405-000,2017,3,10,7,521,463,984,390
3405-000,2017,3,10,8,1162,1300,2462,984
3405-000,2017,3,10,9,1422,1229,2651,2462
3405-000,2017,3,10,10,1174,997,2171,2651
3405-000,2017,3,10,11,1139,1000,2139,2171
3405-000,2017,3,10,12,1007,927,1934,2139
3405-000,2017,3,10,13,921,843,1764,1934
3405-000,2017,3,10,14,1034,995,2029,1764
3405-000,2017,3,10,15,1242,1014,2256,2029
3405-000,2017,3,10,16,1328,970,2298,2256
3405-000,2017,3,10,17,1182,1017,2199,2298
3405-000,2017,3,10,18,1326,1028,2354,2199
3405-000,2017,3,10,19,1414,1147,2561,2354
3405-000,2017,3,10,20,915,711,1626,2561
3405-000,2017,3,10,21,715,520,1235,1626
3405-000,2017,3,10,22,452,432,884,1235
3405-000,2017,3,10,23,274,243,517,884
3405-000,2017,3,10,24,155,168,323,517
3405-000,2017,3,11,1,111,118,229,323
3405-000,2017,3,11,2,80,88,168,229
3405-000,2017,3,11,3,44,50,94,168
3405-000,2017,3,11,4,62,78,140,94
3405-000,2017,3,11,5,71,88,159,140
3405-000,2017,3,11,6,173,144,317,159
3405-000,2017,3,11,7,390,366,756,317
3405-000,2017,3,11,8,732,651,1383,756
3405-000,2017,3,11,9,915,824,1739,1383
3405-000,2017,3,11,10,839,673,1512,1739
3405-000,2017,3,11,11,951,747,1698,1512
3405-000,2017,3,11,12,791,773,1564,1698
3405-000,2017,3,11,13,733,662,1395,1564
3405-000,2017,3,11,14,839,721,1560,1395
3405-000,2017,3,11,15,886,719,1605,1560
3405-000,2017,3,11,16,915,738,1653,1605
3405-000,2017,3,11,17,896,785,1681,1653
3405-000,2017,3,11,18,1065,890,1955,1681
3405-000,2017,3,11,19,904,704,1608,1955
3405-000,2017,3,11,20,568,462,1030,1608
3405-000,2017,3,11,21,375,333,708,1030
3405-000,2017,3,11,22,276,261,537,708
3405-000,2017,3,11,23,198,209,407,537
3405-000,2017,3,11,24,158,131,289,407
3405-000,2017,3,12,1,101,70,171,289
3405-000,2017,3,12,2,53,48,101,171
3405-000,2017,3,12,3,31,30,61,101
3405-000,2017,3,12,4,35,34,69,61
3405-000,2017,3,12,5,44,34,78,69
3405-000,2017,3,12,6,81,74,155,78
3405-000,2017,3,12,7,228,135,363,155
3405-000,2017,3,12,8,343,228,571,363
3405-000,2017,3,12,9,441,386,827,571
3405-000,2017,3,12,10,500,319,819,827
3405-000,2017,3,12,11,600,416,1016,819
3405-000,2017,3,12,12,604,496,1100,1016
3405-000,2017,3,12,13,527,538,1065,1100
3405-000,2017,3,12,14,565,602,1167,1065
3405-000,2017,3,12,15,627,601,1228,1167
3405-000,2017,3,12,16,717,622,1339,1228
3405-000,2017,3,12,17,660,780,1440,1339
3405-000,2017,3,12,18,760,723,1483,1440
3405-000,2017,3,12,19,589,605,1194,1483
3405-000,2017,3,12,20,434,517,951,1194
3405-000,2017,3,12,21,349,452,801,951
3405-000,2017,3,12,22,247,381,628,801
3405-000,2017,3,12,23,212,231,443,628
3405-000,2017,3,12,24,114,162,276,443
3405-000,2017,3,13,1,75,83,158,276
3405-000,2017,3,13,2,53,59,112,158
3405-000,2017,3,13,3,31,58,89,112
3405-000,2017,3,13,4,64,61,125,89
3405-000,2017,3,13,5,122,88,210,125
3405-000,2017,3,13,6,209,263,472,210
3405-000,2017,3,13,7,600,660,1260,472
3405-000,2017,3,13,8,1215,1607,2822,1260
3405-000,2017,3,13,9,1344,1386,2730,2822
3405-000,2017,3,13,10,1029,904,1933,2730
3405-000,2017,3,13,11,1127,934,2061,1933
3405-000,2017,3,13,12,1045,932,1977,2061
3405-000,2017,3,13,13,893,875,1768,1977
3405-000,2017,3,13,14,966,921,1887,1768
3405-000,2017,3,13,15,1074,1034,2108,1887
3405-000,2017,3,13,16,1087,927,2014,2108
3405-000,2017,3,13,17,1133,909,2042,2014
3405-000,2017,3,13,18,1201,1045,2246,2042
3405-000,2017,3,13,19,1117,1029,2146,2246
3405-000,2017,3,13,20,758,687,1445,2146
3405-000,2017,3,13,21,581,579,1160,1445
3405-000,2017,3,13,22,388,432,820,1160
3405-000,2017,3,13,23,234,221,455,820
3405-000,2017,3,13,24,127,168,295,455
3405-000,2017,3,14,1,87,109,196,295
3405-000,2017,3,14,2,57,77,134,196
3405-000,2017,3,14,3,48,58,106,134
3405-000,2017,3,14,4,59,70,129,106
3405-000,2017,3,14,5,112,114,226,129
3405-000,2017,3,14,6,213,227,440,226
3405-000,2017,3,14,7,545,482,1027,440
3405-000,2017,3,14,8,1160,1326,2486,1027
3405-000,2017,3,14,9,1453,1594,3047,2486
3405-000,2017,3,14,10,1147,946,2093,3047
3405-000,2017,3,14,11,1126,1006,2132,2093
3405-000,2017,3,14,12,1028,860,1888,2132
3405-000,2017,3,14,13,855,871,1726,1888
3405-000,2017,3,14,14,984,944,1928,1726
3405-000,2017,3,14,15,1184,1049,2233,1928
3405-000,2017,3,14,16,1187,1020,2207,2233
3405-000,2017,3,14,17,1165,942,2107,2207
3405-000,2017,3,14,18,1203,1035,2238,2107
3405-000,2017,3,14,19,1099,1011,2110,2238
3405-000,2017,3,14,20,787,637,1424,2110
3405-000,2017,3,14,21,594,559,1153,1424
3405-000,2017,3,14,22,455,458,913,1153
3405-000,2017,3,14,23,246,256,502,913
3405-000,2017,3,14,24,133,171,304,502
3405-000,2017,3,15,1,109,112,221,304
3405-000,2017,3,15,2,69,68,137,221
3405-000,2017,3,15,3,47,56,103,137
3405-000,2017,3,15,4,50,64,114,103
3405-000,2017,3,15,5,107,83,190,114
3405-000,2017,3,15,6,203,162,365,190
3405-000,2017,3,15,7,533,483,1016,365
3405-000,2017,3,15,8,1152,1349,2501,1016
3405-000,2017,3,15,9,1354,1306,2660,2501
3405-000,2017,3,15,10,1142,948,2090,2660
3405-000,2017,3,15,11,1148,974,2122,2090
3405-000,2017,3,15,12,1091,928,2019,2122
3405-000,2017,3,15,13,899,836,1735,2019
3405-000,2017,3,15,14,993,1009,2002,1735
3405-000,2017,3,15,15,1123,1033,2156,2002
3405-000,2017,3,15,16,1137,1024,2161,2156
3405-000,2017,3,15,17,1123,931,2054,2161
3405-000,2017,3,15,18,1311,1032,2343,2054
3405-000,2017,3,15,19,1154,1006,2160,2343
3405-000,2017,3,15,20,784,714,1498,2160
3405-000,2017,3,15,21,505,518,1023,1498
3405-000,2017,3,15,22,415,399,814,1023
3405-000,2017,3,15,23,237,204,441,814
3405-000,2017,3,15,24,158,187,345,441
3405-000,2017,3,16,1,97,116,213,345
3405-000,2017,3,16,2,71,58,129,213
3405-000,2017,3,16,3,51,63,114,129
3405-000,2017,3,16,4,48,74,122,114
3405-000,2017,3,16,5,102,89,191,122
3405-000,2017,3,16,6,220,184,404,191
3405-000,2017,3,16,7,547,496,1043,404
3405-000,2017,3,16,8,1165,1357,2522,1043
3405-000,2017,3,16,9,1386,1327,2713,2522
3405-000,2017,3,16,10,1140,975,2115,2713
3405-000,2017,3,16,11,1126,965,2091,2115
3405-000,2017,3,16,12,1044,974,2018,2091
3405-000,2017,3,16,13,903,853,1756,2018
3405-000,2017,3,16,14,980,927,1907,1756
3405-000,2017,3,16,15,1141,1049,2190,1907
3405-000,2017,3,16,16,1111,1016,2127,2190
3405-000,2017,3,16,17,1127,965,2092,2127
3405-000,2017,3,16,18,1234,980,2214,2092
3405-000,2017,3,16,19,1080,984,2064,2214
3405-000,2017,3,16,20,745,649,1394,2064
3405-000,2017,3,16,21,565,572,1137,1394
3405-000,2017,3,16,22,423,450,873,1137
3405-000,2017,3,16,23,244,247,491,873
3405-000,2017,3,16,24,165,166,331,491
3405-000,2017,3,17,1,112,119,231,331
3405-000,2017,3,17,2,67,57,124,231
3405-000,2017,3,17,3,54,57,111,124
3405-000,2017,3,17,4,53,73,126,111
3405-000,2017,3,17,5,107,85,192,126
3405-000,2017,3,17,6,212,180,392,192
3405-000,2017,3,17,7,559,502,1061,392
3405-000,2017,3,17,8,1123,1272,2395,1061
3405-000,2017,3,17,9,1411,1312,2723,2395
3405-000,2017,3,17,10,1166,1019,2185,2723
3405-000,2017,3,17,11,1131,1033,2164,2185
3405-000,2017,3,17,12,1137,921,2058,2164
3405-000,2017,3,17,13,958,917,1875,2058
3405-000,2017,3,17,14,1063,971,2034,1875
3405-000,2017,3,17,15,1153,1047,2200,2034
3405-000,2017,3,17,16,1225,1020,2245,2200
3405-000,2017,3,17,17,1208,966,2174,2245
3405-000,2017,3,17,18,1430,1078,2508,2174
3405-000,2017,3,17,19,1431,1110,2541,2508
3405-000,2017,3,17,20,951,796,1747,2541
3405-000,2017,3,17,21,662,600,1262,1747
3405-000,2017,3,17,22,406,458,864,1262
3405-000,2017,3,17,23,317,236,553,864
3405-000,2017,3,17,24,180,174,354,553
3405-000,2017,3,18,1,111,107,218,354
3405-000,2017,3,18,2,84,83,167,218
3405-000,2017,3,18,3,63,61,124,167
3405-000,2017,3,18,4,70,86,156,124
3405-000,2017,3,18,5,108,84,192,156
3405-000,2017,3,18,6,186,182,368,192
3405-000,2017,3,18,7,401,341,742,368
3405-000,2017,3,18,8,744,675,1419,742
3405-000,2017,3,18,9,990,776,1766,1419
3405-000,2017,3,18,10,888,721,1609,1766
3405-000,2017,3,18,11,1028,750,1778,1609
3405-000,2017,3,18,12,822,847,1669,1778
3405-000,2017,3,18,13,786,771,1557,1669
3405-000,2017,3,18,14,775,780,1555,1557
3405-000,2017,3,18,15,834,778,1612,1555
3405-000,2017,3,18,16,899,721,1620,1612
3405-000,2017,3,18,17,981,732,1713,1620
3405-000,2017,3,18,18,1080,896,1976,1713
3405-000,2017,3,18,19,896,660,1556,1976
3405-000,2017,3,18,20,624,549,1173,1556
3405-000,2017,3,18,21,420,398,818,1173
3405-000,2017,3,18,22,273,283,556,818
3405-000,2017,3,18,23,237,200,437,556
3405-000,2017,3,18,24,127,143,270,437
3405-000,2017,3,19,1,80,79,159,270
3405-000,2017,3,19,2,62,54,116,159
3405-000,2017,3,19,3,50,34,84,116
3405-000,2017,3,19,4,33,33,66,84
3405-000,2017,3,19,5,49,32,81,66
3405-000,2017,3,19,6,101,71,172,81
3405-000,2017,3,19,7,214,169,383,172
3405-000,2017,3,19,8,359,302,661,383
3405-000,2017,3,19,9,545,354,899,661
3405-000,2017,3,19,10,518,395,913,899
3405-000,2017,3,19,11,620,522,1142,913
3405-000,2017,3,19,12,585,549,1134,1142
3405-000,2017,3,19,13,534,562,1096,1134
3405-000,2017,3,19,14,543,617,1160,1096
3405-000,2017,3,19,15,696,594,1290,1160
3405-000,2017,3,19,16,683,617,1300,1290
3405-000,2017,3,19,17,743,703,1446,1300
3405-000,2017,3,19,18,747,672,1419,1446
3405-000,2017,3,19,19,639,632,1271,1419
3405-000,2017,3,19,20,510,561,1071,1271
3405-000,2017,3,19,21,425,476,901,1071
3405-000,2017,3,19,22,289,375,664,901
3405-000,2017,3,19,23,224,278,502,664
3405-000,2017,3,19,24,117,174,291,502
3405-000,2017,3,20,1,66,116,182,291
3405-000,2017,3,20,2,40,71,111,182
3405-000,2017,3,20,3,36,51,87,111
3405-000,2017,3,20,4,39,70,109,87
3405-000,2017,3,20,5,107,97,204,109
3405-000,2017,3,20,6,272,245,517,204
3405-000,2017,3,20,7,642,637,1279,517
3405-000,2017,3,20,8,1235,1583,2818,1279
3405-000,2017,3,20,9,1388,1428,2816,2818
3405-000,2017,3,20,10,1081,944,2025,2816
3405-000,2017,3,20,11,1167,1041,2208,2025
3405-000,2017,3,20,12,1095,969,2064,2208
3405-000,2017,3,20,13,893,883,1776,2064
3405-000,2017,3,20,14,1045,998,2043,1776
3405-000,2017,3,20,15,1121,1013,2134,2043
3405-000,2017,3,20,16,1127,1031,2158,2134
3405-000,2017,3,20,17,1070,973,2043,2158
3405-000,2017,3,20,18,1183,1051,2234,2043
3405-000,2017,3,20,19,1018,975,1993,2234
3405-000,2017,3,20,20,730,648,1378,1993
3405-000,2017,3,20,21,565,577,1142,1378
3405-000,2017,3,20,22,397,450,847,1142
3405-000,2017,3,20,23,231,233,464,847
3405-000,2017,3,20,24,131,142,273,464
3405-000,2017,3,21,1,98,94,192,273
3405-000,2017,3,21,2,68,86,154,192
3405-000,2017,3,21,3,37,67,104,154
3405-000,2017,3,21,4,59,82,141,104
3405-000,2017,3,21,5,108,107,215,141
3405-000,2017,3,21,6,233,206,439,215
3405-000,2017,3,21,7,554,496,1050,439
3405-000,2017,3,21,8,1168,1368,2536,1050
3405-000,2017,3,21,9,1442,1270,2712,2536
3405-000,2017,3,21,10,1130,1026,2156,2712
3405-000,2017,3,21,11,1152,966,2118,2156
3405-000,2017,3,21,12,1023,948,1971,2118
3405-000,2017,3,21,13,945,873,1818,1971
3405-000,2017,3,21,14,1057,965,2022,1818
3405-000,2017,3,21,15,1145,988,2133,2022
3405-000,2017,3,21,16,1148,993,2141,2133
3405-000,2017,3,21,17,1094,958,2052,2141
3405-000,2017,3,21,18,1174,1071,2245,2052
3405-000,2017,3,21,19,1105,1003,2108,2245
3405-000,2017,3,21,20,753,653,1406,2108
3405-000,2017,3,21,21,609,538,1147,1406
3405-000,2017,3,21,22,399,433,832,1147
3405-000,2017,3,21,23,239,236,475,832
3405-000,2017,3,21,24,147,154,301,475
3405-000,2017,3,22,1,94,79,173,301
3405-000,2017,3,22,2,52,86,138,173
3405-000,2017,3,22,3,43,55,98,138
3405-000,2017,3,22,4,66,73,139,98
3405-000,2017,3,22,5,91,84,175,139
3405-000,2017,3,22,6,226,194,420,175
3405-000,2017,3,22,7,525,509,1034,420
3405-000,2017,3,22,8,1133,1371,2504,1034
3405-000,2017,3,22,9,1616,1220,2836,2504
3405-000,2017,3,22,10,1151,999,2150,2836
3405-000,2017,3,22,11,1169,1001,2170,2150
3405-000,2017,3,22,12,1008,948,1956,2170
3405-000,2017,3,22,13,883,842,1725,1956
3405-000,2017,3,22,14,996,969,1965,1725
3405-000,2017,3,22,15,1149,953,2102,1965
3405-000,2017,3,22,16,1107,1040,2147,2102
3405-000,2017,3,22,17,1116,958,2074,2147
3405-000,2017,3,22,18,1277,1169,2446,2074
3405-000,2017,3,22,19,1201,1050,2251,2446
3405-000,2017,3,22,20,767,626,1393,2251
3405-000,2017,3,22,21,518,475,993,1393
3405-000,2017,3,22,22,424,390,814,993
3405-000,2017,3,22,23,253,197,450,814
3405-000,2017,3,22,24,139,154,293,450
3405-000,2017,3,23,1,95,106,201,293
3405-000,2017,3,23,2,66,72,138,201
3405-000,2017,3,23,3,57,66,123,138
3405-000,2017,3,23,4,54,69,123,123
3405-000,2017,3,23,5,103,100,203,123
3405-000,2017,3,23,6,215,206,421,203
3405-000,2017,3,23,7,570,482,1052,421
3405-000,2017,3,23,8,1129,1346,2475,1052
3405-000,2017,3,23,9,1396,1279,2675,2475
3405-000,2017,3,23,10,1125,984,2109,2675
3405-000,2017,3,23,11,1122,1022,2144,2109
3405-000,2017,3,23,12,1008,926,1934,2144
3405-000,2017,3,23,13,892,814,1706,1934
3405-000,2017,3,23,14,1006,939,1945,1706
3405-000,2017,3,23,15,1115,973,2088,1945
3405-000,2017,3,23,16,1102,1000,2102,2088
3405-000,2017,3,23,17,1129,994,2123,2102
3405-000,2017,3,23,18,1209,1059,2268,2123
3405-000,2017,3,23,19,1054,1026,2080,2268
3405-000,2017,3,23,20,737,621,1358,2080
3405-000,2017,3,23,21,629,578,1207,1358
3405-000,2017,3,23,22,422,411,833,1207
3405-000,2017,3,23,23,237,254,491,833
3405-000,2017,3,23,24,151,161,312,491
3405-000,2017,3,24,1,95,114,209,312
3405-000,2017,3,24,2,60,80,140,209
3405-000,2017,3,24,3,54,63,117,140
3405-000,2017,3,24,4,53,79,132,117
3405-000,2017,3,24,5,99,96,195,132
3405-000,2017,3,24,6,236,203,439,195
3405-000,2017,3,24,7,535,481,1016,439
3405-000,2017,3,24,8,1105,1318,2423,1016
3405-000,2017,3,24,9,1391,1264,2655,2423
3405-000,2017,3,24,10,1129,984,2113,2655
3405-000,2017,3,24,11,1173,1037,2210,2113
3405-000,2017,3,24,12,1133,1001,2134,2210
3405-000,2017,3,24,13,923,817,1740,2134
3405-000,2017,3,24,14,1025,948,1973,1740
3405-000,2017,3,24,15,1174,1001,2175,1973
3405-000,2017,3,24,16,1164,1017,2181,2175
3405-000,2017,3,24,17,1176,979,2155,2181
3405-000,2017,3,24,18,1447,1150,2597,2155
3405-000,2017,3,24,19,1491,1132,2623,2597
3405-000,2017,3,24,20,947,755,1702,2623
3405-000,2017,3,24,21,681,566,1247,1702
3405-000,2017,3,24,22,461,442,903,1247
3405-000,2017,3,24,23,297,244,541,903
3405-000,2017,3,24,24,169,180,349,541
3405-000,2017,3,25,1,90,108,198,349
3405-000,2017,3,25,2,81,88,169,198
3405-000,2017,3,25,3,66,60,126,169
3405-000,2017,3,25,4,59,89,148,126
3405-000,2017,3,25,5,92,80,172,148
3405-000,2017,3,25,6,205,174,379,172
3405-000,2017,3,25,7,381,332,713,379
3405-000,2017,3,25,8,682,648,1330,713
3405-000,2017,3,25,9,926,777,1703,1330
3405-000,2017,3,25,10,881,760,1641,1703
3405-000,2017,3,25,11,929,754,1683,1641
3405-000,2017,3,25,12,896,798,1694,1683
3405-000,2017,3,25,13,778,710,1488,1694
3405-000,2017,3,25,14,809,774,1583,1488
3405-000,2017,3,25,15,917,716,1633,1583
3405-000,2017,3,25,16,894,755,1649,1633
3405-000,2017,3,25,17,897,738,1635,1649
3405-000,2017,3,25,18,1115,890,2005,1635
3405-000,2017,3,25,19,861,648,1509,2005
3405-000,2017,3,25,20,564,432,996,1509
3405-000,2017,3,25,21,382,339,721,996
3405-000,2017,3,25,22,287,318,605,721
3405-000,2017,3,25,23,207,200,407,605
3405-000,2017,3,25,24,120,125,245,407
3405-000,2017,3,26,1,73,68,141,245
3405-000,2017,3,26,2,51,45,96,141
3405-000,2017,3,26,3,37,35,72,96
3405-000,2017,3,26,4,36,29,65,72
3405-000,2017,3,26,5,58,34,92,65
3405-000,2017,3,26,6,98,72,170,92
3405-000,2017,3,26,7,227,152,379,170
3405-000,2017,3,26,8,367,300,667,379
3405-000,2017,3,26,9,482,410,892,667
3405-000,2017,3,26,10,515,367,882,892
3405-000,2017,3,26,11,634,448,1082,882
3405-000,2017,3,26,12,620,510,1130,1082
3405-000,2017,3,26,13,541,501,1042,1130
3405-000,2017,3,26,14,642,576,1218,1042
3405-000,2017,3,26,15,641,619,1260,1218
3405-000,2017,3,26,16,676,679,1355,1260
3405-000,2017,3,26,17,696,652,1348,1355
3405-000,2017,3,26,18,736,640,1376,1348
3405-000,2017,3,26,19,628,546,1174,1376
3405-000,2017,3,26,20,441,469,910,1174
3405-000,2017,3,26,21,384,481,865,910
3405-000,2017,3,26,22,241,397,638,865
3405-000,2017,3,26,23,191,277,468,638
3405-000,2017,3,26,24,120,155,275,468
3405-000,2017,3,27,1,58,98,156,275
3405-000,2017,3,27,2,35,70,105,156
3405-000,2017,3,27,3,44,52,96,105
3405-000,2017,3,27,4,51,71,122,96
3405-000,2017,3,27,5,94,85,179,122
3405-000,2017,3,27,6,224,271,495,179
3405-000,2017,3,27,7,618,631,1249,495
3405-000,2017,3,27,8,1247,1520,2767,1249
3405-000,2017,3,27,9,1441,1331,2772,2767
3405-000,2017,3,27,10,981,981,1962,2772
3405-000,2017,3,27,11,1044,972,2016,1962
3405-000,2017,3,27,12,1050,940,1990,2016
3405-000,2017,3,27,13,849,803,1652,1990
3405-000,2017,3,27,14,1012,946,1958,1652
3405-000,2017,3,27,15,1165,948,2113,1958
3405-000,2017,3,27,16,1085,922,2007,2113
3405-000,2017,3,27,17,1051,956,2007,2007
3405-000,2017,3,27,18,1166,1037,2203,2007
3405-000,2017,3,27,19,1061,957,2018,2203
3405-000,2017,3,27,20,752,663,1415,2018
3405-000,2017,3,27,21,576,583,1159,1415
3405-000,2017,3,27,22,410,439,849,1159
3405-000,2017,3,27,23,267,220,487,849
3405-000,2017,3,27,24,136,153,289,487
3405-000,2017,3,28,1,94,107,201,289
3405-000,2017,3,28,2,46,78,124,201
3405-000,2017,3,28,3,49,55,104,124
3405-000,2017,3,28,4,62,76,138,104
3405-000,2017,3,28,5,102,104,206,138
3405-000,2017,3,28,6,208,210,418,206
3405-000,2017,3,28,7,550,517,1067,418
3405-000,2017,3,28,8,1169,1337,2506,1067
3405-000,2017,3,28,9,1364,1237,2601,2506
3405-000,2017,3,28,10,1148,981,2129,2601
3405-000,2017,3,28,11,1105,976,2081,2129
3405-000,2017,3,28,12,1035,922,1957,2081
3405-000,2017,3,28,13,847,866,1713,1957
3405-000,2017,3,28,14,1026,944,1970,1713
3405-000,2017,3,28,15,1114,990,2104,1970
3405-000,2017,3,28,16,1103,1041,2144,2104
3405-000,2017,3,28,17,1104,1016,2120,2144
3405-000,2017,3,28,18,1187,1035,2222,2120
3405-000,2017,3,28,19,1076,1007,2083,2222
3405-000,2017,3,28,20,712,685,1397,2083
3405-000,2017,3,28,21,551,523,1074,1397
3405-000,2017,3,28,22,431,402,833,1074
3405-000,2017,3,28,23,254,210,464,833
3405-000,2017,3,28,24,135,132,267,464
3405-000,2017,3,29,1,86,111,197,267
3405-000,2017,3,29,2,68,74,142,197
3405-000,2017,3,29,3,53,57,110,142
3405-000,2017,3,29,4,54,73,127,110
3405-000,2017,3,29,5,81,91,172,127
3405-000,2017,3,29,6,233,215,448,172
3405-000,2017,3,29,7,585,472,1057,448
3405-000,2017,3,29,8,1149,1372,2521,1057
3405-000,2017,3,29,9,1392,1230,2622,2521
3405-000,2017,3,29,10,1137,1045,2182,2622
3405-000,2017,3,29,11,1067,904,1971,2182
3405-000,2017,3,29,12,1121,904,2025,1971
3405-000,2017,3,29,13,894,796,1690,2025
3405-000,2017,3,29,14,1058,910,1968,1690
3405-000,2017,3,29,15,1100,1054,2154,1968
3405-000,2017,3,29,16,1136,946,2082,2154
3405-000,2017,3,29,17,1052,986,2038,2082
3405-000,2017,3,29,18,1245,1134,2379,2038
3405-000,2017,3,29,19,1159,1015,2174,2379
3405-000,2017,3,29,20,748,665,1413,2174
3405-000,2017,3,29,21,506,543,1049,1413
3405-000,2017,3,29,22,373,350,723,1049
3405-000,2017,3,29,23,264,241,505,723
3405-000,2017,3,29,24,165,166,331,505
3405-000,2017,3,30,1,76,107,183,331
3405-000,2017,3,30,2,81,70,151,183
3405-000,2017,3,30,3,49,66,115,151
3405-000,2017,3,30,4,66,75,141,115
3405-000,2017,3,30,5,102,88,190,141
3405-000,2017,3,30,6,220,215,435,190
3405-000,2017,3,30,7,560,518,1078,435
3405-000,2017,3,30,8,1124,1400,2524,1078
3405-000,2017,3,30,9,1437,1271,2708,2524
3405-000,2017,3,30,10,1173,997,2170,2708
3405-000,2017,3,30,11,1099,944,2043,2170
3405-000,2017,3,30,12,1012,918,1930,2043
3405-000,2017,3,30,13,862,889,1751,1930
3405-000,2017,3,30,14,1026,923,1949,1751
3405-000,2017,3,30,15,1150,1019,2169,1949
3405-000,2017,3,30,16,1145,970,2115,2169
3405-000,2017,3,30,17,1136,1010,2146,2115
3405-000,2017,3,30,18,1160,1024,2184,2146
3405-000,2017,3,30,19,1098,940,2038,2184
3405-000,2017,3,30,20,711,644,1355,2038
3405-000,2017,3,30,21,560,543,1103,1355
3405-000,2017,3,30,22,433,422,855,1103
3405-000,2017,3,30,23,235,239,474,855
3405-000,2017,3,30,24,163,140,303,474
3405-000,2017,3,31,1,105,93,198,303
3405-000,2017,3,31,2,62,78,140,198
3405-000,2017,3,31,3,51,61,112,140
3405-000,2017,3,31,4,64,75,139,112
3405-000,2017,3,31,5,118,90,208,139
3405-000,2017,3,31,6,190,210,400,208
3405-000,2017,3,31,7,523,491,1014,400
3405-000,2017,3,31,8,1126,1282,2408,1014
3405-000,2017,3,31,9,1404,1287,2691,2408
3405-000,2017,3,31,10,1149,979,2128,2691
3405-000,2017,3,31,11,1103,973,2076,2128
3405-000,2017,3,31,12,1054,952,2006,2076
3405-000,2017,3,31,13,923,806,1729,2006
3405-000,2017,3,31,14,1027,933,1960,1729
3405-000,2017,3,31,15,1126,940,2066,1960
3405-000,2017,3,31,16,1163,951,2114,2066
3405-000,2017,3,31,17,1077,958,2035,2114
3405-000,2017,3,31,18,1278,1093,2371,2035
3405-000,2017,3,31,19,1342,1115,2457,2371
3405-000,2017,3,31,20,965,672,1637,2457
3405-000,2017,3,31,21,705,559,1264,1637
3405-000,2017,3,31,22,434,505,939,1264
3405-000,2017,3,31,23,331,254,585,939
3405-000,2017,3,31,24,156,179,335,585
3405-000,2017,4,1,1,108,99,207,335
3405-000,2017,4,1,2,76,75,151,207
3405-000,2017,4,1,3,56,71,127,151
3405-000,2017,4,1,4,57,64,121,127
3405-000,2017,4,1,5,83,72,155,121
3405-000,2017,4,1,6,177,180,357,155
3405-000,2017,4,1,7,423,337,760,357
3405-000,2017,4,1,8,731,607,1338,760
3405-000,2017,4,1,9,900,797,1697,1338
3405-000,2017,4,1,10,914,758,1672,1697
3405-000,2017,4,1,11,900,837,1737,1672
3405-000,2017,4,1,12,886,848,1734,1737
3405-000,2017,4,1,13,791,715,1506,1734
3405-000,2017,4,1,14,775,813,1588,1506
3405-000,2017,4,1,15,883,771,1654,1588
3405-000,2017,4,1,16,855,783,1638,1654
3405-000,2017,4,1,17,935,736,1671,1638
3405-000,2017,4,1,18,1129,855,1984,1671
3405-000,2017,4,1,19,887,736,1623,1984
3405-000,2017,4,1,20,556,475,1031,1623
3405-000,2017,4,1,21,438,414,852,1031
3405-000,2017,4,1,22,298,272,570,852
3405-000,2017,4,1,23,198,189,387,570
3405-000,2017,4,1,24,126,154,280,387
3405-000,2017,4,2,1,87,87,174,280
3405-000,2017,4,2,2,45,47,92,174
3405-000,2017,4,2,3,34,44,78,92
3405-000,2017,4,2,4,45,37,82,78
3405-000,2017,4,2,5,57,32,89,82
3405-000,2017,4,2,6,88,76,164,89
3405-000,2017,4,2,7,238,156,394,164
3405-000,2017,4,2,8,364,270,634,394
3405-000,2017,4,2,9,510,365,875,634
3405-000,2017,4,2,10,613,403,1016,875
3405-000,2017,4,2,11,625,502,1127,1016
3405-000,2017,4,2,12,647,540,1187,1127
3405-000,2017,4,2,13,576,574,1150,1187
3405-000,2017,4,2,14,638,655,1293,1150
3405-000,2017,4,2,15,650,661,1311,1293
3405-000,2017,4,2,16,733,685,1418,1311
3405-000,2017,4,2,17,765,711,1476,1418
3405-000,2017,4,2,18,802,685,1487,1476
3405-000,2017,4,2,19,703,606,1309,1487
3405-000,2017,4,2,20,583,538,1121,1309
3405-000,2017,4,2,21,402,480,882,1121
3405-000,2017,4,2,22,307,416,723,882
3405-000,2017,4,2,23,220,277,497,723
3405-000,2017,4,2,24,129,184,313,497
3405-000,2017,4,3,1,77,112,189,313
3405-000,2017,4,3,2,49,70,119,189
3405-000,2017,4,3,3,50,53,103,119
3405-000,2017,4,3,4,49,71,120,103
3405-000,2017,4,3,5,105,98,203,120
3405-000,2017,4,3,6,238,258,496,203
3405-000,2017,4,3,7,659,663,1322,496
3405-000,2017,4,3,8,1266,1653,2919,1322
3405-000,2017,4,3,9,1365,1360,2725,2919
3405-000,2017,4,3,10,1045,922,1967,2725
3405-000,2017,4,3,11,1040,985,2025,1967
3405-000,2017,4,3,12,1062,918,1980,2025
3405-000,2017,4,3,13,828,807,1635,1980
3405-000,2017,4,3,14,997,938,1935,1635
3405-000,2017,4,3,15,1119,982,2101,1935
3405-000,2017,4,3,16,1106,965,2071,2101
3405-000,2017,4,3,17,1037,952,1989,2071
3405-000,2017,4,3,18,1142,1076,2218,1989
3405-000,2017,4,3,19,1036,1006,2042,2218
3405-000,2017,4,3,20,758,661,1419,2042
3405-000,2017,4,3,21,640,656,1296,1419
3405-000,2017,4,3,22,414,474,888,1296
3405-000,2017,4,3,23,274,249,523,888
3405-000,2017,4,3,24,155,148,303,523
3405-000,2017,4,4,1,101,109,210,303
3405-000,2017,4,4,2,64,68,132,210
3405-000,2017,4,4,3,49,61,110,132
3405-000,2017,4,4,4,57,83,140,110
3405-000,2017,4,4,5,106,99,205,140
3405-000,2017,4,4,6,221,198,419,205
3405-000,2017,4,4,7,542,538,1080,419
3405-000,2017,4,4,8,1142,1416,2558,1080
3405-000,2017,4,4,9,1393,1244,2637,2558
3405-000,2017,4,4,10,1099,1005,2104,2637
3405-000,2017,4,4,11,1211,933,2144,2104
3405-000,2017,4,4,12,1036,886,1922,2144
3405-000,2017,4,4,13,895,764,1659,1922
3405-000,2017,4,4,14,968,996,1964,1659
3405-000,2017,4,4,15,1111,983,2094,1964
3405-000,2017,4,4,16,1155,1053,2208,2094
3405-000,2017,4,4,17,1181,907,2088,2208
3405-000,2017,4,4,18,1209,1017,2226,2088
3405-000,2017,4,4,19,1088,1036,2124,2226
3405-000,2017,4,4,20,761,674,1435,2124
3405-000,2017,4,4,21,640,600,1240,1435
3405-000,2017,4,4,22,409,463,872,1240
3405-000,2017,4,4,23,259,241,500,872
3405-000,2017,4,4,24,185,167,352,500
3405-000,2017,4,5,1,95,100,195,352
3405-000,2017,4,5,2,69,80,149,195
3405-000,2017,4,5,3,52,56,108,149
3405-000,2017,4,5,4,59,67,126,108
3405-000,2017,4,5,5,120,101,221,126
3405-000,2017,4,5,6,207,205,412,221
3405-000,2017,4,5,7,541,530,1071,412
3405-000,2017,4,5,8,1137,1274,2411,1071
3405-000,2017,4,5,9,1424,1239,2663,2411
3405-000,2017,4,5,10,1092,1016,2108,2663
3405-000,2017,4,5,11,1129,1049,2178,2108
3405-000,2017,4,5,12,1043,859,1902,2178
3405-000,2017,4,5,13,878,846,1724,1902
3405-000,2017,4,5,14,1016,935,1951,1724
3405-000,2017,4,5,15,1091,1017,2108,1951
3405-000,2017,4,5,16,1075,919,1994,2108
3405-000,2017,4,5,17,1032,909,1941,1994
3405-000,2017,4,5,18,1157,987,2144,1941
3405-000,2017,4,5,19,1084,1004,2088,2144
3405-000,2017,4,5,20,657,604,1261,2088
3405-000,2017,4,5,21,530,473,1003,1261
3405-000,2017,4,5,22,351,365,716,1003
3405-000,2017,4,5,23,249,232,481,716
3405-000,2017,4,5,24,144,142,286,481
3405-000,2017,4,6,1,92,86,178,286
3405-000,2017,4,6,2,49,83,132,178
3405-000,2017,4,6,3,30,52,82,132
3405-000,2017,4,6,4,53,69,122,82
3405-000,2017,4,6,5,85,95,180,122
3405-000,2017,4,6,6,212,193,405,180
3405-000,2017,4,6,7,492,442,934,405
3405-000,2017,4,6,8,1108,1230,2338,934
3405-000,2017,4,6,9,1341,1251,2592,2338
3405-000,2017,4,6,10,1090,976,2066,2592
3405-000,2017,4,6,11,1048,979,2027,2066
3405-000,2017,4,6,12,1091,868,1959,2027
3405-000,2017,4,6,13,838,791,1629,1959
3405-000,2017,4,6,14,1008,907,1915,1629
3405-000,2017,4,6,15,1084,973,2057,1915
3405-000,2017,4,6,16,1111,979,2090,2057
3405-000,2017,4,6,17,1114,996,2110,2090
3405-000,2017,4,6,18,1153,972,2125,2110
3405-000,2017,4,6,19,1015,1043,2058,2125
3405-000,2017,4,6,20,731,634,1365,2058
3405-000,2017,4,6,21,628,569,1197,1365
3405-000,2017,4,6,22,404,441,845,1197
3405-000,2017,4,6,23,243,260,503,845
3405-000,2017,4,6,24,158,163,321,503
3405-000,2017,4,7,1,102,109,211,321
3405-000,2017,4,7,2,49,81,130,211
3405-000,2017,4,7,3,62,68,130,130
3405-000,2017,4,7,4,61,64,125,130
3405-000,2017,4,7,5,117,93,210,125
3405-000,2017,4,7,6,219,211,430,210
3405-000,2017,4,7,7,599,505,1104,430
3405-000,2017,4,7,8,1159,1356,2515,1104
3405-000,2017,4,7,9,1397,1248,2645,2515
3405-000,2017,4,7,10,1140,957,2097,2645
3405-000,2017,4,7,11,1151,1045,2196,2097
3405-000,2017,4,7,12,1024,890,1914,2196
3405-000,2017,4,7,13,930,811,1741,1914
3405-000,2017,4,7,14,1028,977,2005,1741
3405-000,2017,4,7,15,1238,994,2232,2005
3405-000,2017,4,7,16,1226,1012,2238,2232
3405-000,2017,4,7,17,1214,976,2190,2238
3405-000,2017,4,7,18,1356,1083,2439,2190
3405-000,2017,4,7,19,1456,1148,2604,2439
3405-000,2017,4,7,20,962,725,1687,2604
3405-000,2017,4,7,21,745,606,1351,1687
3405-000,2017,4,7,22,504,459,963,1351
3405-000,2017,4,7,23,325,283,608,963
3405-000,2017,4,7,24,173,180,353,608
3405-000,2017,4,8,1,136,138,274,353
3405-000,2017,4,8,2,77,78,155,274
3405-000,2017,4,8,3,64,64,128,155
3405-000,2017,4,8,4,62,88,150,128
3405-000,2017,4,8,5,108,92,200,150
3405-000,2017,4,8,6,203,183,386,200
3405-000,2017,4,8,7,475,380,855,386
3405-000,2017,4,8,8,798,749,1547,855
3405-000,2017,4,8,9,959,824,1783,1547
3405-000,2017,4,8,10,947,817,1764,1783
3405-000,2017,4,8,11,978,826,1804,1764
3405-000,2017,4,8,12,904,1006,1910,1804
3405-000,2017,4,8,13,808,854,1662,1910
3405-000,2017,4,8,14,861,711,1572,1662
3405-000,2017,4,8,15,920,868,1788,1572
3405-000,2017,4,8,16,928,863,1791,1788
3405-000,2017,4,8,17,985,797,1782,1791
3405-000,2017,4,8,18,1148,875,2023,1782
3405-000,2017,4,8,19,964,700,1664,2023
3405-000,2017,4,8,20,597,527,1124,1664
3405-000,2017,4,8,21,435,419,854,1124
3405-000,2017,4,8,22,302,310,612,854
3405-000,2017,4,8,23,226,218,444,612
3405-000,2017,4,8,24,144,148,292,444
3405-000,2017,4,9,1,85,82,167,292
3405-000,2017,4,9,2,60,48,108,167
3405-000,2017,4,9,3,40,58,98,108
3405-000,2017,4,9,4,34,37,71,98
3405-000,2017,4,9,5,55,34,89,71
3405-000,2017,4,9,6,104,91,195,89
3405-000,2017,4,9,7,253,175,428,195
3405-000,2017,4,9,8,328,301,629,428
3405-000,2017,4,9,9,506,386,892,629
3405-000,2017,4,9,10,551,416,967,892
3405-000,2017,4,9,11,694,485,1179,967
3405-000,2017,4,9,12,608,461,1069,1179
3405-000,2017,4,9,13,600,550,1150,1069
3405-000,2017,4,9,14,626,616,1242,1150
3405-000,2017,4,9,15,738,586,1324,1242
3405-000,2017,4,9,16,688,610,1298,1324
3405-000,2017,4,9,17,716,661,1377,1298
3405-000,2017,4,9,18,765,624,1389,1377
3405-000,2017,4,9,19,656,568,1224,1389
3405-000,2017,4,9,20,511,511,1022,1224
3405-000,2017,4,9,21,426,467,893,1022
3405-000,2017,4,9,22,280,446,726,893
3405-000,2017,4,9,23,185,379,564,726
3405-000,2017,4,9,24,137,187,324,564
3405-000,2017,4,10,1,71,105,176,324
3405-000,2017,4,10,2,44,78,122,176
3405-000,2017,4,10,3,42,53,95,122
3405-000,2017,4,10,4,48,67,115,95
3405-000,2017,4,10,5,115,106,221,115
3405-000,2017,4,10,6,256,256,512,221
3405-000,2017,4,10,7,643,713,1356,512
3405-000,2017,4,10,8,1229,1585,2814,1356
3405-000,2017,4,10,9,1388,1367,2755,2814
3405-000,2017,4,10,10,1097,938,2035,2755
3405-000,2017,4,10,11,1077,979,2056,2035
3405-000,2017,4,10,12,1024,941,1965,2056
3405-000,2017,4,10,13,899,784,1683,1965
3405-000,2017,4,10,14,992,947,1939,1683
3405-000,2017,4,10,15,1157,974,2131,1939
3405-000,2017,4,10,16,1147,1013,2160,2131
3405-000,2017,4,10,17,1075,942,2017,2160
3405-000,2017,4,10,18,1133,1082,2215,2017
3405-000,2017,4,10,19,1098,1022,2120,2215
3405-000,2017,4,10,20,841,729,1570,2120
3405-000,2017,4,10,21,598,623,1221,1570
3405-000,2017,4,10,22,426,459,885,1221
3405-000,2017,4,10,23,278,276,554,885
3405-000,2017,4,10,24,143,180,323,554
3405-000,2017,4,11,1,100,112,212,323
3405-000,2017,4,11,2,67,71,138,212
3405-000,2017,4,11,3,50,81,131,138
3405-000,2017,4,11,4,64,62,126,131
3405-000,2017,4,11,5,108,95,203,126
3405-000,2017,4,11,6,221,203,424,203
3405-000,2017,4,11,7,537,498,1035,424
3405-000,2017,4,11,8,1076,1318,2394,1035
3405-000,2017,4,11,9,1353,1311,2664,2394
3405-000,2017,4,11,10,1171,970,2141,2664
3405-000,2017,4,11,11,1161,1001,2162,2141
3405-000,2017,4,11,12,1033,901,1934,2162
3405-000,2017,4,11,13,902,816,1718,1934
3405-000,2017,4,11,14,1004,949,1953,1718
3405-000,2017,4,11,15,1151,962,2113,1953
3405-000,2017,4,11,16,1211,989,2200,2113
3405-000,2017,4,11,17,1013,948,1961,2200
3405-000,2017,4,11,18,1140,1014,2154,1961
3405-000,2017,4,11,19,1079,1016,2095,2154
3405-000,2017,4,11,20,801,740,1541,2095
3405-000,2017,4,11,21,615,568,1183,1541
3405-000,2017,4,11,22,420,474,894,1183
3405-000,2017,4,11,23,282,246,528,894
3405-000,2017,4,11,24,162,144,306,528
3405-000,2017,4,12,1,104,92,196,306
3405-000,2017,4,12,2,62,65,127,196
3405-000,2017,4,12,3,63,56,119,127
3405-000,2017,4,12,4,50,71,121,119
3405-000,2017,4,12,5,103,109,212,121
3405-000,2017,4,12,6,234,200,434,212
3405-000,2017,4,12,7,628,511,1139,434
3405-000,2017,4,12,8,1182,1435,2617,1139
3405-000,2017,4,12,9,1394,1277,2671,2617
3405-000,2017,4,12,10,1149,975,2124,2671
3405-000,2017,4,12,11,1192,1054,2246,2124
3405-000,2017,4,12,12,1087,946,2033,2246
3405-000,2017,4,12,13,895,867,1762,2033
3405-000,2017,4,12,14,1042,935,1977,1762
3405-000,2017,4,12,15,1199,1012,2211,1977
3405-000,2017,4,12,16,1131,1101,2232,2211
3405-000,2017,4,12,17,1096,980,2076,2232
3405-000,2017,4,12,18,1307,1142,2449,2076
3405-000,2017,4,12,19,1175,1073,2248,2449
3405-000,2017,4,12,20,773,725,1498,2248
3405-000,2017,4,12,21,589,539,1128,1498
3405-000,2017,4,12,22,425,400,825,1128
3405-000,2017,4,12,23,301,234,535,825
3405-000,2017,4,12,24,150,162,312,535
3405-000,2017,4,13,1,99,115,214,312
3405-000,2017,4,13,2,66,90,156,214
3405-000,2017,4,13,3,54,64,118,156
3405-000,2017,4,13,4,54,84,138,118
3405-000,2017,4,13,5,128,117,245,138
3405-000,2017,4,13,6,236,218,454,245
3405-000,2017,4,13,7,581,507,1088,454
3405-000,2017,4,13,8,1148,1399,2547,1088
3405-000,2017,4,13,9,1397,1340,2737,2547
3405-000,2017,4,13,10,1170,976,2146,2737
3405-000,2017,4,13,11,1101,962,2063,2146
3405-000,2017,4,13,12,1100,1029,2129,2063
3405-000,2017,4,13,13,882,809,1691,2129
3405-000,2017,4,13,14,1086,975,2061,1691
3405-000,2017,4,13,15,1189,1031,2220,2061
3405-000,2017,4,13,16,1233,1041,2274,2220
3405-000,2017,4,13,17,1115,945,2060,2274
3405-000,2017,4,13,18,1321,1037,2358,2060
3405-000,2017,4,13,19,1141,1038,2179,2358
3405-000,2017,4,13,20,784,688,1472,2179
3405-000,2017,4,13,21,593,583,1176,1472
3405-000,2017,4,13,22,419,432,851,1176
3405-000,2017,4,13,23,264,234,498,851
3405-000,2017,4,13,24,166,168,334,498
3405-000,2017,4,14,1,113,125,238,334
3405-000,2017,4,14,2,65,78,143,238
3405-000,2017,4,14,3,56,64,120,143
3405-000,2017,4,14,4,64,74,138,120
3405-000,2017,4,14,5,109,101,210,138
3405-000,2017,4,14,6,209,226,435,210
3405-000,2017,4,14,7,579,512,1091,435
3405-000,2017,4,14,8,1120,1371,2491,1091
3405-000,2017,4,14,9,1441,1307,2748,2491
3405-000,2017,4,14,10,1190,1036,2226,2748
3405-000,2017,4,14,11,1121,1012,2133,2226
3405-000,2017,4,14,12,1072,901,1973,2133
3405-000,2017,4,14,13,1003,830,1833,1973
3405-000,2017,4,14,14,1106,962,2068,1833
3405-000,2017,4,14,15,1164,955,2119,2068
3405-000,2017,4,14,16,1183,1012,2195,2119
3405-000,2017,4,14,17,1161,941,2102,2195
3405-000,2017,4,14,18,1339,1098,2437,2102
3405-000,2017,4,14,19,1422,1107,2529,2437
3405-000,2017,4,14,20,911,776,1687,2529
3405-000,2017,4,14,21,753,631,1384,1687
3405-000,2017,4,14,22,476,427,903,1384
3405-000,2017,4,14,23,286,227,513,903
3405-000,2017,4,14,24,167,159,326,513
3405-000,2017,4,15,1,128,113,241,326
3405-000,2017,4,15,2,82,84,166,241
3405-000,2017,4,15,3,57,84,141,166
3405-000,2017,4,15,4,68,70,138,141
3405-000,2017,4,15,5,103,113,216,138
3405-000,2017,4,15,6,219,173,392,216
3405-000,2017,4,15,7,467,390,857,392
3405-000,2017,4,15,8,731,724,1455,857
3405-000,2017,4,15,9,978,849,1827,1455
3405-000,2017,4,15,10,897,766,1663,1827
3405-000,2017,4,15,11,965,815,1780,1663
3405-000,2017,4,15,12,952,751,1703,1780
3405-000,2017,4,15,13,782,764,1546,1703
3405-000,2017,4,15,14,814,759,1573,1546
3405-000,2017,4,15,15,887,826,1713,1573
3405-000,2017,4,15,16,935,818,1753,1713
3405-000,2017,4,15,17,867,760,1627,1753
3405-000,2017,4,15,18,1155,875,2030,1627
3405-000,2017,4,15,19,921,716,1637,2030
3405-000,2017,4,15,20,560,522,1082,1637
3405-000,2017,4,15,21,441,389,830,1082
3405-000,2017,4,15,22,307,297,604,830
3405-000,2017,4,15,23,207,234,441,604
3405-000,2017,4,15,24,138,156,294,441
3405-000,2017,4,16,1,108,62,170,294
3405-000,2017,4,16,2,48,57,105,170
3405-000,2017,4,16,3,37,35,72,105
3405-000,2017,4,16,4,38,44,82,72
3405-000,2017,4,16,5,76,53,129,82
3405-000,2017,4,16,6,127,89,216,129
3405-000,2017,4,16,7,258,194,452,216
3405-000,2017,4,16,8,393,373,766,452
3405-000,2017,4,16,9,525,453,978,766
3405-000,2017,4,16,10,589,431,1020,978
3405-000,2017,4,16,11,632,561,1193,1020
3405-000,2017,4,16,12,692,558,1250,1193
3405-000,2017,4,16,13,574,540,1114,1250
3405-000,2017,4,16,14,639,617,1256,1114
3405-000,2017,4,16,15,708,721,1429,1256
3405-000,2017,4,16,16,783,675,1458,1429
3405-000,2017,4,16,17,722,725,1447,1458
3405-000,2017,4,16,18,817,747,1564,1447
3405-000,2017,4,16,19,678,696,1374,1564
3405-000,2017,4,16,20,570,572,1142,1374
3405-000,2017,4,16,21,451,451,902,1142
3405-000,2017,4,16,22,340,375,715,902
3405-000,2017,4,16,23,243,301,544,715
3405-000,2017,4,16,24,131,199,330,544
3405-000,2017,4,17,1,95,88,183,330
3405-000,2017,4,17,2,58,67,125,183
3405-000,2017,4,17,3,35,51,86,125
3405-000,2017,4,17,4,58,69,127,86
3405-000,2017,4,17,5,110,92,202,127
3405-000,2017,4,17,6,232,266,498,202
3405-000,2017,4,17,7,616,670,1286,498
3405-000,2017,4,17,8,1216,1592,2808,1286
3405-000,2017,4,17,9,1367,1304,2671,2808
3405-000,2017,4,17,10,1014,922,1936,2671
3405-000,2017,4,17,11,1026,900,1926,1936
3405-000,2017,4,17,12,990,872,1862,1926
3405-000,2017,4,17,13,834,765,1599,1862
3405-000,2017,4,17,14,887,911,1798,1599
3405-000,2017,4,17,15,994,937,1931,1798
3405-000,2017,4,17,16,1056,915,1971,1931
3405-000,2017,4,17,17,990,888,1878,1971
3405-000,2017,4,17,18,1091,911,2002,1878
3405-000,2017,4,17,19,1025,1009,2034,2002
3405-000,2017,4,17,20,736,647,1383,2034
3405-000,2017,4,17,21,564,544,1108,1383
3405-000,2017,4,17,22,422,401,823,1108
3405-000,2017,4,17,23,240,235,475,823
3405-000,2017,4,17,24,139,165,304,475
3405-000,2017,4,18,1,114,97,211,304
3405-000,2017,4,18,2,58,77,135,211
3405-000,2017,4,18,3,45,60,105,135
3405-000,2017,4,18,4,83,66,149,105
3405-000,2017,4,18,5,126,96,222,149
3405-000,2017,4,18,6,243,202,445,222
3405-000,2017,4,18,7,567,547,1114,445
3405-000,2017,4,18,8,1183,1458,2641,1114
3405-000,2017,4,18,9,1396,1293,2689,2641
3405-000,2017,4,18,10,1195,1030,2225,2689
3405-000,2017,4,18,11,1156,1100,2256,2225
3405-000,2017,4,18,12,1116,906,2022,2256
3405-000,2017,4,18,13,921,841,1762,2022
3405-000,2017,4,18,14,1050,987,2037,1762
3405-000,2017,4,18,15,1089,922,2011,2037
3405-000,2017,4,18,16,1161,968,2129,2011
3405-000,2017,4,18,17,1097,948,2045,2129
3405-000,2017,4,18,18,1115,1011,2126,2045
3405-000,2017,4,18,19,1030,923,1953,2126
3405-000,2017,4,18,20,638,654,1292,1953
3405-000,2017,4,18,21,608,581,1189,1292
3405-000,2017,4,18,22,437,424,861,1189
3405-000,2017,4,18,23,234,223,457,861
3405-000,2017,4,18,24,177,179,356,457
3405-000,2017,4,19,1,114,91,205,356
3405-000,2017,4,19,2,70,56,126,205
3405-000,2017,4,19,3,55,60,115,126
3405-000,2017,4,19,4,56,56,112,115
3405-000,2017,4,19,5,117,99,216,112
3405-000,2017,4,19,6,206,229,435,216
3405-000,2017,4,19,7,587,539,1126,435
3405-000,2017,4,19,8,1167,1414,2581,1126
3405-000,2017,4,19,9,1385,1317,2702,2581
3405-000,2017,4,19,10,1138,1048,2186,2702
3405-000,2017,4,19,11,1122,1006,2128,2186
3405-000,2017,4,19,12,1050,917,1967,2128
3405-000,2017,4,19,13,868,891,1759,1967
3405-000,2017,4,19,14,1029,982,2011,1759
3405-000,2017,4,19,15,1168,1097,2265,2011
3405-000,2017,4,19,16,1162,965,2127,2265
3405-000,2017,4,19,17,1109,993,2102,2127
3405-000,2017,4,19,18,1346,1182,2528,2102
3405-000,2017,4,19,19,1113,1071,2184,2528
3405-000,2017,4,19,20,767,735,1502,2184
3405-000,2017,4,19,21,600,572,1172,1502
3405-000,2017,4,19,22,471,410,881,1172
3405-000,2017,4,19,23,334,234,568,881
3405-000,2017,4,19,24,269,148,417,568
3405-000,2017,4,20,1,119,102,221,417
3405-000,2017,4,20,2,59,75,134,221
3405-000,2017,4,20,3,60,59,119,134
3405-000,2017,4,20,4,60,71,131,119
3405-000,2017,4,20,5,113,99,212,131
3405-000,2017,4,20,6,226,214,440,212
3405-000,2017,4,20,7,572,554,1126,440
3405-000,2017,4,20,8,1172,1388,2560,1126
3405-000,2017,4,20,9,1380,1337,2717,2560
3405-000,2017,4,20,10,1111,1024,2135,2717
3405-000,2017,4,20,11,1158,1047,2205,2135
3405-000,2017,4,20,12,1117,913,2030,2205
3405-000,2017,4,20,13,904,862,1766,2030
3405-000,2017,4,20,14,1025,982,2007,1766
3405-000,2017,4,20,15,1160,1037,2197,2007
3405-000,2017,4,20,16,1143,1020,2163,2197
3405-000,2017,4,20,17,1126,930,2056,2163
3405-000,2017,4,20,18,1217,1048,2265,2056
3405-000,2017,4,20,19,1052,988,2040,2265
3405-000,2017,4,20,20,757,712,1469,2040
3405-000,2017,4,20,21,627,579,1206,1469
3405-000,2017,4,20,22,415,437,852,1206
3405-000,2017,4,20,23,244,270,514,852
3405-000,2017,4,20,24,158,168,326,514
3405-000,2017,4,21,1,101,107,208,326
3405-000,2017,4,21,2,81,90,171,208
3405-000,2017,4,21,3,49,60,109,171
3405-000,2017,4,21,4,66,90,156,109
3405-000,2017,4,21,5,124,93,217,156
3405-000,2017,4,21,6,240,221,461,217
3405-000,2017,4,21,7,638,538,1176,461
3405-000,2017,4,21,8,1173,1389,2562,1176
3405-000,2017,4,21,9,1471,1327,2798,2562
3405-000,2017,4,21,10,1162,1009,2171,2798
3405-000,2017,4,21,11,1186,984,2170,2171
3405-000,2017,4,21,12,1103,897,2000,2170
3405-000,2017,4,21,13,942,837,1779,2000
3405-000,2017,4,21,14,1075,888,1963,1779
3405-000,2017,4,21,15,1209,1064,2273,1963
3405-000,2017,4,21,16,1307,1064,2371,2273
3405-000,2017,4,21,17,1310,970,2280,2371
3405-000,2017,4,21,18,1567,1141,2708,2280
3405-000,2017,4,21,19,1532,1146,2678,2708
3405-000,2017,4,21,20,1089,784,1873,2678
3405-000,2017,4,21,21,786,629,1415,1873
3405-000,2017,4,21,22,454,467,921,1415
3405-000,2017,4,21,23,320,248,568,921
3405-000,2017,4,21,24,168,173,341,568
3405-000,2017,4,22,1,113,116,229,341
3405-000,2017,4,22,2,72,69,141,229
3405-000,2017,4,22,3,55,57,112,141
3405-000,2017,4,22,4,69,77,146,112
3405-000,2017,4,22,5,104,95,199,146
3405-000,2017,4,22,6,208,203,411,199
3405-000,2017,4,22,7,479,412,891,411
3405-000,2017,4,22,8,786,755,1541,891
3405-000,2017,4,22,9,1003,954,1957,1541
3405-000,2017,4,22,10,920,860,1780,1957
3405-000,2017,4,22,11,902,826,1728,1780
3405-000,2017,4,22,12,858,862,1720,1728
3405-000,2017,4,22,13,811,777,1588,1720
3405-000,2017,4,22,14,849,784,1633,1588
3405-000,2017,4,22,15,843,778,1621,1633
3405-000,2017,4,22,16,895,836,1731,1621
3405-000,2017,4,22,17,991,794,1785,1731
3405-000,2017,4,22,18,1118,945,2063,1785
3405-000,2017,4,22,19,910,684,1594,2063
3405-000,2017,4,22,20,609,545,1154,1594
3405-000,2017,4,22,21,405,399,804,1154
3405-000,2017,4,22,22,299,357,656,804
3405-000,2017,4,22,23,228,197,425,656
3405-000,2017,4,22,24,146,138,284,425
3405-000,2017,4,23,1,91,86,177,284
3405-000,2017,4,23,2,60,57,117,177
3405-000,2017,4,23,3,55,38,93,117
3405-000,2017,4,23,4,46,46,92,93
3405-000,2017,4,23,5,64,41,105,92
3405-000,2017,4,23,6,116,100,216,105
3405-000,2017,4,23,7,256,203,459,216
3405-000,2017,4,23,8,407,335,742,459
3405-000,2017,4,23,9,533,421,954,742
3405-000,2017,4,23,10,543,439,982,954
3405-000,2017,4,23,11,605,511,1116,982
3405-000,2017,4,23,12,591,520,1111,1116
3405-000,2017,4,23,13,613,567,1180,1111
3405-000,2017,4,23,14,590,594,1184,1180
3405-000,2017,4,23,15,674,644,1318,1184
3405-000,2017,4,23,16,766,729,1495,1318
3405-000,2017,4,23,17,773,611,1384,1495
3405-000,2017,4,23,18,809,650,1459,1384
3405-000,2017,4,23,19,726,644,1370,1459
3405-000,2017,4,23,20,542,516,1058,1370
3405-000,2017,4,23,21,401,457,858,1058
3405-000,2017,4,23,22,335,410,745,858
3405-000,2017,4,23,23,227,271,498,745
3405-000,2017,4,23,24,139,182,321,498
3405-000,2017,4,24,1,76,98,174,321
3405-000,2017,4,24,2,44,62,106,174
3405-000,2017,4,24,3,45,53,98,106
3405-000,2017,4,24,4,52,66,118,98
3405-000,2017,4,24,5,130,118,248,118
3405-000,2017,4,24,6,293,270,563,248
3405-000,2017,4,24,7,701,747,1448,563
3405-000,2017,4,24,8,1243,1613,2856,1448
3405-000,2017,4,24,9,1311,1384,2695,2856
3405-000,2017,4,24,10,1077,994,2071,2695
3405-000,2017,4,24,11,1086,1004,2090,2071
3405-000,2017,4,24,12,1093,950,2043,2090
3405-000,2017,4,24,13,905,824,1729,2043
3405-000,2017,4,24,14,1036,937,1973,1729
3405-000,2017,4,24,15,1110,1038,2148,1973
3405-000,2017,4,24,16,1092,1025,2117,2148
3405-000,2017,4,24,17,1073,982,2055,2117
3405-000,2017,4,24,18,1205,1006,2211,2055
3405-000,2017,4,24,19,1153,1043,2196,2211
3405-000,2017,4,24,20,764,702,1466,2196
3405-000,2017,4,24,21,603,609,1212,1466
3405-000,2017,4,24,22,396,459,855,1212
3405-000,2017,4,24,23,265,265,530,855
3405-000,2017,4,24,24,146,177,323,530
3405-000,2017,4,25,1,92,118,210,323
3405-000,2017,4,25,2,58,69,127,210
3405-000,2017,4,25,3,55,76,131,127
3405-000,2017,4,25,4,70,73,143,131
3405-000,2017,4,25,5,137,104,241,143
3405-000,2017,4,25,6,244,185,429,241
3405-000,2017,4,25,7,587,540,1127,429
3405-000,2017,4,25,8,1155,1359,2514,1127
3405-000,2017,4,25,9,1346,1359,2705,2514
3405-000,2017,4,25,10,1245,991,2236,2705
3405-000,2017,4,25,11,1137,1008,2145,2236
3405-000,2017,4,25,12,1058,958,2016,2145
3405-000,2017,4,25,13,867,782,1649,2016
3405-000,2017,4,25,14,1009,965,1974,1649
3405-000,2017,4,25,15,1145,1098,2243,1974
3405-000,2017,4,25,16,1211,991,2202,2243
3405-000,2017,4,25,17,1140,1018,2158,2202
3405-000,2017,4,25,18,1248,1061,2309,2158
3405-000,2017,4,25,19,1133,982,2115,2309
3405-000,2017,4,25,20,773,715,1488,2115
3405-000,2017,4,25,21,594,594,1188,1488
3405-000,2017,4,25,22,395,422,817,1188
3405-000,2017,4,25,23,265,231,496,817
3405-000,2017,4,25,24,144,198,342,496
3405-000,2017,4,26,1,108,102,210,342
3405-000,2017,4,26,2,61,78,139,210
3405-000,2017,4,26,3,42,62,104,139
3405-000,2017,4,26,4,66,62,128,104
3405-000,2017,4,26,5,133,97,230,128
3405-000,2017,4,26,6,264,194,458,230
3405-000,2017,4,26,7,577,498,1075,458
3405-000,2017,4,26,8,1127,1375,2502,1075
3405-000,2017,4,26,9,1351,1253,2604,2502
3405-000,2017,4,26,10,1152,945,2097,2604
3405-000,2017,4,26,11,1117,1137,2254,2097
3405-000,2017,4,26,12,995,1136,2131,2254
3405-000,2017,4,26,13,942,851,1793,2131
3405-000,2017,4,26,14,1018,987,2005,1793
3405-000,2017,4,26,15,1172,968,2140,2005
3405-000,2017,4,26,16,1165,982,2147,2140
3405-000,2017,4,26,17,1103,997,2100,2147
3405-000,2017,4,26,18,1316,1086,2402,2100
3405-000,2017,4,26,19,1158,1158,2316,2402
3405-000,2017,4,26,20,769,709,1478,2316
3405-000,2017,4,26,21,589,554,1143,1478
3405-000,2017,4,26,22,418,385,803,1143
3405-000,2017,4,26,23,254,218,472,803
3405-000,2017,4,26,24,139,174,313,472
3405-000,2017,4,27,1,91,99,190,313
3405-000,2017,4,27,2,68,77,145,190
3405-000,2017,4,27,3,73,64,137,145
3405-000,2017,4,27,4,54,78,132,137
3405-000,2017,4,27,5,132,106,238,132
3405-000,2017,4,27,6,244,237,481,238
3405-000,2017,4,27,7,594,560,1154,481
3405-000,2017,4,27,8,1202,1355,2557,1154
3405-000,2017,4,27,9,1405,1314,2719,2557
3405-000,2017,4,27,10,1161,1021,2182,2719
3405-000,2017,4,27,11,1101,1056,2157,2182
3405-000,2017,4,27,12,1117,940,2057,2157
3405-000,2017,4,27,13,894,836,1730,2057
3405-000,2017,4,27,14,1028,1037,2065,1730
3405-000,2017,4,27,15,1139,1030,2169,2065
3405-000,2017,4,27,16,1173,1054,2227,2169
3405-000,2017,4,27,17,1125,1002,2127,2227
3405-000,2017,4,27,18,1208,1175,2383,2127
3405-000,2017,4,27,19,1106,1058,2164,2383
3405-000,2017,4,27,20,794,699,1493,2164
3405-000,2017,4,27,21,621,624,1245,1493
3405-000,2017,4,27,22,454,484,938,1245
3405-000,2017,4,27,23,295,227,522,938
3405-000,2017,4,27,24,155,161,316,522
3405-000,2017,4,28,1,103,128,231,316
3405-000,2017,4,28,2,72,75,147,231
3405-000,2017,4,28,3,45,53,98,147
3405-000,2017,4,28,4,65,71,136,98
3405-000,2017,4,28,5,121,110,231,136
3405-000,2017,4,28,6,258,221,479,231
3405-000,2017,4,28,7,628,576,1204,479
3405-000,2017,4,28,8,1150,1323,2473,1204
3405-000,2017,4,28,9,1444,1296,2740,2473
3405-000,2017,4,28,10,1169,1026,2195,2740
3405-000,2017,4,28,11,1167,1086,2253,2195
3405-000,2017,4,28,12,1069,963,2032,2253
3405-000,2017,4,28,13,987,837,1824,2032
3405-000,2017,4,28,14,1035,974,2009,1824
3405-000,2017,4,28,15,1227,1020,2247,2009
3405-000,2017,4,28,16,1214,1023,2237,2247
3405-000,2017,4,28,17,1256,1066,2322,2237
3405-000,2017,4,28,18,1401,1188,2589,2322
3405-000,2017,4,28,19,1497,1118,2615,2589
3405-000,2017,4,28,20,973,841,1814,2615
3405-000,2017,4,28,21,745,630,1375,1814
3405-000,2017,4,28,22,492,499,991,1375
3405-000,2017,4,28,23,331,268,599,991
3405-000,2017,4,28,24,184,229,413,599
3405-000,2017,4,29,1,132,111,243,413
3405-000,2017,4,29,2,76,79,155,243
3405-000,2017,4,29,3,70,72,142,155
3405-000,2017,4,29,4,71,79,150,142
3405-000,2017,4,29,5,116,96,212,150
3405-000,2017,4,29,6,224,175,399,212
3405-000,2017,4,29,7,551,395,946,399
3405-000,2017,4,29,8,784,754,1538,946
3405-000,2017,4,29,9,1034,863,1897,1538
3405-000,2017,4,29,10,962,874,1836,1897
3405-000,2017,4,29,11,989,879,1868,1836
3405-000,2017,4,29,12,822,875,1697,1868
3405-000,2017,4,29,13,887,736,1623,1697
3405-000,2017,4,29,14,701,839,1540,1623
3405-000,2017,4,29,15,795,798,1593,1540
3405-000,2017,4,29,16,840,1169,2009,1593
3405-000,2017,4,29,17,1094,935,2029,2009
3405-000,2017,4,29,18,1104,878,1982,2029
3405-000,2017,4,29,19,918,707,1625,1982
3405-000,2017,4,29,20,572,549,1121,1625
3405-000,2017,4,29,21,436,379,815,1121
3405-000,2017,4,29,22,341,289,630,815
3405-000,2017,4,29,23,222,225,447,630
3405-000,2017,4,29,24,130,152,282,447
3405-000,2017,4,30,1,99,89,188,282
3405-000,2017,4,30,2,53,66,119,188
3405-000,2017,4,30,3,48,22,70,119
3405-000,2017,4,30,4,45,38,83,70
3405-000,2017,4,30,5,79,39,118,83
3405-000,2017,4,30,6,120,102,222,118
3405-000,2017,4,30,7,271,198,469,222
3405-000,2017,4,30,8,431,362,793,469
3405-000,2017,4,30,9,534,392,926,793
3405-000,2017,4,30,10,610,484,1094,926
3405-000,2017,4,30,11,616,561,1177,1094
3405-000,2017,4,30,12,610,518,1128,1177
3405-000,2017,4,30,13,557,535,1092,1128
3405-000,2017,4,30,14,662,552,1214,1092
3405-000,2017,4,30,15,656,599,1255,1214
3405-000,2017,4,30,16,719,634,1353,1255
3405-000,2017,4,30,17,652,595,1247,1353
3405-000,2017,4,30,18,759,675,1434,1247
3405-000,2017,4,30,19,659,669,1328,1434
3405-000,2017,4,30,20,546,542,1088,1328
3405-000,2017,4,30,21,442,441,883,1088
3405-000,2017,4,30,22,360,352,712,883
3405-000,2017,4,30,23,232,240,472,712
3405-000,2017,4,30,24,135,174,309,472
3405-000,2017,5,1,1,72,102,174,309
3405-000,2017,5,1,2,48,65,113,174
3405-000,2017,5,1,3,43,54,97,113
3405-000,2017,5,1,4,51,54,105,97
3405-000,2017,5,1,5,107,72,179,105
3405-000,2017,5,1,6,211,133,344,179
3405-000,2017,5,1,7,416,376,792,344
3405-000,2017,5,1,8,815,869,1684,792
3405-000,2017,5,1,9,1001,861,1862,1684
3405-000,2017,5,1,10,848,689,1537,1862
3405-000,2017,5,1,11,908,665,1573,1537
3405-000,2017,5,1,12,800,710,1510,1573
3405-000,2017,5,1,13,680,660,1340,1510
3405-000,2017,5,1,14,709,719,1428,1340
3405-000,2017,5,1,15,846,705,1551,1428
3405-000,2017,5,1,16,815,754,1569,1551
3405-000,2017,5,1,17,795,747,1542,1569
3405-000,2017,5,1,18,907,849,1756,1542
3405-000,2017,5,1,19,801,811,1612,1756
3405-000,2017,5,1,20,527,606,1133,1612
3405-000,2017,5,1,21,435,493,928,1133
3405-000,2017,5,1,22,279,402,681,928
3405-000,2017,5,1,23,194,263,457,681
3405-000,2017,5,1,24,134,173,307,457
3405-000,2017,5,2,1,68,96,164,307
3405-000,2017,5,2,2,48,77,125,164
3405-000,2017,5,2,3,44,54,98,125
3405-000,2017,5,2,4,68,62,130,98
3405-000,2017,5,2,5,133,92,225,130
3405-000,2017,5,2,6,290,275,565,225
3405-000,2017,5,2,7,632,627,1259,565
3405-000,2017,5,2,8,1139,1390,2529,1259
3405-000,2017,5,2,9,1350,1191,2541,2529
3405-000,2017,5,2,10,1088,891,1979,2541
3405-000,2017,5,2,11,1181,976,2157,1979
3405-000,2017,5,2,12,1039,968,2007,2157
3405-000,2017,5,2,13,857,881,1738,2007
3405-000,2017,5,2,14,995,1004,1999,1738
3405-000,2017,5,2,15,1174,985,2159,1999
3405-000,2017,5,2,16,1133,1045,2178,2159
3405-000,2017,5,2,17,1125,1028,2153,2178
3405-000,2017,5,2,18,1321,1132,2453,2153
3405-000,2017,5,2,19,1322,1088,2410,2453
3405-000,2017,5,2,20,932,819,1751,2410
3405-000,2017,5,2,21,648,622,1270,1751
3405-000,2017,5,2,22,427,427,854,1270
3405-000,2017,5,2,23,282,272,554,854
3405-000,2017,5,2,24,192,180,372,554
3405-000,2017,5,3,1,110,104,214,372
3405-000,2017,5,3,2,62,67,129,214
3405-000,2017,5,3,3,52,78,130,129
3405-000,2017,5,3,4,73,54,127,130
3405-000,2017,5,3,5,141,67,208,127
3405-000,2017,5,3,6,271,201,472,208
3405-000,2017,5,3,7,523,431,954,472
3405-000,2017,5,3,8,836,749,1585,954
3405-000,2017,5,3,9,1053,797,1850,1585
3405-000,2017,5,3,10,1009,830,1839,1850
3405-000,2017,5,3,11,1083,1057,2140,1839
3405-000,2017,5,3,12,995,928,1923,2140
3405-000,2017,5,3,13,775,802,1577,1923
3405-000,2017,5,3,14,753,803,1556,1577
3405-000,2017,5,3,15,870,852,1722,1556
3405-000,2017,5,3,16,836,801,1637,1722
3405-000,2017,5,3,17,770,823,1593,1637
3405-000,2017,5,3,18,960,885,1845,1593
3405-000,2017,5,3,19,790,702,1492,1845
3405-000,2017,5,3,20,579,542,1121,1492
3405-000,2017,5,3,21,424,452,876,1121
3405-000,2017,5,3,22,320,339,659,876
3405-000,2017,5,3,23,240,229,469,659
3405-000,2017,5,3,24,116,141,257,469
3405-000,2017,5,4,1,61,96,157,257
3405-000,2017,5,4,2,65,63,128,157
3405-000,2017,5,4,3,49,53,102,128
3405-000,2017,5,4,4,57,63,120,102
3405-000,2017,5,4,5,117,77,194,120
3405-000,2017,5,4,6,243,214,457,194
3405-000,2017,5,4,7,619,492,1111,457
3405-000,2017,5,4,8,981,1032,2013,1111
3405-000,2017,5,4,9,1117,953,2070,2013
3405-000,2017,5,4,10,982,824,1806,2070
3405-000,2017,5,4,11,1004,911,1915,1806
3405-000,2017,5,4,12,993,857,1850,1915
3405-000,2017,5,4,13,855,817,1672,1850
3405-000,2017,5,4,14,920,906,1826,1672
3405-000,2017,5,4,15,1031,905,1936,1826
3405-000,2017,5,4,16,1016,937,1953,1936
3405-000,2017,5,4,17,1013,899,1912,1953
3405-000,2017,5,4,18,1245,988,2233,1912
3405-000,2017,5,4,19,1259,949,2208,2233
3405-000,2017,5,4,20,972,652,1624,2208
3405-000,2017,5,4,21,639,600,1239,1624
3405-000,2017,5,4,22,419,455,874,1239
3405-000,2017,5,4,23,265,262,527,874
3405-000,2017,5,4,24,160,177,337,527
3405-000,2017,5,5,1,80,98,178,337
3405-000,2017,5,5,2,55,62,117,178
3405-000,2017,5,5,3,65,42,107,117
3405-000,2017,5,5,4,51,55,106,107
3405-000,2017,5,5,5,97,82,179,106
3405-000,2017,5,5,6,218,128,346,179
3405-000,2017,5,5,7,454,368,822,346
3405-000,2017,5,5,8,667,547,1214,822
3405-000,2017,5,5,9,756,645,1401,1214
3405-000,2017,5,5,10,895,679,1574,1401
3405-000,2017,5,5,11,912,1067,1979,1574
3405-000,2017,5,5,12,978,1171,2149,1979
3405-000,2017,5,5,13,756,975,1731,2149
3405-000,2017,5,5,14,694,775,1469,1731
3405-000,2017,5,5,15,784,673,1457,1469
3405-000,2017,5,5,16,778,677,1455,1457
3405-000,2017,5,5,17,772,696,1468,1455
3405-000,2017,5,5,18,882,743,1625,1468
3405-000,2017,5,5,19,764,603,1367,1625
3405-000,2017,5,5,20,491,521,1012,1367
3405-000,2017,5,5,21,439,410,849,1012
3405-000,2017,5,5,22,324,294,618,849
3405-000,2017,5,5,23,232,213,445,618
3405-000,2017,5,5,24,124,170,294,445
3405-000,2017,5,6,1,95,102,197,294
3405-000,2017,5,6,2,52,57,109,197
3405-000,2017,5,6,3,42,58,100,109
3405-000,2017,5,6,4,56,46,102,100
3405-000,2017,5,6,5,67,80,147,102
3405-000,2017,5,6,6,176,141,317,147
3405-000,2017,5,6,7,414,326,740,317
3405-000,2017,5,6,8,515,478,993,740
3405-000,2017,5,6,9,672,523,1195,993
3405-000,2017,5,6,10,667,602,1269,1195
3405-000,2017,5,6,11,799,679,1478,1269
3405-000,2017,5,6,12,765,723,1488,1478
3405-000,2017,5,6,13,686,640,1326,1488
3405-000,2017,5,6,14,702,665,1367,1326
3405-000,2017,5,6,15,747,636,1383,1367
3405-000,2017,5,6,16,789,672,1461,1383
3405-000,2017,5,6,17,862,703,1565,1461
3405-000,2017,5,6,18,967,706,1673,1565
3405-000,2017,5,6,19,784,599,1383,1673
3405-000,2017,5,6,20,563,598,1161,1383
3405-000,2017,5,6,21,444,551,995,1161
3405-000,2017,5,6,22,359,459,818,995
3405-000,2017,5,6,23,263,252,515,818
3405-000,2017,5,6,24,139,199,338,515
3405-000,2017,5,7,1,75,93,168,338
3405-000,2017,5,7,2,60,58,118,168
3405-000,2017,5,7,3,35,43,78,118
3405-000,2017,5,7,4,45,36,81,78
3405-000,2017,5,7,5,59,56,115,81
3405-000,2017,5,7,6,105,89,194,115
3405-000,2017,5,7,7,249,175,424,194
3405-000,2017,5,7,8,345,303,648,424
3405-000,2017,5,7,9,454,336,790,648
3405-000,2017,5,7,10,549,406,955,790
3405-000,2017,5,7,11,665,463,1128,955
3405-000,2017,5,7,12,652,570,1222,1128
3405-000,2017,5,7,13,652,550,1202,1222
3405-000,2017,5,7,14,641,537,1178,1202
3405-000,2017,5,7,15,766,625,1391,1178
3405-000,2017,5,7,16,765,715,1480,1391
3405-000,2017,5,7,17,785,722,1507,1480
3405-000,2017,5,7,18,727,691,1418,1507
3405-000,2017,5,7,19,711,645,1356,1418
3405-000,2017,5,7,20,529,603,1132,1356
3405-000,2017,5,7,21,480,535,1015,1132
3405-000,2017,5,7,22,425,433,858,1015
3405-000,2017,5,7,23,238,349,587,858
3405-000,2017,5,7,24,133,193,326,587
3405-000,2017,5,8,1,80,87,167,326
3405-000,2017,5,8,2,61,82,143,167
3405-000,2017,5,8,3,49,52,101,143
3405-000,2017,5,8,4,109,71,180,101
3405-000,2017,5,8,5,122,122,244,180
3405-000,2017,5,8,6,299,267,566,244
3405-000,2017,5,8,7,721,712,1433,566
3405-000,2017,5,8,8,1188,1492,2680,1433
3405-000,2017,5,8,9,1287,1284,2571,2680
3405-000,2017,5,8,10,988,892,1880,2571
3405-000,2017,5,8,11,1133,983,2116,1880
3405-000,2017,5,8,12,964,875,1839,2116
3405-000,2017,5,8,13,900,854,1754,1839
3405-000,2017,5,8,14,932,1020,1952,1754
3405-000,2017,5,8,15,1056,1065,2121,1952
3405-000,2017,5,8,16,1124,1001,2125,2121
3405-000,2017,5,8,17,1117,988,2105,2125
3405-000,2017,5,8,18,1280,1043,2323,2105
3405-000,2017,5,8,19,1244,1098,2342,2323
3405-000,2017,5,8,20,901,762,1663,2342
3405-000,2017,5,8,21,641,591,1232,1663
3405-000,2017,5,8,22,429,422,851,1232
3405-000,2017,5,8,23,244,248,492,851
3405-000,2017,5,8,24,153,168,321,492
3405-000,2017,5,9,1,89,94,183,321
3405-000,2017,5,9,2,59,76,135,183
3405-000,2017,5,9,3,54,59,113,135
3405-000,2017,5,9,4,57,70,127,113
3405-000,2017,5,9,5,88,78,166,127
3405-000,2017,5,9,6,213,195,408,166
3405-000,2017,5,9,7,478,370,848,408
3405-000,2017,5,9,8,826,732,1558,848
3405-000,2017,5,9,9,874,843,1717,1558
3405-000,2017,5,9,10,929,793,1722,1717
3405-000,2017,5,9,11,989,783,1772,1722
3405-000,2017,5,9,12,914,787,1701,1772
3405-000,2017,5,9,13,784,767,1551,1701
3405-000,2017,5,9,14,803,767,1570,1551
3405-000,2017,5,9,15,907,783,1690,1570
3405-000,2017,5,9,16,869,850,1719,1690
3405-000,2017,5,9,17,841,746,1587,1719
3405-000,2017,5,9,18,865,883,1748,1587
3405-000,2017,5,9,19,697,670,1367,1748
3405-000,2017,5,9,20,453,438,891,1367
3405-000,2017,5,9,21,392,411,803,891
3405-000,2017,5,9,22,275,336,611,803
3405-000,2017,5,9,23,176,199,375,611
3405-000,2017,5,9,24,93,152,245,375
3405-000,2017,5,10,1,71,81,152,245
3405-000,2017,5,10,2,64,62,126,152
3405-000,2017,5,10,3,42,50,92,126
3405-000,2017,5,10,4,59,64,123,92
3405-000,2017,5,10,5,112,92,204,123
3405-000,2017,5,10,6,245,217,462,204
3405-000,2017,5,10,7,596,571,1167,462
3405-000,2017,5,10,8,1128,1388,2516,1167
3405-000,2017,5,10,9,1261,1326,2587,2516
3405-000,2017,5,10,10,1116,949,2065,2587
3405-000,2017,5,10,11,1105,1074,2179,2065
3405-000,2017,5,10,12,1052,951,2003,2179
3405-000,2017,5,10,13,919,854,1773,2003
3405-000,2017,5,10,14,1035,958,1993,1773
3405-000,2017,5,10,15,1101,1084,2185,1993
3405-000,2017,5,10,16,1129,1010,2139,2185
3405-000,2017,5,10,17,1027,931,1958,2139
3405-000,2017,5,10,18,1249,1037,2286,1958
3405-000,2017,5,10,19,1112,1106,2218,2286
3405-000,2017,5,10,20,743,691,1434,2218
3405-000,2017,5,10,21,599,551,1150,1434
3405-000,2017,5,10,22,412,414,826,1150
3405-000,2017,5,10,23,260,252,512,826
3405-000,2017,5,10,24,142,169,311,512
3405-000,2017,5,11,1,93,97,190,311
3405-000,2017,5,11,2,62,65,127,190
3405-000,2017,5,11,3,69,63,132,127
3405-000,2017,5,11,4,61,68,129,132
3405-000,2017,5,11,5,131,99,230,129
3405-000,2017,5,11,6,248,247,495,230
3405-000,2017,5,11,7,599,505,1104,495
3405-000,2017,5,11,8,1124,1345,2469,1104
3405-000,2017,5,11,9,1369,1313,2682,2469
3405-000,2017,5,11,10,1100,972,2072,2682
3405-000,2017,5,11,11,1125,1029,2154,2072
3405-000,2017,5,11,12,1133,933,2066,2154
3405-000,2017,5,11,13,955,845,1800,2066
3405-000,2017,5,11,14,1033,962,1995,1800
3405-000,2017,5,11,15,1123,1037,2160,1995
3405-000,2017,5,11,16,1154,1013,2167,2160
3405-000,2017,5,11,17,1102,1010,2112,2167
3405-000,2017,5,11,18,1294,1045,2339,2112
3405-000,2017,5,11,19,1117,1043,2160,2339
3405-000,2017,5,11,20,790,714,1504,2160
3405-000,2017,5,11,21,667,687,1354,1504
3405-000,2017,5,11,22,429,465,894,1354
3405-000,2017,5,11,23,280,274,554,894
3405-000,2017,5,11,24,166,157,323,554
3405-000,2017,5,12,1,113,112,225,323
3405-000,2017,5,12,2,61,78,139,225
3405-000,2017,5,12,3,50,57,107,139
3405-000,2017,5,12,4,63,87,150,107
3405-000,2017,5,12,5,110,98,208,150
3405-000,2017,5,12,6,258,216,474,208
3405-000,2017,5,12,7,661,568,1229,474
3405-000,2017,5,12,8,1184,1391,2575,1229
3405-000,2017,5,12,9,1339,1249,2588,2575
3405-000,2017,5,12,10,1158,1053,2211,2588
3405-000,2017,5,12,11,1186,1022,2208,2211
3405-000,2017,5,12,12,1084,952,2036,2208
3405-000,2017,5,12,13,946,870,1816,2036
3405-000,2017,5,12,14,992,986,1978,1816
3405-000,2017,5,12,15,1202,1042,2244,1978
3405-000,2017,5,12,16,1137,1048,2185,2244
3405-000,2017,5,12,17,1188,1011,2199,2185
3405-000,2017,5,12,18,1363,1156,2519,2199
3405-000,2017,5,12,19,1431,1228,2659,2519
3405-000,2017,5,12,20,1034,791,1825,2659
3405-000,2017,5,12,21,699,626,1325,1825
3405-000,2017,5,12,22,461,477,938,1325
3405-000,2017,5,12,23,330,318,648,938
3405-000,2017,5,12,24,187,179,366,648
3405-000,2017,5,13,1,122,101,223,366
3405-000,2017,5,13,2,98,74,172,223
3405-000,2017,5,13,3,67,72,139,172
3405-000,2017,5,13,4,66,96,162,139
3405-000,2017,5,13,5,102,105,207,162
3405-000,2017,5,13,6,261,199,460,207
3405-000,2017,5,13,7,496,427,923,460
3405-000,2017,5,13,8,788,762,1550,923
3405-000,2017,5,13,9,944,860,1804,1550
3405-000,2017,5,13,10,899,809,1708,1804
3405-000,2017,5,13,11,925,823,1748,1708
3405-000,2017,5,13,12,877,736,1613,1748
3405-000,2017,5,13,13,781,684,1465,1613
3405-000,2017,5,13,14,762,713,1475,1465
3405-000,2017,5,13,15,842,790,1632,1475
3405-000,2017,5,13,16,923,796,1719,1632
3405-000,2017,5,13,17,1017,793,1810,1719
3405-000,2017,5,13,18,1068,900,1968,1810
3405-000,2017,5,13,19,803,636,1439,1968
3405-000,2017,5,13,20,486,409,895,1439
3405-000,2017,5,13,21,417,339,756,895
3405-000,2017,5,13,22,281,250,531,756
3405-000,2017,5,13,23,202,201,403,531
3405-000,2017,5,13,24,144,142,286,403
3405-000,2017,5,14,1,91,77,168,286
3405-000,2017,5,14,2,74,47,121,168
3405-000,2017,5,14,3,80,37,117,121
3405-000,2017,5,14,4,59,32,91,117
3405-000,2017,5,14,5,75,37,112,91
3405-000,2017,5,14,6,161,118,279,112
3405-000,2017,5,14,7,296,201,497,279
3405-000,2017,5,14,8,390,287,677,497
3405-000,2017,5,14,9,476,412,888,677
3405-000,2017,5,14,10,563,410,973,888
3405-000,2017,5,14,11,670,437,1107,973
3405-000,2017,5,14,12,524,503,1027,1107
3405-000,2017,5,14,13,530,518,1048,1027
3405-000,2017,5,14,14,597,613,1210,1048
3405-000,2017,5,14,15,619,539,1158,1210
3405-000,2017,5,14,16,651,640,1291,1158
3405-000,2017,5,14,17,667,646,1313,1291
3405-000,2017,5,14,18,688,642,1330,1313
3405-000,2017,5,14,19,597,624,1221,1330
3405-000,2017,5,14,20,441,530,971,1221
3405-000,2017,5,14,21,386,461,847,971
3405-000,2017,5,14,22,278,389,667,847
3405-000,2017,5,14,23,214,261,475,667
3405-000,2017,5,14,24,156,186,342,475
3405-000,2017,5,15,1,71,115,186,342
3405-000,2017,5,15,2,57,80,137,186
3405-000,2017,5,15,3,53,46,99,137
3405-000,2017,5,15,4,52,64,116,99
3405-000,2017,5,15,5,126,102,228,116
3405-000,2017,5,15,6,290,259,549,228
3405-000,2017,5,15,7,725,758,1483,549
3405-000,2017,5,15,8,1189,1650,2839,1483
3405-000,2017,5,15,9,1380,1329,2709,2839
3405-000,2017,5,15,10,1063,954,2017,2709
3405-000,2017,5,15,11,1121,954,2075,2017
3405-000,2017,5,15,12,1106,953,2059,2075
3405-000,2017,5,15,13,886,832,1718,2059
3405-000,2017,5,15,14,1032,999,2031,1718
3405-000,2017,5,15,15,1139,1075,2214,2031
3405-000,2017,5,15,16,1220,1004,2224,2214
3405-000,2017,5,15,17,1070,1012,2082,2224
3405-000,2017,5,15,18,1199,1024,2223,2082
3405-000,2017,5,15,19,1072,1053,2125,2223
3405-000,2017,5,15,20,774,724,1498,2125
3405-000,2017,5,15,21,669,652,1321,1498
3405-000,2017,5,15,22,440,447,887,1321
3405-000,2017,5,15,23,230,268,498,887
3405-000,2017,5,15,24,152,160,312,498
3405-000,2017,5,16,1,87,96,183,312
3405-000,2017,5,16,2,56,64,120,183
3405-000,2017,5,16,3,42,69,111,120
3405-000,2017,5,16,4,64,75,139,111
3405-000,2017,5,16,5,130,102,232,139
3405-000,2017,5,16,6,286,251,537,232
3405-000,2017,5,16,7,659,570,1229,537
3405-000,2017,5,16,8,1127,1418,2545,1229
3405-000,2017,5,16,9,1291,1311,2602,2545
3405-000,2017,5,16,10,1135,1039,2174,2602
3405-000,2017,5,16,11,1093,983,2076,2174
3405-000,2017,5,16,12,1144,992,2136,2076
3405-000,2017,5,16,13,870,806,1676,2136
3405-000,2017,5,16,14,1001,940,1941,1676
3405-000,2017,5,16,15,1129,1006,2135,1941
3405-000,2017,5,16,16,1126,1010,2136,2135
3405-000,2017,5,16,17,1071,1014,2085,2136
3405-000,2017,5,16,18,1184,1032,2216,2085
3405-000,2017,5,16,19,1133,1047,2180,2216
3405-000,2017,5,16,20,746,735,1481,2180
3405-000,2017,5,16,21,638,627,1265,1481
3405-000,2017,5,16,22,447,454,901,1265
3405-000,2017,5,16,23,284,255,539,901
3405-000,2017,5,16,24,159,177,336,539
3405-000,2017,5,17,1,103,102,205,336
3405-000,2017,5,17,2,59,78,137,205
3405-000,2017,5,17,3,48,59,107,137
3405-000,2017,5,17,4,59,67,126,107
3405-000,2017,5,17,5,117,88,205,126
3405-000,2017,5,17,6,239,269,508,205
3405-000,2017,5,17,7,611,565,1176,508
3405-000,2017,5,17,8,1113,1406,2519,1176
3405-000,2017,5,17,9,1301,1254,2555,2519
3405-000,2017,5,17,10,1098,1017,2115,2555
3405-000,2017,5,17,11,1112,1065,2177,2115
3405-000,2017,5,17,12,1026,968,1994,2177
3405-000,2017,5,17,13,863,847,1710,1994
3405-000,2017,5,17,14,1045,1002,2047,1710
3405-000,2017,5,17,15,1143,1050,2193,2047
3405-000,2017,5,17,16,1128,971,2099,2193
3405-000,2017,5,17,17,1119,971,2090,2099
3405-000,2017,5,17,18,1383,1091,2474,2090
3405-000,2017,5,17,19,1234,1094,2328,2474
3405-000,2017,5,17,20,760,674,1434,2328
3405-000,2017,5,17,21,597,553,1150,1434
3405-000,2017,5,17,22,385,386,771,1150
3405-000,2017,5,17,23,279,233,512,771
3405-000,2017,5,17,24,163,185,348,512
3405-000,2017,5,18,1,95,95,190,348
3405-000,2017,5,18,2,70,86,156,190
3405-000,2017,5,18,3,52,63,115,156
3405-000,2017,5,18,4,61,65,126,115
3405-000,2017,5,18,5,113,100,213,126
3405-000,2017,5,18,6,256,226,482,213
3405-000,2017,5,18,7,625,562,1187,482
3405-000,2017,5,18,8,1227,1374,2601,1187
3405-000,2017,5,18,9,1357,1271,2628,2601
3405-000,2017,5,18,10,1120,1003,2123,2628
3405-000,2017,5,18,11,1188,1002,2190,2123
3405-000,2017,5,18,12,1069,961,2030,2190
3405-000,2017,5,18,13,885,842,1727,2030
3405-000,2017,5,18,14,1026,966,1992,1727
3405-000,2017,5,18,15,1170,1101,2271,1992
3405-000,2017,5,18,16,1095,1044,2139,2271
3405-000,2017,5,18,17,1169,1012,2181,2139
3405-000,2017,5,18,18,1252,1047,2299,2181
3405-000,2017,5,18,19,1120,1028,2148,2299
3405-000,2017,5,18,20,731,707,1438,2148
3405-000,2017,5,18,21,660,594,1254,1438
3405-000,2017,5,18,22,429,453,882,1254
3405-000,2017,5,18,23,313,213,526,882
3405-000,2017,5,18,24,163,170,333,526
3405-000,2017,5,19,1,94,98,192,333
3405-000,2017,5,19,2,73,72,145,192
3405-000,2017,5,19,3,58,61,119,145
3405-000,2017,5,19,4,69,66,135,119
3405-000,2017,5,19,5,112,107,219,135
3405-000,2017,5,19,6,274,220,494,219
3405-000,2017,5,19,7,620,558,1178,494
3405-000,2017,5,19,8,1199,1376,2575,1178
3405-000,2017,5,19,9,1392,1282,2674,2575
3405-000,2017,5,19,10,1126,971,2097,2674
3405-000,2017,5,19,11,1183,982,2165,2097
3405-000,2017,5,19,12,1082,881,1963,2165
3405-000,2017,5,19,13,948,782,1730,1963
3405-000,2017,5,19,14,1070,926,1996,1730
3405-000,2017,5,19,15,1166,953,2119,1996
3405-000,2017,5,19,16,1165,1039,2204,2119
3405-000,2017,5,19,17,1204,921,2125,2204
3405-000,2017,5,19,18,1490,1043,2533,2125
3405-000,2017,5,19,19,1498,1138,2636,2533
3405-000,2017,5,19,20,981,830,1811,2636
3405-000,2017,5,19,21,728,696,1424,1811
3405-000,2017,5,19,22,506,488,994,1424
3405-000,2017,5,19,23,334,274,608,994
3405-000,2017,5,19,24,193,189,382,608
3405-000,2017,5,20,1,119,125,244,382
3405-000,2017,5,20,2,64,76,140,244
3405-000,2017,5,20,3,67,70,137,140
3405-000,2017,5,20,4,68,88,156,137
3405-000,2017,5,20,5,143,98,241,156
3405-000,2017,5,20,6,239,196,435,241
3405-000,2017,5,20,7,509,458,967,435
3405-000,2017,5,20,8,749,715,1464,967
3405-000,2017,5,20,9,963,847,1810,1464
3405-000,2017,5,20,10,957,781,1738,1810
3405-000,2017,5,20,11,847,791,1638,1738
3405-000,2017,5,20,12,897,707,1604,1638
3405-000,2017,5,20,13,722,700,1422,1604
3405-000,2017,5,20,14,792,701,1493,1422
3405-000,2017,5,20,15,849,706,1555,1493
3405-000,2017,5,20,16,889,731,1620,1555
3405-000,2017,5,20,17,901,731,1632,1620
3405-000,2017,5,20,18,1087,859,1946,1632
3405-000,2017,5,20,19,795,657,1452,1946
3405-000,2017,5,20,20,543,572,1115,1452
3405-000,2017,5,20,21,404,380,784,1115
3405-000,2017,5,20,22,303,304,607,784
3405-000,2017,5,20,23,226,260,486,607
3405-000,2017,5,20,24,154,157,311,486
3405-000,2017,5,21,1,102,102,204,311
3405-000,2017,5,21,2,67,66,133,204
3405-000,2017,5,21,3,49,53,102,133
3405-000,2017,5,21,4,34,36,70,102
3405-000,2017,5,21,5,60,43,103,70
3405-000,2017,5,21,6,167,94,261,103
3405-000,2017,5,21,7,267,195,462,261
3405-000,2017,5,21,8,408,377,785,462
3405-000,2017,5,21,9,528,379,907,785
3405-000,2017,5,21,10,507,421,928,907
3405-000,2017,5,21,11,603,444,1047,928
3405-000,2017,5,21,12,567,546,1113,1047
3405-000,2017,5,21,13,541,503,1044,1113
3405-000,2017,5,21,14,547,529,1076,1044
3405-000,2017,5,21,15,625,638,1263,1076
3405-000,2017,5,21,16,643,626,1269,1263
3405-000,2017,5,21,17,713,644,1357,1269
3405-000,2017,5,21,18,739,751,1490,1357
3405-000,2017,5,21,19,606,579,1185,1490
3405-000,2017,5,21,20,483,541,1024,1185
3405-000,2017,5,21,21,423,521,944,1024
3405-000,2017,5,21,22,337,367,704,944
3405-000,2017,5,21,23,218,302,520,704
3405-000,2017,5,21,24,156,200,356,520
3405-000,2017,5,22,1,78,113,191,356
3405-000,2017,5,22,2,52,63,115,191
3405-000,2017,5,22,3,38,53,91,115
3405-000,2017,5,22,4,56,76,132,91
3405-000,2017,5,22,5,132,119,251,132
3405-000,2017,5,22,6,301,281,582,251
3405-000,2017,5,22,7,760,725,1485,582
3405-000,2017,5,22,8,1209,1618,2827,1485
3405-000,2017,5,22,9,1344,1374,2718,2827
3405-000,2017,5,22,10,1049,916,1965,2718
3405-000,2017,5,22,11,1091,962,2053,1965
3405-000,2017,5,22,12,1040,916,1956,2053
3405-000,2017,5,22,13,891,864,1755,1956
3405-000,2017,5,22,14,960,961,1921,1755
3405-000,2017,5,22,15,1097,989,2086,1921
3405-000,2017,5,22,16,1072,1037,2109,2086
3405-000,2017,5,22,17,1094,995,2089,2109
3405-000,2017,5,22,18,1166,1001,2167,2089
3405-000,2017,5,22,19,1122,1056,2178,2167
3405-000,2017,5,22,20,768,703,1471,2178
3405-000,2017,5,22,21,662,590,1252,1471
3405-000,2017,5,22,22,407,480,887,1252
3405-000,2017,5,22,23,285,233,518,887
3405-000,2017,5,22,24,153,173,326,518
3405-000,2017,5,23,1,101,100,201,326
3405-000,2017,5,23,2,62,90,152,201
3405-000,2017,5,23,3,44,55,99,152
3405-000,2017,5,23,4,61,78,139,99
3405-000,2017,5,23,5,133,96,229,139
3405-000,2017,5,23,6,251,222,473,229
3405-000,2017,5,23,7,637,568,1205,473
3405-000,2017,5,23,8,1168,1361,2529,1205
3405-000,2017,5,23,9,1322,1248,2570,2529
3405-000,2017,5,23,10,1132,997,2129,2570
3405-000,2017,5,23,11,1128,983,2111,2129
3405-000,2017,5,23,12,1033,896,1929,2111
3405-000,2017,5,23,13,858,832,1690,1929
3405-000,2017,5,23,14,1065,1024,2089,1690
3405-000,2017,5,23,15,1069,1029,2098,2089
3405-000,2017,5,23,16,1056,987,2043,2098
3405-000,2017,5,23,17,1063,953,2016,2043
3405-000,2017,5,23,18,1216,961,2177,2016
3405-000,2017,5,23,19,1112,1031,2143,2177
3405-000,2017,5,23,20,727,634,1361,2143
3405-000,2017,5,23,21,582,612,1194,1361
3405-000,2017,5,23,22,423,446,869,1194
3405-000,2017,5,23,23,267,238,505,869
3405-000,2017,5,23,24,157,167,324,505
3405-000,2017,5,24,1,88,98,186,324
3405-000,2017,5,24,2,56,83,139,186
3405-000,2017,5,24,3,51,50,101,139
3405-000,2017,5,24,4,46,61,107,101
3405-000,2017,5,24,5,121,93,214,107
3405-000,2017,5,24,6,225,212,437,214
3405-000,2017,5,24,7,609,506,1115,437
3405-000,2017,5,24,8,1148,1322,2470,1115
3405-000,2017,5,24,9,1353,1323,2676,2470
3405-000,2017,5,24,10,1063,961,2024,2676
3405-000,2017,5,24,11,1081,1032,2113,2024
3405-000,2017,5,24,12,1019,913,1932,2113
3405-000,2017,5,24,13,934,808,1742,1932
3405-000,2017,5,24,14,944,928,1872,1742
3405-000,2017,5,24,15,1084,952,2036,1872
3405-000,2017,5,24,16,1213,1027,2240,2036
3405-000,2017,5,24,17,1126,952,2078,2240
3405-000,2017,5,24,18,1283,1052,2335,2078
3405-000,2017,5,24,19,1183,1109,2292,2335
3405-000,2017,5,24,20,719,645,1364,2292
3405-000,2017,5,24,21,574,564,1138,1364
3405-000,2017,5,24,22,390,405,795,1138
3405-000,2017,5,24,23,257,237,494,795
3405-000,2017,5,24,24,149,154,303,494
3405-000,2017,5,25,1,98,89,187,303
3405-000,2017,5,25,2,57,71,128,187
3405-000,2017,5,25,3,53,54,107,128
3405-000,2017,5,25,4,68,59,127,107
3405-000,2017,5,25,5,129,94,223,127
3405-000,2017,5,25,6,291,254,545,223
3405-000,2017,5,25,7,695,609,1304,545
3405-000,2017,5,25,8,1135,1327,2462,1304
3405-000,2017,5,25,9,1370,1333,2703,2462
3405-000,2017,5,25,10,1132,986,2118,2703
3405-000,2017,5,25,11,1116,979,2095,2118
3405-000,2017,5,25,12,1132,944,2076,2095
3405-000,2017,5,25,13,843,849,1692,2076
3405-000,2017,5,25,14,1045,981,2026,1692
3405-000,2017,5,25,15,1048,999,2047,2026
3405-000,2017,5,25,16,1085,1017,2102,2047
3405-000,2017,5,25,17,1096,999,2095,2102
3405-000,2017,5,25,18,1250,1007,2257,2095
3405-000,2017,5,25,19,1127,1013,2140,2257
3405-000,2017,5,25,20,775,632,1407,2140
3405-000,2017,5,25,21,592,656,1248,1407
3405-000,2017,5,25,22,443,437,880,1248
3405-000,2017,5,25,23,270,227,497,880
3405-000,2017,5,25,24,180,158,338,497
3405-000,2017,5,26,1,107,120,227,338
3405-000,2017,5,26,2,58,75,133,227
3405-000,2017,5,26,3,54,60,114,133
3405-000,2017,5,26,4,73,78,151,114
3405-000,2017,5,26,5,128,111,239,151
3405-000,2017,5,26,6,270,217,487,239
3405-000,2017,5,26,7,633,551,1184,487
3405-000,2017,5,26,8,1160,1339,2499,1184
3405-000,2017,5,26,9,1377,1321,2698,2499
3405-000,2017,5,26,10,1164,951,2115,2698
3405-000,2017,5,26,11,1105,1022,2127,2115
3405-000,2017,5,26,12,1131,938,2069,2127
3405-000,2017,5,26,13,992,838,1830,2069
3405-000,2017,5,26,14,1046,946,1992,1830
3405-000,2017,5,26,15,1097,1010,2107,1992
3405-000,2017,5,26,16,1266,1036,2302,2107
3405-000,2017,5,26,17,1162,1076,2238,2302
3405-000,2017,5,26,18,1420,1084,2504,2238
3405-000,2017,5,26,19,1510,1192,2702,2504
3405-000,2017,5,26,20,998,815,1813,2702
3405-000,2017,5,26,21,810,633,1443,1813
3405-000,2017,5,26,22,499,419,918,1443
3405-000,2017,5,26,23,315,264,579,918
3405-000,2017,5,26,24,188,203,391,579
3405-000,2017,5,27,1,136,102,238,391
3405-000,2017,5,27,2,100,77,177,238
3405-000,2017,5,27,3,60,55,115,177
3405-000,2017,5,27,4,46,92,138,115
3405-000,2017,5,27,5,115,106,221,138
3405-000,2017,5,27,6,295,208,503,221
3405-000,2017,5,27,7,557,414,971,503
3405-000,2017,5,27,8,840,678,1518,971
3405-000,2017,5,27,9,947,896,1843,1518
3405-000,2017,5,27,10,915,787,1702,1843
3405-000,2017,5,27,11,976,912,1888,1702
3405-000,2017,5,27,12,862,823,1685,1888
3405-000,2017,5,27,13,852,781,1633,1685
3405-000,2017,5,27,14,824,763,1587,1633
3405-000,2017,5,27,15,848,781,1629,1587
3405-000,2017,5,27,16,923,763,1686,1629
3405-000,2017,5,27,17,913,764,1677,1686
3405-000,2017,5,27,18,1105,990,2095,1677
3405-000,2017,5,27,19,961,765,1726,2095
3405-000,2017,5,27,20,603,518,1121,1726
3405-000,2017,5,27,21,436,349,785,1121
3405-000,2017,5,27,22,324,309,633,785
3405-000,2017,5,27,23,269,263,532,633
3405-000,2017,5,27,24,135,185,320,532
3405-000,2017,5,28,1,117,113,230,320
3405-000,2017,5,28,2,86,58,144,230
3405-000,2017,5,28,3,59,36,95,144
3405-000,2017,5,28,4,52,31,83,95
3405-000,2017,5,28,5,65,48,113,83
3405-000,2017,5,28,6,158,114,272,113
3405-000,2017,5,28,7,262,203,465,272
3405-000,2017,5,28,8,405,321,726,465
3405-000,2017,5,28,9,497,409,906,726
3405-000,2017,5,28,10,533,438,971,906
3405-000,2017,5,28,11,576,528,1104,971
3405-000,2017,5,28,12,594,492,1086,1104
3405-000,2017,5,28,13,559,504,1063,1086
3405-000,2017,5,28,14,560,561,1121,1063
3405-000,2017,5,28,15,656,601,1257,1121
3405-000,2017,5,28,16,734,670,1404,1257
3405-000,2017,5,28,17,724,640,1364,1404
3405-000,2017,5,28,18,701,629,1330,1364
3405-000,2017,5,28,19,643,631,1274,1330
3405-000,2017,5,28,20,485,585,1070,1274
3405-000,2017,5,28,21,380,522,902,1070
3405-000,2017,5,28,22,320,419,739,902
3405-000,2017,5,28,23,221,306,527,739
3405-000,2017,5,28,24,127,209,336,527
3405-000,2017,5,29,1,74,112,186,336
3405-000,2017,5,29,2,36,64,100,186
3405-000,2017,5,29,3,49,54,103,100
3405-000,2017,5,29,4,53,62,115,103
3405-000,2017,5,29,5,113,91,204,115
3405-000,2017,5,29,6,305,303,608,204
3405-000,2017,5,29,7,682,740,1422,608
3405-000,2017,5,29,8,1265,1641,2906,1422
3405-000,2017,5,29,9,1300,1293,2593,2906
3405-000,2017,5,29,10,1098,888,1986,2593
3405-000,2017,5,29,11,1083,1021,2104,1986
3405-000,2017,5,29,12,1066,972,2038,2104
3405-000,2017,5,29,13,914,833,1747,2038
3405-000,2017,5,29,14,1020,976,1996,1747
3405-000,2017,5,29,15,1140,1047,2187,1996
3405-000,2017,5,29,16,1164,955,2119,2187
3405-000,2017,5,29,17,1065,1009,2074,2119
3405-000,2017,5,29,18,1202,1092,2294,2074
3405-000,2017,5,29,19,1173,1032,2205,2294
3405-000,2017,5,29,20,736,728,1464,2205
3405-000,2017,5,29,21,603,616,1219,1464
3405-000,2017,5,29,22,433,459,892,1219
3405-000,2017,5,29,23,263,261,524,892
3405-000,2017,5,29,24,153,205,358,524
3405-000,2017,5,30,1,111,91,202,358
3405-000,2017,5,30,2,67,69,136,202
3405-000,2017,5,30,3,48,60,108,136
3405-000,2017,5,30,4,68,75,143,108
3405-000,2017,5,30,5,122,121,243,143
3405-000,2017,5,30,6,260,222,482,243
3405-000,2017,5,30,7,640,570,1210,482
3405-000,2017,5,30,8,1176,1379,2555,1210
3405-000,2017,5,30,9,1351,1328,2679,2555
3405-000,2017,5,30,10,1088,1030,2118,2679
3405-000,2017,5,30,11,1174,1021,2195,2118
3405-000,2017,5,30,12,1105,965,2070,2195
3405-000,2017,5,30,13,989,867,1856,2070
3405-000,2017,5,30,14,1031,1078,2109,1856
3405-000,2017,5,30,15,1105,1025,2130,2109
3405-000,2017,5,30,16,1176,1039,2215,2130
3405-000,2017,5,30,17,1175,967,2142,2215
3405-000,2017,5,30,18,1208,996,2204,2142
3405-000,2017,5,30,19,1164,1097,2261,2204
3405-000,2017,5,30,20,760,754,1514,2261
3405-000,2017,5,30,21,580,600,1180,1514
3405-000,2017,5,30,22,394,398,792,1180
3405-000,2017,5,30,23,381,278,659,792
3405-000,2017,5,30,24,169,180,349,659
3405-000,2017,5,31,1,90,106,196,349
3405-000,2017,5,31,2,58,65,123,196
3405-000,2017,5,31,3,48,55,103,123
3405-000,2017,5,31,4,45,66,111,103
3405-000,2017,5,31,5,119,111,230,111
3405-000,2017,5,31,6,291,218,509,230
3405-000,2017,5,31,7,592,545,1137,509
3405-000,2017,5,31,8,1089,1343,2432,1137
3405-000,2017,5,31,9,1326,1315,2641,2432
3405-000,2017,5,31,10,996,945,1941,2641
3405-000,2017,5,31,11,1078,1014,2092,1941
3405-000,2017,5,31,12,972,908,1880,2092
3405-000,2017,5,31,13,887,824,1711,1880
3405-000,2017,5,31,14,985,866,1851,1711
3405-000,2017,5,31,15,1116,1040,2156,1851
3405-000,2017,5,31,16,1059,987,2046,2156
3405-000,2017,5,31,17,1033,927,1960,2046
3405-000,2017,5,31,18,1139,1011,2150,1960
3405-000,2017,5,31,19,1045,1099,2144,2150
3405-000,2017,5,31,20,697,662,1359,2144
3405-000,2017,5,31,21,556,537,1093,1359
3405-000,2017,5,31,22,377,393,770,1093
3405-000,2017,5,31,23,257,241,498,770
3405-000,2017,5,31,24,154,166,320,498
3405-000,2017,6,1,1,106,115,221,320
3405-000,2017,6,1,2,53,68,121,221
3405-000,2017,6,1,3,62,61,123,121
3405-000,2017,6,1,4,59,74,133,123
3405-000,2017,6,1,5,120,94,214,133
3405-000,2017,6,1,6,275,246,521,214
3405-000,2017,6,1,7,603,521,1124,521
3405-000,2017,6,1,8,1155,1370,2525,1124
3405-000,2017,6,1,9,1385,1235,2620,2525
3405-000,2017,6,1,10,1188,871,2059,2620
3405-000,2017,6,1,11,1083,992,2075,2059
3405-000,2017,6,1,12,1037,907,1944,2075
3405-000,2017,6,1,13,851,818,1669,1944
3405-000,2017,6,1,14,1003,965,1968,1669
3405-000,2017,6,1,15,1087,1048,2135,1968
3405-000,2017,6,1,16,1072,975,2047,2135
3405-000,2017,6,1,17,1122,923,2045,2047
3405-000,2017,6,1,18,1219,1047,2266,2045
3405-000,2017,6,1,19,1165,1030,2195,2266
3405-000,2017,6,1,20,789,661,1450,2195
3405-000,2017,6,1,21,618,615,1233,1450
3405-000,2017,6,1,22,414,422,836,1233
3405-000,2017,6,1,23,268,257,525,836
3405-000,2017,6,1,24,139,182,321,525
3405-000,2017,6,2,1,109,101,210,321
3405-000,2017,6,2,2,59,67,126,210
3405-000,2017,6,2,3,60,64,124,126
3405-000,2017,6,2,4,54,74,128,124
3405-000,2017,6,2,5,114,100,214,128
3405-000,2017,6,2,6,297,223,520,214
3405-000,2017,6,2,7,648,556,1204,520
3405-000,2017,6,2,8,1182,1164,2346,1204
3405-000,2017,6,2,9,1412,1347,2759,2346
3405-000,2017,6,2,10,1124,1003,2127,2759
3405-000,2017,6,2,11,1129,1033,2162,2127
3405-000,2017,6,2,12,1079,901,1980,2162
3405-000,2017,6,2,13,902,858,1760,1980
3405-000,2017,6,2,14,1050,983,2033,1760
3405-000,2017,6,2,15,1095,1025,2120,2033
3405-000,2017,6,2,16,1204,991,2195,2120
3405-000,2017,6,2,17,1203,964,2167,2195
3405-000,2017,6,2,18,1543,1169,2712,2167
3405-000,2017,6,2,19,1588,1180,2768,2712
3405-000,2017,6,2,20,1021,889,1910,2768
3405-000,2017,6,2,21,733,638,1371,1910
3405-000,2017,6,2,22,510,464,974,1371
3405-000,2017,6,2,23,306,279,585,974
3405-000,2017,6,2,24,191,201,392,585
3405-000,2017,6,3,1,143,115,258,392
3405-000,2017,6,3,2,86,71,157,258
3405-000,2017,6,3,3,62,65,127,157
3405-000,2017,6,3,4,59,73,132,127
3405-000,2017,6,3,5,100,92,192,132
3405-000,2017,6,3,6,259,211,470,192
3405-000,2017,6,3,7,535,402,937,470
3405-000,2017,6,3,8,752,656,1408,937
3405-000,2017,6,3,9,927,852,1779,1408
3405-000,2017,6,3,10,933,865,1798,1779
3405-000,2017,6,3,11,1028,899,1927,1798
3405-000,2017,6,3,12,935,724,1659,1927
3405-000,2017,6,3,13,862,755,1617,1659
3405-000,2017,6,3,14,837,765,1602,1617
3405-000,2017,6,3,15,860,841,1701,1602
3405-000,2017,6,3,16,884,730,1614,1701
3405-000,2017,6,3,17,929,747,1676,1614
3405-000,2017,6,3,18,1072,910,1982,1676
3405-000,2017,6,3,19,833,710,1543,1982
3405-000,2017,6,3,20,541,518,1059,1543
3405-000,2017,6,3,21,412,380,792,1059
3405-000,2017,6,3,22,327,331,658,792
3405-000,2017,6,3,23,253,226,479,658
3405-000,2017,6,3,24,157,173,330,479
3405-000,2017,6,4,1,84,88,172,330
3405-000,2017,6,4,2,74,53,127,172
3405-000,2017,6,4,3,44,33,77,127
3405-000,2017,6,4,4,52,60,112,77
3405-000,2017,6,4,5,60,50,110,112
3405-000,2017,6,4,6,161,118,279,110
3405-000,2017,6,4,7,278,219,497,279
3405-000,2017,6,4,8,404,328,732,497
3405-000,2017,6,4,9,487,359,846,732
3405-000,2017,6,4,10,572,407,979,846
3405-000,2017,6,4,11,526,464,990,979
3405-000,2017,6,4,12,525,503,1028,990
3405-000,2017,6,4,13,571,542,1113,1028
3405-000,2017,6,4,14,555,569,1124,1113
3405-000,2017,6,4,15,616,575,1191,1124
3405-000,2017,6,4,16,684,633,1317,1191
3405-000,2017,6,4,17,697,605,1302,1317
3405-000,2017,6,4,18,719,702,1421,1302
3405-000,2017,6,4,19,631,611,1242,1421
3405-000,2017,6,4,20,454,542,996,1242
3405-000,2017,6,4,21,423,506,929,996
3405-000,2017,6,4,22,374,383,757,929
3405-000,2017,6,4,23,219,281,500,757
3405-000,2017,6,4,24,144,219,363,500
3405-000,2017,6,5,1,104,107,211,363
3405-000,2017,6,5,2,47,90,137,211
3405-000,2017,6,5,3,35,61,96,137
3405-000,2017,6,5,4,55,51,106,96
3405-000,2017,6,5,5,133,108,241,106
3405-000,2017,6,5,6,320,312,632,241
3405-000,2017,6,5,7,689,720,1409,632
3405-000,2017,6,5,8,1173,1458,2631,1409
3405-000,2017,6,5,9,1257,1212,2469,2631
3405-000,2017,6,5,10,1122,910,2032,2469
3405-000,2017,6,5,11,1060,938,1998,2032
3405-000,2017,6,5,12,1080,911,1991,1998
3405-000,2017,6,5,13,861,821,1682,1991
3405-000,2017,6,5,14,979,951,1930,1682
3405-000,2017,6,5,15,1146,1005,2151,1930
3405-000,2017,6,5,16,1113,968,2081,2151
3405-000,2017,6,5,17,1078,996,2074,2081
3405-000,2017,6,5,18,1192,1036,2228,2074
3405-000,2017,6,5,19,1172,1050,2222,2228
3405-000,2017,6,5,20,855,792,1647,2222
3405-000,2017,6,5,21,600,597,1197,1647
3405-000,2017,6,5,22,435,462,897,1197
3405-000,2017,6,5,23,319,255,574,897
3405-000,2017,6,5,24,175,202,377,574
3405-000,2017,6,6,1,93,117,210,377
3405-000,2017,6,6,2,57,67,124,210
3405-000,2017,6,6,3,49,69,118,124
3405-000,2017,6,6,4,56,65,121,118
3405-000,2017,6,6,5,110,87,197,121
3405-000,2017,6,6,6,243,222,465,197
3405-000,2017,6,6,7,480,398,878,465
3405-000,2017,6,6,8,807,697,1504,878
3405-000,2017,6,6,9,842,646,1488,1504
3405-000,2017,6,6,10,762,644,1406,1488
3405-000,2017,6,6,11,788,729,1517,1406
3405-000,2017,6,6,12,770,704,1474,1517
3405-000,2017,6,6,13,722,658,1380,1474
3405-000,2017,6,6,14,712,650,1362,1380
3405-000,2017,6,6,15,782,691,1473,1362
3405-000,2017,6,6,16,754,763,1517,1473
3405-000,2017,6,6,17,803,747,1550,1517
3405-000,2017,6,6,18,915,829,1744,1550
3405-000,2017,6,6,19,655,636,1291,1744
3405-000,2017,6,6,20,462,486,948,1291
3405-000,2017,6,6,21,374,408,782,948
3405-000,2017,6,6,22,266,340,606,782
3405-000,2017,6,6,23,179,223,402,606
3405-000,2017,6,6,24,116,133,249,402
3405-000,2017,6,7,1,78,83,161,249
3405-000,2017,6,7,2,56,47,103,161
3405-000,2017,6,7,3,35,46,81,103
3405-000,2017,6,7,4,57,50,107,81
3405-000,2017,6,7,5,93,85,178,107
3405-000,2017,6,7,6,225,215,440,178
3405-000,2017,6,7,7,574,548,1122,440
3405-000,2017,6,7,8,1122,1388,2510,1122
3405-000,2017,6,7,9,1342,1412,2754,2510
3405-000,2017,6,7,10,1044,897,1941,2754
3405-000,2017,6,7,11,1103,964,2067,1941
3405-000,2017,6,7,12,1036,850,1886,2067
3405-000,2017,6,7,13,904,832,1736,1886
3405-000,2017,6,7,14,955,982,1937,1736
3405-000,2017,6,7,15,1155,1063,2218,1937
3405-000,2017,6,7,16,1161,1002,2163,2218
3405-000,2017,6,7,17,1060,932,1992,2163
3405-000,2017,6,7,18,1167,934,2101,1992
3405-000,2017,6,7,19,1031,972,2003,2101
3405-000,2017,6,7,20,664,630,1294,2003
3405-000,2017,6,7,21,537,493,1030,1294
3405-000,2017,6,7,22,353,403,756,1030
3405-000,2017,6,7,23,245,215,460,756
3405-000,2017,6,7,24,142,160,302,460
3405-000,2017,6,8,1,91,106,197,302
3405-000,2017,6,8,2,56,57,113,197
3405-000,2017,6,8,3,43,48,91,113
3405-000,2017,6,8,4,72,79,151,91
3405-000,2017,6,8,5,125,119,244,151
3405-000,2017,6,8,6,280,246,526,244
3405-000,2017,6,8,7,608,550,1158,526
3405-000,2017,6,8,8,1171,1343,2514,1158
3405-000,2017,6,8,9,1360,1310,2670,2514
3405-000,2017,6,8,10,1107,996,2103,2670
3405-000,2017,6,8,11,1160,975,2135,2103
3405-000,2017,6,8,12,1120,917,2037,2135
3405-000,2017,6,8,13,911,836,1747,2037
3405-000,2017,6,8,14,1034,1005,2039,1747
3405-000,2017,6,8,15,1114,1041,2155,2039
3405-000,2017,6,8,16,1120,996,2116,2155
3405-000,2017,6,8,17,1094,1008,2102,2116
3405-000,2017,6,8,18,1183,1017,2200,2102
3405-000,2017,6,8,19,1130,1029,2159,2200
3405-000,2017,6,8,20,770,689,1459,2159
3405-000,2017,6,8,21,602,631,1233,1459
3405-000,2017,6,8,22,461,455,916,1233
3405-000,2017,6,8,23,270,251,521,916
3405-000,2017,6,8,24,160,176,336,521
3405-000,2017,6,9,1,97,106,203,336
3405-000,2017,6,9,2,70,87,157,203
3405-000,2017,6,9,3,44,60,104,157
3405-000,2017,6,9,4,61,63,124,104
3405-000,2017,6,9,5,109,100,209,124
3405-000,2017,6,9,6,299,247,546,209
3405-000,2017,6,9,7,619,588,1207,546
3405-000,2017,6,9,8,1134,1314,2448,1207
3405-000,2017,6,9,9,1347,1258,2605,2448
3405-000,2017,6,9,10,1055,955,2010,2605
3405-000,2017,6,9,11,1144,1006,2150,2010
3405-000,2017,6,9,12,1104,934,2038,2150
3405-000,2017,6,9,13,913,796,1709,2038
3405-000,2017,6,9,14,983,957,1940,1709
3405-000,2017,6,9,15,1194,985,2179,1940
3405-000,2017,6,9,16,1208,1007,2215,2179
3405-000,2017,6,9,17,1186,985,2171,2215
3405-000,2017,6,9,18,1485,1159,2644,2171
3405-000,2017,6,9,19,1483,1219,2702,2644
3405-000,2017,6,9,20,949,772,1721,2702
3405-000,2017,6,9,21,686,668,1354,1721
3405-000,2017,6,9,22,504,447,951,1354
3405-000,2017,6,9,23,369,280,649,951
3405-000,2017,6,9,24,167,205,372,649
3405-000,2017,6,10,1,118,118,236,372
3405-000,2017,6,10,2,88,67,155,236
3405-000,2017,6,10,3,51,62,113,155
3405-000,2017,6,10,4,59,83,142,113
3405-000,2017,6,10,5,116,105,221,142
3405-000,2017,6,10,6,265,217,482,221
3405-000,2017,6,10,7,558,413,971,482
3405-000,2017,6,10,8,779,668,1447,971
3405-000,2017,6,10,9,930,775,1705,1447
3405-000,2017,6,10,10,904,709,1613,1705
3405-000,2017,6,10,11,968,841,1809,1613
3405-000,2017,6,10,12,933,745,1678,1809
3405-000,2017,6,10,13,806,806,1612,1678
3405-000,2017,6,10,14,781,741,1522,1612
3405-000,2017,6,10,15,824,781,1605,1522
3405-000,2017,6,10,16,927,734,1661,1605
3405-000,2017,6,10,17,878,724,1602,1661
3405-000,2017,6,10,18,1068,935,2003,1602
3405-000,2017,6,10,19,867,624,1491,2003
3405-000,2017,6,10,20,518,512,1030,1491
3405-000,2017,6,10,21,406,419,825,1030
3405-000,2017,6,10,22,345,317,662,825
3405-000,2017,6,10,23,208,220,428,662
3405-000,2017,6,10,24,170,174,344,428
3405-000,2017,6,11,1,90,111,201,344
3405-000,2017,6,11,2,77,61,138,201
3405-000,2017,6,11,3,51,37,88,138
3405-000,2017,6,11,4,45,44,89,88
3405-000,2017,6,11,5,77,62,139,89
3405-000,2017,6,11,6,162,124,286,139
3405-000,2017,6,11,7,249,179,428,286
3405-000,2017,6,11,8,359,300,659,428
3405-000,2017,6,11,9,459,411,870,659
3405-000,2017,6,11,10,538,382,920,870
3405-000,2017,6,11,11,590,481,1071,920
3405-000,2017,6,11,12,577,553,1130,1071
3405-000,2017,6,11,13,530,545,1075,1130
3405-000,2017,6,11,14,559,518,1077,1075
3405-000,2017,6,11,15,655,638,1293,1077
3405-000,2017,6,11,16,671,625,1296,1293
3405-000,2017,6,11,17,693,683,1376,1296
3405-000,2017,6,11,18,722,599,1321,1376
3405-000,2017,6,11,19,642,611,1253,1321
3405-000,2017,6,11,20,500,538,1038,1253
3405-000,2017,6,11,21,385,502,887,1038
3405-000,2017,6,11,22,352,442,794,887
3405-000,2017,6,11,23,219,340,559,794
3405-000,2017,6,11,24,134,198,332,559
3405-000,2017,6,12,1,70,130,200,332
3405-000,2017,6,12,2,44,75,119,200
3405-000,2017,6,12,3,44,53,97,119
3405-000,2017,6,12,4,55,57,112,97
3405-000,2017,6,12,5,158,117,275,112
3405-000,2017,6,12,6,335,294,629,275
3405-000,2017,6,12,7,721,707,1428,629
3405-000,2017,6,12,8,1261,1572,2833,1428
3405-000,2017,6,12,9,1345,1355,2700,2833
3405-000,2017,6,12,10,1120,935,2055,2700
3405-000,2017,6,12,11,1072,973,2045,2055
3405-000,2017,6,12,12,1053,939,1992,2045
3405-000,2017,6,12,13,861,830,1691,1992
3405-000,2017,6,12,14,1035,976,2011,1691
3405-000,2017,6,12,15,1118,1003,2121,2011
3405-000,2017,6,12,16,1182,1041,2223,2121
3405-000,2017,6,12,17,1161,996,2157,2223
3405-000,2017,6,12,18,1251,1015,2266,2157
3405-000,2017,6,12,19,1111,1014,2125,2266
3405-000,2017,6,12,20,694,698,1392,2125
3405-000,2017,6,12,21,633,606,1239,1392
3405-000,2017,6,12,22,402,460,862,1239
3405-000,2017,6,12,23,262,232,494,862
3405-000,2017,6,12,24,137,143,280,494
3405-000,2017,6,13,1,102,102,204,280
3405-000,2017,6,13,2,62,87,149,204
3405-000,2017,6,13,3,67,55,122,149
3405-000,2017,6,13,4,55,71,126,122
3405-000,2017,6,13,5,146,133,279,126
3405-000,2017,6,13,6,285,251,536,279
3405-000,2017,6,13,7,582,575,1157,536
3405-000,2017,6,13,8,1158,1343,2501,1157
3405-000,2017,6,13,9,1419,1341,2760,2501
3405-000,2017,6,13,10,1127,986,2113,2760
3405-000,2017,6,13,11,1085,928,2013,2113
3405-000,2017,6,13,12,1028,974,2002,2013
3405-000,2017,6,13,13,926,797,1723,2002
3405-000,2017,6,13,14,996,1002,1998,1723
3405-000,2017,6,13,15,1143,995,2138,1998
3405-000,2017,6,13,16,1096,1014,2110,2138
3405-000,2017,6,13,17,1048,970,2018,2110
3405-000,2017,6,13,18,1181,1018,2199,2018
3405-000,2017,6,13,19,1165,1016,2181,2199
3405-000,2017,6,13,20,739,698,1437,2181
3405-000,2017,6,13,21,631,615,1246,1437
3405-000,2017,6,13,22,433,434,867,1246
3405-000,2017,6,13,23,265,230,495,867
3405-000,2017,6,13,24,178,164,342,495
3405-000,2017,6,14,1,94,96,190,342
3405-000,2017,6,14,2,71,70,141,190
3405-000,2017,6,14,3,49,63,112,141
3405-000,2017,6,14,4,82,71,153,112
3405-000,2017,6,14,5,134,104,238,153
3405-000,2017,6,14,6,270,267,537,238
3405-000,2017,6,14,7,629,545,1174,537
3405-000,2017,6,14,8,1136,1425,2561,1174
3405-000,2017,6,14,9,1353,1320,2673,2561
3405-000,2017,6,14,10,1109,976,2085,2673
3405-000,2017,6,14,11,1142,1025,2167,2085
3405-000,2017,6,14,12,982,903,1885,2167
3405-000,2017,6,14,13,829,878,1707,1885
3405-000,2017,6,14,14,926,952,1878,1707
3405-000,2017,6,14,15,1149,1004,2153,1878
3405-000,2017,6,14,16,1135,988,2123,2153
3405-000,2017,6,14,17,1109,1010,2119,2123
3405-000,2017,6,14,18,1379,1041,2420,2119
3405-000,2017,6,14,19,1201,1039,2240,2420
3405-000,2017,6,14,20,712,686,1398,2240
3405-000,2017,6,14,21,556,528,1084,1398
3405-000,2017,6,14,22,396,393,789,1084
3405-000,2017,6,14,23,239,248,487,789
3405-000,2017,6,14,24,166,176,342,487
3405-000,2017,6,15,1,75,96,171,342
3405-000,2017,6,15,2,79,80,159,171
3405-000,2017,6,15,3,61,57,118,159
3405-000,2017,6,15,4,83,75,158,118
3405-000,2017,6,15,5,151,114,265,158
3405-000,2017,6,15,6,300,269,569,265
3405-000,2017,6,15,7,641,582,1223,569
3405-000,2017,6,15,8,1167,1380,2547,1223
3405-000,2017,6,15,9,1333,1345,2678,2547
3405-000,2017,6,15,10,1055,970,2025,2678
3405-000,2017,6,15,11,1114,983,2097,2025
3405-000,2017,6,15,12,1023,957,1980,2097
3405-000,2017,6,15,13,872,795,1667,1980
3405-000,2017,6,15,14,991,945,1936,1667
3405-000,2017,6,15,15,1141,1015,2156,1936
3405-000,2017,6,15,16,1137,1062,2199,2156
3405-000,2017,6,15,17,1185,990,2175,2199
3405-000,2017,6,15,18,1204,1071,2275,2175
3405-000,2017,6,15,19,1120,1009,2129,2275
3405-000,2017,6,15,20,793,703,1496,2129
3405-000,2017,6,15,21,653,645,1298,1496
3405-000,2017,6,15,22,468,449,917,1298
3405-000,2017,6,15,23,293,292,585,917
3405-000,2017,6,15,24,184,184,368,585
3405-000,2017,6,16,1,110,106,216,368
3405-000,2017,6,16,2,74,81,155,216
3405-000,2017,6,16,3,57,56,113,155
3405-000,2017,6,16,4,73,83,156,113
3405-000,2017,6,16,5,153,112,265,156
3405-000,2017,6,16,6,277,236,513,265
3405-000,2017,6,16,7,622,574,1196,513
3405-000,2017,6,16,8,1159,1351,2510,1196
3405-000,2017,6,16,9,1352,1320,2672,2510
3405-000,2017,6,16,10,1114,988,2102,2672
3405-000,2017,6,16,11,1088,997,2085,2102
3405-000,2017,6,16,12,1076,930,2006,2085
3405-000,2017,6,16,13,942,803,1745,2006
3405-000,2017,6,16,14,973,906,1879,1745
3405-000,2017,6,16,15,1056,987,2043,1879
3405-000,2017,6,16,16,1130,1020,2150,2043
3405-000,2017,6,16,17,1203,1001,2204,2150
3405-000,2017,6,16,18,1526,1169,2695,2204
3405-000,2017,6,16,19,1589,1159,2748,2695
3405-000,2017,6,16,20,956,847,1803,2748
3405-000,2017,6,16,21,756,654,1410,1803
3405-000,2017,6,16,22,543,428,971,1410
3405-000,2017,6,16,23,316,259,575,971
3405-000,2017,6,16,24,159,193,352,575
3405-000,2017,6,17,1,120,127,247,352
3405-000,2017,6,17,2,86,94,180,247
3405-000,2017,6,17,3,70,65,135,180
3405-000,2017,6,17,4,71,84,155,135
3405-000,2017,6,17,5,160,121,281,155
3405-000,2017,6,17,6,301,211,512,281
3405-000,2017,6,17,7,527,411,938,512
3405-000,2017,6,17,8,830,696,1526,938
3405-000,2017,6,17,9,888,853,1741,1526
3405-000,2017,6,17,10,897,762,1659,1741
3405-000,2017,6,17,11,960,757,1717,1659
3405-000,2017,6,17,12,914,823,1737,1717
3405-000,2017,6,17,13,850,736,1586,1737
3405-000,2017,6,17,14,849,756,1605,1586
3405-000,2017,6,17,15,870,811,1681,1605
3405-000,2017,6,17,16,894,771,1665,1681
3405-000,2017,6,17,17,914,732,1646,1665
3405-000,2017,6,17,18,1066,917,1983,1646
3405-000,2017,6,17,19,822,685,1507,1983
3405-000,2017,6,17,20,577,483,1060,1507
3405-000,2017,6,17,21,436,404,840,1060
3405-000,2017,6,17,22,355,341,696,840
3405-000,2017,6,17,23,224,232,456,696
3405-000,2017,6,17,24,149,167,316,456
3405-000,2017,6,18,1,103,93,196,316
3405-000,2017,6,18,2,62,83,145,196
3405-000,2017,6,18,3,43,46,89,145
3405-000,2017,6,18,4,46,32,78,89
3405-000,2017,6,18,5,77,58,135,78
3405-000,2017,6,18,6,182,116,298,135
3405-000,2017,6,18,7,254,167,421,298
3405-000,2017,6,18,8,393,248,641,421
3405-000,2017,6,18,9,458,363,821,641
3405-000,2017,6,18,10,448,403,851,821
3405-000,2017,6,18,11,625,463,1088,851
3405-000,2017,6,18,12,554,489,1043,1088
3405-000,2017,6,18,13,530,480,1010,1043
3405-000,2017,6,18,14,545,558,1103,1010
3405-000,2017,6,18,15,626,568,1194,1103
3405-000,2017,6,18,16,685,609,1294,1194
3405-000,2017,6,18,17,691,690,1381,1294
3405-000,2017,6,18,18,719,692,1411,1381
3405-000,2017,6,18,19,581,636,1217,1411
3405-000,2017,6,18,20,466,576,1042,1217
3405-000,2017,6,18,21,458,555,1013,1042
3405-000,2017,6,18,22,323,446,769,1013
3405-000,2017,6,18,23,256,349,605,769
3405-000,2017,6,18,24,160,217,377,605
3405-000,2017,6,19,1,104,120,224,377
3405-000,2017,6,19,2,54,69,123,224
3405-000,2017,6,19,3,36,63,99,123
3405-000,2017,6,19,4,59,64,123,99
3405-000,2017,6,19,5,152,123,275,123
3405-000,2017,6,19,6,350,319,669,275
3405-000,2017,6,19,7,736,717,1453,669
3405-000,2017,6,19,8,1237,1566,2803,1453
3405-000,2017,6,19,9,1295,1341,2636,2803
3405-000,2017,6,19,10,1019,965,1984,2636
3405-000,2017,6,19,11,1064,932,1996,1984
3405-000,2017,6,19,12,1051,944,1995,1996
3405-000,2017,6,19,13,843,754,1597,1995
3405-000,2017,6,19,14,1005,990,1995,1597
3405-000,2017,6,19,15,1117,1018,2135,1995
3405-000,2017,6,19,16,1104,989,2093,2135
3405-000,2017,6,19,17,1027,949,1976,2093
3405-000,2017,6,19,18,1166,1014,2180,1976
3405-000,2017,6,19,19,1167,1035,2202,2180
3405-000,2017,6,19,20,770,725,1495,2202
3405-000,2017,6,19,21,619,618,1237,1495
3405-000,2017,6,19,22,420,429,849,1237
3405-000,2017,6,19,23,267,241,508,849
3405-000,2017,6,19,24,140,146,286,508
3405-000,2017,6,20,1,102,109,211,286
3405-000,2017,6,20,2,61,83,144,211
3405-000,2017,6,20,3,56,46,102,144
3405-000,2017,6,20,4,69,84,153,102
3405-000,2017,6,20,5,131,104,235,153
3405-000,2017,6,20,6,304,275,579,235
3405-000,2017,6,20,7,632,578,1210,579
3405-000,2017,6,20,8,1167,1335,2502,1210
3405-000,2017,6,20,9,1336,1324,2660,2502
3405-000,2017,6,20,10,1116,1063,2179,2660
3405-000,2017,6,20,11,1160,998,2158,2179
3405-000,2017,6,20,12,1057,903,1960,2158
3405-000,2017,6,20,13,877,799,1676,1960
3405-000,2017,6,20,14,1050,954,2004,1676
3405-000,2017,6,20,15,1112,964,2076,2004
3405-000,2017,6,20,16,1095,971,2066,2076
3405-000,2017,6,20,17,1092,1033,2125,2066
3405-000,2017,6,20,18,1203,992,2195,2125
3405-000,2017,6,20,19,1133,1003,2136,2195
3405-000,2017,6,20,20,759,717,1476,2136
3405-000,2017,6,20,21,666,627,1293,1476
3405-000,2017,6,20,22,427,418,845,1293
3405-000,2017,6,20,23,283,258,541,845
3405-000,2017,6,20,24,160,169,329,541
3405-000,2017,6,21,1,92,96,188,329
3405-000,2017,6,21,2,73,79,152,188
3405-000,2017,6,21,3,54,59,113,152
3405-000,2017,6,21,4,80,75,155,113
3405-000,2017,6,21,5,133,110,243,155
3405-000,2017,6,21,6,285,252,537,243
3405-000,2017,6,21,7,632,547,1179,537
3405-000,2017,6,21,8,1155,1408,2563,1179
3405-000,2017,6,21,9,1358,1332,2690,2563
3405-000,2017,6,21,10,1142,1006,2148,2690
3405-000,2017,6,21,11,1102,1033,2135,2148
3405-000,2017,6,21,12,1062,943,2005,2135
3405-000,2017,6,21,13,876,882,1758,2005
3405-000,2017,6,21,14,959,980,1939,1758
3405-000,2017,6,21,15,1175,990,2165,1939
3405-000,2017,6,21,16,1151,1010,2161,2165
3405-000,2017,6,21,17,1113,1025,2138,2161
3405-000,2017,6,21,18,1346,1068,2414,2138
3405-000,2017,6,21,19,1235,1085,2320,2414
3405-000,2017,6,21,20,714,682,1396,2320
3405-000,2017,6,21,21,565,537,1102,1396
3405-000,2017,6,21,22,399,397,796,1102
3405-000,2017,6,21,23,265,244,509,796
3405-000,2017,6,21,24,160,163,323,509
3405-000,2017,6,22,1,89,100,189,323
3405-000,2017,6,22,2,76,79,155,189
3405-000,2017,6,22,3,55,63,118,155
3405-000,2017,6,22,4,76,75,151,118
3405-000,2017,6,22,5,158,111,269,151
3405-000,2017,6,22,6,291,258,549,269
3405-000,2017,6,22,7,655,579,1234,549
3405-000,2017,6,22,8,1179,1345,2524,1234
3405-000,2017,6,22,9,1334,1315,2649,2524
3405-000,2017,6,22,10,1096,992,2088,2649
3405-000,2017,6,22,11,1100,1006,2106,2088
3405-000,2017,6,22,12,1020,937,1957,2106
3405-000,2017,6,22,13,892,818,1710,1957
3405-000,2017,6,22,14,1008,931,1939,1710
3405-000,2017,6,22,15,1107,1000,2107,1939
3405-000,2017,6,22,16,1093,999,2092,2107
3405-000,2017,6,22,17,1100,959,2059,2092
3405-000,2017,6,22,18,1217,1089,2306,2059
3405-000,2017,6,22,19,1141,1028,2169,2306
3405-000,2017,6,22,20,755,706,1461,2169
3405-000,2017,6,22,21,637,620,1257,1461
3405-000,2017,6,22,22,455,464,919,1257
3405-000,2017,6,22,23,287,277,564,919
3405-000,2017,6,22,24,173,188,361,564
3405-000,2017,6,23,1,137,109,246,361
3405-000,2017,6,23,2,100,79,179,246
3405-000,2017,6,23,3,64,61,125,179
3405-000,2017,6,23,4,84,83,167,125
3405-000,2017,6,23,5,160,118,278,167
3405-000,2017,6,23,6,300,242,542,278
3405-000,2017,6,23,7,635,573,1208,542
3405-000,2017,6,23,8,1178,1320,2498,1208
3405-000,2017,6,23,9,1324,1278,2602,2498
3405-000,2017,6,23,10,1105,964,2069,2602
3405-000,2017,6,23,11,1088,986,2074,2069
3405-000,2017,6,23,12,1078,950,2028,2074
3405-000,2017,6,23,13,890,824,1714,2028
3405-000,2017,6,23,14,989,928,1917,1714
3405-000,2017,6,23,15,1106,990,2096,1917
3405-000,2017,6,23,16,1165,1011,2176,2096
3405-000,2017,6,23,17,1188,961,2149,2176
3405-000,2017,6,23,18,1522,1125,2647,2149
3405-000,2017,6,23,19,1700,1241,2941,2647
3405-000,2017,6,23,20,966,842,1808,2941
3405-000,2017,6,23,21,735,642,1377,1808
3405-000,2017,6,23,22,518,424,942,1377
3405-000,2017,6,23,23,317,267,584,942
3405-000,2017,6,23,24,179,191,370,584
3405-000,2017,6,24,1,127,146,273,370
3405-000,2017,6,24,2,86,93,179,273
3405-000,2017,6,24,3,68,73,141,179
3405-000,2017,6,24,4,102,88,190,141
3405-000,2017,6,24,5,168,110,278,190
3405-000,2017,6,24,6,298,206,504,278
3405-000,2017,6,24,7,490,398,888,504
3405-000,2017,6,24,8,830,685,1515,888
3405-000,2017,6,24,9,900,832,1732,1515
3405-000,2017,6,24,10,880,723,1603,1732
3405-000,2017,6,24,11,932,748,1680,1603
3405-000,2017,6,24,12,857,776,1633,1680
3405-000,2017,6,24,13,840,738,1578,1633
3405-000,2017,6,24,14,837,778,1615,1578
3405-000,2017,6,24,15,839,775,1614,1615
3405-000,2017,6,24,16,874,782,1656,1614
3405-000,2017,6,24,17,949,746,1695,1656
3405-000,2017,6,24,18,1024,887,1911,1695
3405-000,2017,6,24,19,841,677,1518,1911
3405-000,2017,6,24,20,542,491,1033,1518
3405-000,2017,6,24,21,406,400,806,1033
3405-000,2017,6,24,22,330,326,656,806
3405-000,2017,6,24,23,222,238,460,656
3405-000,2017,6,24,24,142,167,309,460
3405-000,2017,6,25,1,96,94,190,309
3405-000,2017,6,25,2,63,67,130,190
3405-000,2017,6,25,3,43,41,84,130
3405-000,2017,6,25,4,42,35,77,84
3405-000,2017,6,25,5,69,56,125,77
3405-000,2017,6,25,6,168,94,262,125
3405-000,2017,6,25,7,235,159,394,262
3405-000,2017,6,25,8,365,237,602,394
3405-000,2017,6,25,9,429,344,773,602
3405-000,2017,6,25,10,446,385,831,773
3405-000,2017,6,25,11,559,432,991,831
3405-000,2017,6,25,12,520,493,1013,991
3405-000,2017,6,25,13,506,529,1035,1013
3405-000,2017,6,25,14,553,559,1112,1035
3405-000,2017,6,25,15,616,600,1216,1112
3405-000,2017,6,25,16,657,611,1268,1216
3405-000,2017,6,25,17,623,653,1276,1268
3405-000,2017,6,25,18,632,646,1278,1276
3405-000,2017,6,25,19,525,603,1128,1278
3405-000,2017,6,25,20,462,546,1008,1128
3405-000,2017,6,25,21,401,466,867,1008
3405-000,2017,6,25,22,294,382,676,867
3405-000,2017,6,25,23,220,305,525,676
3405-000,2017,6,25,24,138,187,325,525
3405-000,2017,6,26,1,89,117,206,325
3405-000,2017,6,26,2,51,65,116,206
3405-000,2017,6,26,3,52,43,95,116
3405-000,2017,6,26,4,55,78,133,95
3405-000,2017,6,26,5,138,116,254,133
3405-000,2017,6,26,6,316,294,610,254
3405-000,2017,6,26,7,746,676,1422,610
3405-000,2017,6,26,8,1201,1623,2824,1422
3405-000,2017,6,26,9,1303,1332,2635,2824
3405-000,2017,6,26,10,988,926,1914,2635
3405-000,2017,6,26,11,1139,953,2092,1914
3405-000,2017,6,26,12,1082,976,2058,2092
3405-000,2017,6,26,13,855,851,1706,2058
3405-000,2017,6,26,14,988,934,1922,1706
3405-000,2017,6,26,15,1096,980,2076,1922
3405-000,2017,6,26,16,1137,1007,2144,2076
3405-000,2017,6,26,17,1085,954,2039,2144
3405-000,2017,6,26,18,1160,1039,2199,2039
3405-000,2017,6,26,19,1112,990,2102,2199
3405-000,2017,6,26,20,732,700,1432,2102
3405-000,2017,6,26,21,598,591,1189,1432
3405-000,2017,6,26,22,395,410,805,1189
3405-000,2017,6,26,23,261,228,489,805
3405-000,2017,6,26,24,141,150,291,489
3405-000,2017,6,27,1,90,91,181,291
3405-000,2017,6,27,2,52,76,128,181
3405-000,2017,6,27,3,53,74,127,128
3405-000,2017,6,27,4,67,81,148,127
3405-000,2017,6,27,5,131,98,229,148
3405-000,2017,6,27,6,299,231,530,229
3405-000,2017,6,27,7,602,572,1174,530
3405-000,2017,6,27,8,1185,1355,2540,1174
3405-000,2017,6,27,9,1339,1293,2632,2540
3405-000,2017,6,27,10,1091,1002,2093,2632
3405-000,2017,6,27,11,1138,934,2072,2093
3405-000,2017,6,27,12,1064,950,2014,2072
3405-000,2017,6,27,13,853,822,1675,2014
3405-000,2017,6,27,14,935,971,1906,1675
3405-000,2017,6,27,15,1101,948,2049,1906
3405-000,2017,6,27,16,1097,971,2068,2049
3405-000,2017,6,27,17,1123,941,2064,2068
3405-000,2017,6,27,18,1221,1013,2234,2064
3405-000,2017,6,27,19,1145,1066,2211,2234
3405-000,2017,6,27,20,722,692,1414,2211
3405-000,2017,6,27,21,606,621,1227,1414
3405-000,2017,6,27,22,451,434,885,1227
3405-000,2017,6,27,23,282,236,518,885
3405-000,2017,6,27,24,156,160,316,518
3405-000,2017,6,28,1,90,95,185,316
3405-000,2017,6,28,2,74,88,162,185
3405-000,2017,6,28,3,58,55,113,162
3405-000,2017,6,28,4,78,79,157,113
3405-000,2017,6,28,5,131,115,246,157
3405-000,2017,6,28,6,300,236,536,246
3405-000,2017,6,28,7,634,548,1182,536
3405-000,2017,6,28,8,1174,1390,2564,1182
3405-000,2017,6,28,9,1363,1344,2707,2564
3405-000,2017,6,28,10,1174,1035,2209,2707
3405-000,2017,6,28,11,1061,1041,2102,2209
3405-000,2017,6,28,12,1142,982,2124,2102
3405-000,2017,6,28,13,923,885,1808,2124
3405-000,2017,6,28,14,992,1007,1999,1808
3405-000,2017,6,28,15,1201,975,2176,1999
3405-000,2017,6,28,16,1167,1031,2198,2176
3405-000,2017,6,28,17,1116,1040,2156,2198
3405-000,2017,6,28,18,1312,1095,2407,2156
3405-000,2017,6,28,19,1269,1130,2399,2407
3405-000,2017,6,28,20,716,678,1394,2399
3405-000,2017,6,28,21,574,546,1120,1394
3405-000,2017,6,28,22,401,400,801,1120
3405-000,2017,6,28,23,290,239,529,801
3405-000,2017,6,28,24,153,149,302,529
3405-000,2017,6,29,1,102,103,205,302
3405-000,2017,6,29,2,72,78,150,205
3405-000,2017,6,29,3,49,69,118,150
3405-000,2017,6,29,4,69,75,144,118
3405-000,2017,6,29,5,165,107,272,144
3405-000,2017,6,29,6,282,246,528,272
3405-000,2017,6,29,7,669,575,1244,528
3405-000,2017,6,29,8,1191,1310,2501,1244
3405-000,2017,6,29,9,1334,1284,2618,2501
3405-000,2017,6,29,10,1136,1014,2150,2618
3405-000,2017,6,29,11,1085,1029,2114,2150
3405-000,2017,6,29,12,1016,916,1932,2114
3405-000,2017,6,29,13,912,840,1752,1932
3405-000,2017,6,29,14,1024,916,1940,1752
3405-000,2017,6,29,15,1072,984,2056,1940
3405-000,2017,6,29,16,1049,936,1985,2056
3405-000,2017,6,29,17,1015,927,1942,1985
3405-000,2017,6,29,18,1229,1107,2336,1942
3405-000,2017,6,29,19,1162,1047,2209,2336
3405-000,2017,6,29,20,716,708,1424,2209
3405-000,2017,6,29,21,620,595,1215,1424
3405-000,2017,6,29,22,442,478,920,1215
3405-000,2017,6,29,23,280,262,542,920
3405-000,2017,6,29,24,162,192,354,542
3405-000,2017,6,30,1,164,112,276,354
3405-000,2017,6,30,2,125,77,202,276
3405-000,2017,6,30,3,70,66,136,202
3405-000,2017,6,30,4,95,82,177,136
3405-000,2017,6,30,5,166,123,289,177
3405-000,2017,6,30,6,323,247,570,289
3405-000,2017,6,30,7,647,571,1218,570
3405-000,2017,6,30,8,1197,1288,2485,1218
3405-000,2017,6,30,9,1296,1236,2532,2485
3405-000,2017,6,30,10,1096,939,2035,2532
3405-000,2017,6,30,11,1088,975,2063,2035
3405-000,2017,6,30,12,1080,970,2050,2063
3405-000,2017,6,30,13,838,844,1682,2050
3405-000,2017,6,30,14,1005,949,1954,1682
3405-000,2017,6,30,15,1156,993,2149,1954
3405-000,2017,6,30,16,1200,1002,2202,2149
3405-000,2017,6,30,17,1172,920,2092,2202
3405-000,2017,6,30,18,1518,1081,2599,2092
3405-000,2017,6,30,19,1810,1323,3133,2599
3405-000,2017,6,30,20,975,836,1811,3133
3405-000,2017,6,30,21,714,630,1344,1811
3405-000,2017,6,30,22,493,420,913,1344
3405-000,2017,6,30,23,317,274,591,913
3405-000,2017,6,30,24,198,188,386,591
3405-000,2017,7,1,1,133,165,298,386
3405-000,2017,7,1,2,86,92,178,298
3405-000,2017,7,1,3,65,81,146,178
3405-000,2017,7,1,4,133,92,225,146
3405-000,2017,7,1,5,176,98,274,225
3405-000,2017,7,1,6,294,200,494,274
3405-000,2017,7,1,7,452,384,836,494
3405-000,2017,7,1,8,829,673,1502,836
3405-000,2017,7,1,9,912,810,1722,1502
3405-000,2017,7,1,10,862,684,1546,1722
3405-000,2017,7,1,11,903,738,1641,1546
3405-000,2017,7,1,12,800,729,1529,1641
3405-000,2017,7,1,13,829,740,1569,1529
3405-000,2017,7,1,14,824,799,1623,1569
3405-000,2017,7,1,15,808,739,1547,1623
3405-000,2017,7,1,16,853,793,1646,1547
3405-000,2017,7,1,17,983,760,1743,1646
3405-000,2017,7,1,18,981,856,1837,1743
3405-000,2017,7,1,19,859,669,1528,1837
3405-000,2017,7,1,20,506,498,1004,1528
3405-000,2017,7,1,21,376,395,771,1004
3405-000,2017,7,1,22,305,310,615,771
3405-000,2017,7,1,23,219,244,463,615
3405-000,2017,7,1,24,135,166,301,463
3405-000,2017,7,2,1,88,95,183,301
3405-000,2017,7,2,2,64,50,114,183
3405-000,2017,7,2,3,42,36,78,114
3405-000,2017,7,2,4,38,37,75,78
3405-000,2017,7,2,5,61,54,115,75
3405-000,2017,7,2,6,153,71,224,115
3405-000,2017,7,2,7,216,150,366,224
3405-000,2017,7,2,8,336,225,561,366
3405-000,2017,7,2,9,399,324,723,561
3405-000,2017,7,2,10,444,367,811,723
3405-000,2017,7,2,11,493,401,894,811
3405-000,2017,7,2,12,485,497,982,894
3405-000,2017,7,2,13,482,577,1059,982
3405-000,2017,7,2,14,560,559,1119,1059
3405-000,2017,7,2,15,606,631,1237,1119
3405-000,2017,7,2,16,628,612,1240,1237
3405-000,2017,7,2,17,555,615,1170,1240
3405-000,2017,7,2,18,544,599,1143,1170
3405-000,2017,7,2,19,469,570,1039,1143
3405-000,2017,7,2,20,457,516,973,1039
3405-000,2017,7,2,21,344,376,720,973
3405-000,2017,7,2,22,265,317,582,720
3405-000,2017,7,2,23,184,261,445,582
3405-000,2017,7,2,24,115,157,272,445
3405-000,2017,7,3,1,64,109,173,272
3405-000,2017,7,3,2,53,64,117,173
3405-000,2017,7,3,3,41,51,92,117
3405-000,2017,7,3,4,58,74,132,92
3405-000,2017,7,3,5,103,91,194,132
3405-000,2017,7,3,6,265,272,537,194
3405-000,2017,7,3,7,662,642,1304,537
3405-000,2017,7,3,8,1114,1534,2648,1304
3405-000,2017,7,3,9,1217,1279,2496,2648
3405-000,2017,7,3,10,1036,876,1912,2496
3405-000,2017,7,3,11,1017,927,1944,1912
3405-000,2017,7,3,12,981,887,1868,1944
3405-000,2017,7,3,13,812,800,1612,1868
3405-000,2017,7,3,14,925,874,1799,1612
3405-000,2017,7,3,15,1065,956,2021,1799
3405-000,2017,7,3,16,1056,989,2045,2021
3405-000,2017,7,3,17,989,918,1907,2045
3405-000,2017,7,3,18,1061,981,2042,1907
3405-000,2017,7,3,19,1051,1012,2063,2042
3405-000,2017,7,3,20,676,628,1304,2063
3405-000,2017,7,3,21,587,571,1158,1304
3405-000,2017,7,3,22,404,357,761,1158
3405-000,2017,7,3,23,224,233,457,761
3405-000,2017,7,3,24,127,126,253,457
3405-000,2017,7,4,1,86,90,176,253
3405-000,2017,7,4,2,51,59,110,176
3405-000,2017,7,4,3,51,58,109,110
3405-000,2017,7,4,4,74,82,156,109
3405-000,2017,7,4,5,109,88,197,156
3405-000,2017,7,4,6,213,195,408,197
3405-000,2017,7,4,7,503,498,1001,408
3405-000,2017,7,4,8,1103,1277,2380,1001
3405-000,2017,7,4,9,1282,1233,2515,2380
3405-000,2017,7,4,10,1125,929,2054,2515
3405-000,2017,7,4,11,1123,1001,2124,2054
3405-000,2017,7,4,12,1094,820,1914,2124
3405-000,2017,7,4,13,881,801,1682,1914
3405-000,2017,7,4,14,978,1016,1994,1682
3405-000,2017,7,4,15,1129,984,2113,1994
3405-000,2017,7,4,16,1231,960,2191,2113
3405-000,2017,7,4,17,1059,903,1962,2191
3405-000,2017,7,4,18,1127,1021,2148,1962
3405-000,2017,7,4,19,1068,1072,2140,2148
3405-000,2017,7,4,20,688,675,1363,2140
3405-000,2017,7,4,21,596,637,1233,1363
3405-000,2017,7,4,22,428,382,810,1233
3405-000,2017,7,4,23,276,224,500,810
3405-000,2017,7,4,24,149,152,301,500
3405-000,2017,7,5,1,91,101,192,301
3405-000,2017,7,5,2,64,61,125,192
3405-000,2017,7,5,3,46,56,102,125
3405-000,2017,7,5,4,77,67,144,102
3405-000,2017,7,5,5,109,106,215,144
3405-000,2017,7,5,6,276,265,541,215
3405-000,2017,7,5,7,626,541,1167,541
3405-000,2017,7,5,8,1225,1353,2578,1167
3405-000,2017,7,5,9,1332,1312,2644,2578
3405-000,2017,7,5,10,1020,909,1929,2644
3405-000,2017,7,5,11,1100,979,2079,1929
3405-000,2017,7,5,12,1055,1008,2063,2079
3405-000,2017,7,5,13,924,814,1738,2063
3405-000,2017,7,5,14,1003,962,1965,1738
3405-000,2017,7,5,15,1121,984,2105,1965
3405-000,2017,7,5,16,1081,1050,2131,2105
3405-000,2017,7,5,17,1083,1014,2097,2131
3405-000,2017,7,5,18,1246,1114,2360,2097
3405-000,2017,7,5,19,1247,1111,2358,2360
3405-000,2017,7,5,20,769,660,1429,2358
3405-000,2017,7,5,21,576,520,1096,1429
3405-000,2017,7,5,22,387,398,785,1096
3405-000,2017,7,5,23,251,229,480,785
3405-000,2017,7,5,24,162,154,316,480
3405-000,2017,7,6,1,106,103,209,316
3405-000,2017,7,6,2,75,82,157,209
3405-000,2017,7,6,3,60,46,106,157
3405-000,2017,7,6,4,70,78,148,106
3405-000,2017,7,6,5,124,100,224,148
3405-000,2017,7,6,6,277,256,533,224
3405-000,2017,7,6,7,636,569,1205,533
3405-000,2017,7,6,8,1224,1389,2613,1205
3405-000,2017,7,6,9,1324,1257,2581,2613
3405-000,2017,7,6,10,1116,964,2080,2581
3405-000,2017,7,6,11,1098,972,2070,2080
3405-000,2017,7,6,12,1009,928,1937,2070
3405-000,2017,7,6,13,912,877,1789,1937
3405-000,2017,7,6,14,1016,930,1946,1789
3405-000,2017,7,6,15,1168,1104,2272,1946
3405-000,2017,7,6,16,1185,1045,2230,2272
3405-000,2017,7,6,17,1080,961,2041,2230
3405-000,2017,7,6,18,1239,1081,2320,2041
3405-000,2017,7,6,19,1109,1044,2153,2320
3405-000,2017,7,6,20,747,684,1431,2153
3405-000,2017,7,6,21,619,611,1230,1431
3405-000,2017,7,6,22,410,426,836,1230
3405-000,2017,7,6,23,290,241,531,836
3405-000,2017,7,6,24,133,160,293,531
3405-000,2017,7,7,1,91,115,206,293
3405-000,2017,7,7,2,64,72,136,206
3405-000,2017,7,7,3,58,47,105,136
3405-000,2017,7,7,4,68,61,129,105
3405-000,2017,7,7,5,102,97,199,129
3405-000,2017,7,7,6,256,216,472,199
3405-000,2017,7,7,7,587,529,1116,472
3405-000,2017,7,7,8,1171,1288,2459,1116
3405-000,2017,7,7,9,1310,1211,2521,2459
3405-000,2017,7,7,10,1083,904,1987,2521
3405-000,2017,7,7,11,1137,991,2128,1987
3405-000,2017,7,7,12,1068,885,1953,2128
3405-000,2017,7,7,13,916,789,1705,1953
3405-000,2017,7,7,14,1009,983,1992,1705
3405-000,2017,7,7,15,1147,1017,2164,1992
3405-000,2017,7,7,16,1140,972,2112,2164
3405-000,2017,7,7,17,1100,938,2038,2112
3405-000,2017,7,7,18,1367,1115,2482,2038
3405-000,2017,7,7,19,1504,1121,2625,2482
3405-000,2017,7,7,20,914,779,1693,2625
3405-000,2017,7,7,21,652,602,1254,1693
3405-000,2017,7,7,22,446,393,839,1254
3405-000,2017,7,7,23,284,245,529,839
3405-000,2017,7,7,24,156,155,311,529
3405-000,2017,7,8,1,113,99,212,311
3405-000,2017,7,8,2,64,83,147,212
3405-000,2017,7,8,3,71,58,129,147
3405-000,2017,7,8,4,58,71,129,129
3405-000,2017,7,8,5,97,72,169,129
3405-000,2017,7,8,6,216,170,386,169
3405-000,2017,7,8,7,412,338,750,386
3405-000,2017,7,8,8,656,517,1173,750
3405-000,2017,7,8,9,790,700,1490,1173
3405-000,2017,7,8,10,830,627,1457,1490
3405-000,2017,7,8,11,824,611,1435,1457
3405-000,2017,7,8,12,835,646,1481,1435
3405-000,2017,7,8,13,707,630,1337,1481
3405-000,2017,7,8,14,737,629,1366,1337
3405-000,2017,7,8,15,741,627,1368,1366
3405-000,2017,7,8,16,811,662,1473,1368
3405-000,2017,7,8,17,791,604,1395,1473
3405-000,2017,7,8,18,1028,761,1789,1395
3405-000,2017,7,8,19,904,537,1441,1789
3405-000,2017,7,8,20,563,478,1041,1441
3405-000,2017,7,8,21,365,308,673,1041
3405-000,2017,7,8,22,301,282,583,673
3405-000,2017,7,8,23,224,197,421,583
3405-000,2017,7,8,24,124,163,287,421
3405-000,2017,7,9,1,84,83,167,287
3405-000,2017,7,9,2,74,48,122,167
3405-000,2017,7,9,3,44,42,86,122
3405-000,2017,7,9,4,45,44,89,86
3405-000,2017,7,9,5,62,36,98,89
3405-000,2017,7,9,6,132,95,227,98
3405-000,2017,7,9,7,211,158,369,227
3405-000,2017,7,9,8,292,236,528,369
3405-000,2017,7,9,9,389,349,738,528
3405-000,2017,7,9,10,455,360,815,738
3405-000,2017,7,9,11,553,448,1001,815
3405-000,2017,7,9,12,579,444,1023,1001
3405-000,2017,7,9,13,512,481,993,1023
3405-000,2017,7,9,14,544,556,1100,993
3405-000,2017,7,9,15,579,599,1178,1100
3405-000,2017,7,9,16,572,638,1210,1178
3405-000,2017,7,9,17,652,609,1261,1210
3405-000,2017,7,9,18,602,653,1255,1261
3405-000,2017,7,9,19,534,652,1186,1255
3405-000,2017,7,9,20,378,524,902,1186
3405-000,2017,7,9,21,330,415,745,902
3405-000,2017,7,9,22,301,418,719,745
3405-000,2017,7,9,23,239,287,526,719
3405-000,2017,7,9,24,99,173,272,526
3405-000,2017,7,10,1,67,136,203,272
3405-000,2017,7,10,2,49,62,111,203
3405-000,2017,7,10,3,33,49,82,111
3405-000,2017,7,10,4,51,62,113,82
3405-000,2017,7,10,5,127,113,240,113
3405-000,2017,7,10,6,288,275,563,240
3405-000,2017,7,10,7,674,688,1362,563
3405-000,2017,7,10,8,1171,1491,2662,1362
3405-000,2017,7,10,9,1214,1299,2513,2662
3405-000,2017,7,10,10,966,823,1789,2513
3405-000,2017,7,10,11,899,835,1734,1789
3405-000,2017,7,10,12,924,824,1748,1734
3405-000,2017,7,10,13,724,715,1439,1748
3405-000,2017,7,10,14,855,872,1727,1439
3405-000,2017,7,10,15,1046,923,1969,1727
3405-000,2017,7,10,16,1057,974,2031,1969
3405-000,2017,7,10,17,966,795,1761,2031
3405-000,2017,7,10,18,1042,980,2022,1761
3405-000,2017,7,10,19,981,994,1975,2022
3405-000,2017,7,10,20,680,636,1316,1975
3405-000,2017,7,10,21,531,550,1081,1316
3405-000,2017,7,10,22,344,365,709,1081
3405-000,2017,7,10,23,218,181,399,709
3405-000,2017,7,10,24,122,140,262,399
3405-000,2017,7,11,1,89,88,177,262
3405-000,2017,7,11,2,47,66,113,177
3405-000,2017,7,11,3,60,61,121,113
3405-000,2017,7,11,4,64,95,159,121
3405-000,2017,7,11,5,110,82,192,159
3405-000,2017,7,11,6,216,216,432,192
3405-000,2017,7,11,7,596,498,1094,432
3405-000,2017,7,11,8,1176,1317,2493,1094
3405-000,2017,7,11,9,1330,1254,2584,2493
3405-000,2017,7,11,10,1132,959,2091,2584
3405-000,2017,7,11,11,1074,1011,2085,2091
3405-000,2017,7,11,12,978,934,1912,2085
3405-000,2017,7,11,13,868,803,1671,1912
3405-000,2017,7,11,14,1017,917,1934,1671
3405-000,2017,7,11,15,1145,1115,2260,1934
3405-000,2017,7,11,16,1177,1029,2206,2260
3405-000,2017,7,11,17,1087,907,1994,2206
3405-000,2017,7,11,18,1136,1098,2234,1994
3405-000,2017,7,11,19,1132,1052,2184,2234
3405-000,2017,7,11,20,737,660,1397,2184
3405-000,2017,7,11,21,586,598,1184,1397
3405-000,2017,7,11,22,389,396,785,1184
3405-000,2017,7,11,23,260,238,498,785
3405-000,2017,7,11,24,196,141,337,498
3405-000,2017,7,12,1,93,83,176,337
3405-000,2017,7,12,2,67,75,142,176
3405-000,2017,7,12,3,50,51,101,142
3405-000,2017,7,12,4,58,67,125,101
3405-000,2017,7,12,5,122,111,233,125
3405-000,2017,7,12,6,272,244,516,233
3405-000,2017,7,12,7,606,561,1167,516
3405-000,2017,7,12,8,1194,1392,2586,1167
3405-000,2017,7,12,9,1363,1260,2623,2586
3405-000,2017,7,12,10,1162,995,2157,2623
3405-000,2017,7,12,11,1130,1058,2188,2157
3405-000,2017,7,12,12,1080,941,2021,2188
3405-000,2017,7,12,13,877,792,1669,2021
3405-000,2017,7,12,14,941,944,1885,1669
3405-000,2017,7,12,15,1094,1023,2117,1885
3405-000,2017,7,12,16,1169,955,2124,2117
3405-000,2017,7,12,17,1100,1013,2113,2124
3405-000,2017,7,12,18,1350,1164,2514,2113
3405-000,2017,7,12,19,1261,1173,2434,2514
3405-000,2017,7,12,20,774,733,1507,2434
3405-000,2017,7,12,21,562,512,1074,1507
3405-000,2017,7,12,22,389,401,790,1074
3405-000,2017,7,12,23,272,241,513,790
3405-000,2017,7,12,24,148,159,307,513
3405-000,2017,7,13,1,105,106,211,307
3405-000,2017,7,13,2,66,95,161,211
3405-000,2017,7,13,3,72,62,134,161
3405-000,2017,7,13,4,63,75,138,134
3405-000,2017,7,13,5,123,112,235,138
3405-000,2017,7,13,6,284,261,545,235
3405-000,2017,7,13,7,664,543,1207,545
3405-000,2017,7,13,8,1191,1362,2553,1207
3405-000,2017,7,13,9,1408,1228,2636,2553
3405-000,2017,7,13,10,1149,966,2115,2636
3405-000,2017,7,13,11,1058,1023,2081,2115
3405-000,2017,7,13,12,1068,931,1999,2081
3405-000,2017,7,13,13,879,825,1704,1999
3405-000,2017,7,13,14,1019,1004,2023,1704
3405-000,2017,7,13,15,1097,1027,2124,2023
3405-000,2017,7,13,16,1116,1011,2127,2124
3405-000,2017,7,13,17,1076,953,2029,2127
3405-000,2017,7,13,18,1245,1076,2321,2029
3405-000,2017,7,13,19,1227,1054,2281,2321
3405-000,2017,7,13,20,748,734,1482,2281
3405-000,2017,7,13,21,591,632,1223,1482
3405-000,2017,7,13,22,414,466,880,1223
3405-000,2017,7,13,23,310,270,580,880
3405-000,2017,7,13,24,148,202,350,580
3405-000,2017,7,14,1,90,123,213,350
3405-000,2017,7,14,2,72,72,144,213
3405-000,2017,7,14,3,60,51,111,144
3405-000,2017,7,14,4,72,74,146,111
3405-000,2017,7,14,5,127,98,225,146
3405-000,2017,7,14,6,294,244,538,225
3405-000,2017,7,14,7,631,582,1213,538
3405-000,2017,7,14,8,1224,1332,2556,1213
3405-000,2017,7,14,9,1298,1261,2559,2556
3405-000,2017,7,14,10,1142,1042,2184,2559
3405-000,2017,7,14,11,1137,1022,2159,2184
3405-000,2017,7,14,12,1114,949,2063,2159
3405-000,2017,7,14,13,921,801,1722,2063
3405-000,2017,7,14,14,1036,966,2002,1722
3405-000,2017,7,14,15,1156,974,2130,2002
3405-000,2017,7,14,16,1239,991,2230,2130
3405-000,2017,7,14,17,1217,997,2214,2230
3405-000,2017,7,14,18,1496,1164,2660,2214
3405-000,2017,7,14,19,1551,1181,2732,2660
3405-000,2017,7,14,20,1042,828,1870,2732
3405-000,2017,7,14,21,742,651,1393,1870
3405-000,2017,7,14,22,496,451,947,1393
3405-000,2017,7,14,23,313,273,586,947
3405-000,2017,7,14,24,166,171,337,586
3405-000,2017,7,15,1,118,110,228,337
3405-000,2017,7,15,2,70,80,150,228
3405-000,2017,7,15,3,57,66,123,150
3405-000,2017,7,15,4,53,78,131,123
3405-000,2017,7,15,5,100,90,190,131
3405-000,2017,7,15,6,218,157,375,190
3405-000,2017,7,15,7,443,351,794,375
3405-000,2017,7,15,8,815,620,1435,794
3405-000,2017,7,15,9,857,731,1588,1435
3405-000,2017,7,15,10,847,710,1557,1588
3405-000,2017,7,15,11,910,688,1598,1557
3405-000,2017,7,15,12,878,704,1582,1598
3405-000,2017,7,15,13,766,657,1423,1582
3405-000,2017,7,15,14,782,713,1495,1423
3405-000,2017,7,15,15,781,722,1503,1495
3405-000,2017,7,15,16,802,741,1543,1503
3405-000,2017,7,15,17,850,670,1520,1543
3405-000,2017,7,15,18,895,795,1690,1520
3405-000,2017,7,15,19,796,612,1408,1690
3405-000,2017,7,15,20,480,450,930,1408
3405-000,2017,7,15,21,358,334,692,930
3405-000,2017,7,15,22,301,280,581,692
3405-000,2017,7,15,23,196,206,402,581
3405-000,2017,7,15,24,137,168,305,402
3405-000,2017,7,16,1,91,86,177,305
3405-000,2017,7,16,2,66,57,123,177
3405-000,2017,7,16,3,52,38,90,123
3405-000,2017,7,16,4,35,36,71,90
3405-000,2017,7,16,5,68,46,114,71
3405-000,2017,7,16,6,103,68,171,114
3405-000,2017,7,16,7,167,144,311,171
3405-000,2017,7,16,8,274,242,516,311
3405-000,2017,7,16,9,395,290,685,516
3405-000,2017,7,16,10,412,304,716,685
3405-000,2017,7,16,11,502,432,934,716
3405-000,2017,7,16,12,509,441,950,934
3405-000,2017,7,16,13,457,489,946,950
3405-000,2017,7,16,14,484,527,1011,946
3405-000,2017,7,16,15,562,558,1120,1011
3405-000,2017,7,16,16,602,575,1177,1120
3405-000,2017,7,16,17,614,640,1254,1177
3405-000,2017,7,16,18,544,704,1248,1254
3405-000,2017,7,16,19,453,531,984,1248
3405-000,2017,7,16,20,372,542,914,984
3405-000,2017,7,16,21,359,405,764,914
3405-000,2017,7,16,22,258,350,608,764
3405-000,2017,7,16,23,192,265,457,608
3405-000,2017,7,16,24,122,177,299,457
3405-000,2017,7,17,1,73,111,184,299
3405-000,2017,7,17,2,47,47,94,184
3405-000,2017,7,17,3,55,39,94,94
3405-000,2017,7,17,4,53,71,124,94
3405-000,2017,7,17,5,119,105,224,124
3405-000,2017,7,17,6,306,313,619,224
3405-000,2017,7,17,7,679,686,1365,619
3405-000,2017,7,17,8,1258,1567,2825,1365
3405-000,2017,7,17,9,1312,1342,2654,2825
3405-000,2017,7,17,10,1056,922,1978,2654
3405-000,2017,7,17,11,1054,901,1955,1978
3405-000,2017,7,17,12,1019,865,1884,1955
3405-000,2017,7,17,13,832,772,1604,1884
3405-000,2017,7,17,14,893,985,1878,1604
3405-000,2017,7,17,15,1019,1018,2037,1878
3405-000,2017,7,17,16,1076,996,2072,2037
3405-000,2017,7,17,17,1011,949,1960,2072
3405-000,2017,7,17,18,1120,1031,2151,1960
3405-000,2017,7,17,19,1070,1013,2083,2151
3405-000,2017,7,17,20,674,717,1391,2083
3405-000,2017,7,17,21,580,610,1190,1391
3405-000,2017,7,17,22,395,421,816,1190
3405-000,2017,7,17,23,233,217,450,816
3405-000,2017,7,17,24,129,144,273,450
3405-000,2017,7,18,1,89,85,174,273
3405-000,2017,7,18,2,46,60,106,174
3405-000,2017,7,18,3,59,76,135,106
3405-000,2017,7,18,4,57,78,135,135
3405-000,2017,7,18,5,111,100,211,135
3405-000,2017,7,18,6,240,234,474,211
3405-000,2017,7,18,7,613,541,1154,474
3405-000,2017,7,18,8,1161,1302,2463,1154
3405-000,2017,7,18,9,1298,1243,2541,2463
3405-000,2017,7,18,10,1110,936,2046,2541
3405-000,2017,7,18,11,1080,1027,2107,2046
3405-000,2017,7,18,12,985,940,1925,2107
3405-000,2017,7,18,13,899,845,1744,1925
3405-000,2017,7,18,14,981,1004,1985,1744
3405-000,2017,7,18,15,1103,1045,2148,1985
3405-000,2017,7,18,16,1116,969,2085,2148
3405-000,2017,7,18,17,1089,972,2061,2085
3405-000,2017,7,18,18,1192,1093,2285,2061
3405-000,2017,7,18,19,1102,1008,2110,2285
3405-000,2017,7,18,20,773,713,1486,2110
3405-000,2017,7,18,21,600,634,1234,1486
3405-000,2017,7,18,22,447,495,942,1234
3405-000,2017,7,18,23,258,249,507,942
3405-000,2017,7,18,24,173,178,351,507
3405-000,2017,7,19,1,89,116,205,351
3405-000,2017,7,19,2,57,85,142,205
3405-000,2017,7,19,3,43,79,122,142
3405-000,2017,7,19,4,77,72,149,122
3405-000,2017,7,19,5,112,89,201,149
3405-000,2017,7,19,6,270,227,497,201
3405-000,2017,7,19,7,652,567,1219,497
3405-000,2017,7,19,8,1237,1374,2611,1219
3405-000,2017,7,19,9,1421,1306,2727,2611
3405-000,2017,7,19,10,1129,1020,2149,2727
3405-000,2017,7,19,11,1100,1050,2150,2149
3405-000,2017,7,19,12,1066,951,2017,2150
3405-000,2017,7,19,13,953,854,1807,2017
3405-000,2017,7,19,14,1009,976,1985,1807
3405-000,2017,7,19,15,1128,1049,2177,1985
3405-000,2017,7,19,16,1172,961,2133,2177
3405-000,2017,7,19,17,1107,942,2049,2133
3405-000,2017,7,19,18,1279,1193,2472,2049
3405-000,2017,7,19,19,1192,1101,2293,2472
3405-000,2017,7,19,20,740,721,1461,2293
3405-000,2017,7,19,21,590,565,1155,1461
3405-000,2017,7,19,22,397,389,786,1155
3405-000,2017,7,19,23,247,225,472,786
3405-000,2017,7,19,24,165,174,339,472
3405-000,2017,7,20,1,94,123,217,339
3405-000,2017,7,20,2,58,90,148,217
3405-000,2017,7,20,3,58,63,121,148
3405-000,2017,7,20,4,83,75,158,121
3405-000,2017,7,20,5,130,92,222,158
3405-000,2017,7,20,6,297,260,557,222
3405-000,2017,7,20,7,671,593,1264,557
3405-000,2017,7,20,8,1234,1377,2611,1264
3405-000,2017,7,20,9,1376,1281,2657,2611
3405-000,2017,7,20,10,1206,1014,2220,2657
3405-000,2017,7,20,11,1123,1040,2163,2220
3405-000,2017,7,20,12,1118,938,2056,2163
3405-000,2017,7,20,13,853,885,1738,2056
3405-000,2017,7,20,14,1041,992,2033,1738
3405-000,2017,7,20,15,1096,1024,2120,2033
3405-000,2017,7,20,16,1226,973,2199,2120
3405-000,2017,7,20,17,1153,975,2128,2199
3405-000,2017,7,20,18,1248,1152,2400,2128
3405-000,2017,7,20,19,1139,1014,2153,2400
3405-000,2017,7,20,20,795,655,1450,2153
3405-000,2017,7,20,21,637,619,1256,1450
3405-000,2017,7,20,22,385,471,856,1256
3405-000,2017,7,20,23,284,236,520,856
3405-000,2017,7,20,24,170,184,354,520
3405-000,2017,7,21,1,101,106,207,354
3405-000,2017,7,21,2,68,78,146,207
3405-000,2017,7,21,3,63,66,129,146
3405-000,2017,7,21,4,69,77,146,129
3405-000,2017,7,21,5,142,98,240,146
3405-000,2017,7,21,6,281,233,514,240
3405-000,2017,7,21,7,646,573,1219,514
3405-000,2017,7,21,8,1190,1324,2514,1219
3405-000,2017,7,21,9,1388,1299,2687,2514
3405-000,2017,7,21,10,1209,1038,2247,2687
3405-000,2017,7,21,11,1121,1137,2258,2247
3405-000,2017,7,21,12,1157,1022,2179,2258
3405-000,2017,7,21,13,946,865,1811,2179
3405-000,2017,7,21,14,1052,1057,2109,1811
3405-000,2017,7,21,15,1166,1056,2222,2109
3405-000,2017,7,21,16,1194,1011,2205,2222
3405-000,2017,7,21,17,1223,1075,2298,2205
3405-000,2017,7,21,18,1443,1244,2687,2298
3405-000,2017,7,21,19,1507,1171,2678,2687
3405-000,2017,7,21,20,1006,837,1843,2678
3405-000,2017,7,21,21,688,639,1327,1843
3405-000,2017,7,21,22,455,448,903,1327
3405-000,2017,7,21,23,326,267,593,903
3405-000,2017,7,21,24,174,179,353,593
3405-000,2017,7,22,1,112,124,236,353
3405-000,2017,7,22,2,72,82,154,236
3405-000,2017,7,22,3,78,67,145,154
3405-000,2017,7,22,4,74,90,164,145
3405-000,2017,7,22,5,146,75,221,164
3405-000,2017,7,22,6,291,202,493,221
3405-000,2017,7,22,7,544,454,998,493
3405-000,2017,7,22,8,755,743,1498,998
3405-000,2017,7,22,9,931,779,1710,1498
3405-000,2017,7,22,10,957,758,1715,1710
3405-000,2017,7,22,11,958,810,1768,1715
3405-000,2017,7,22,12,862,808,1670,1768
3405-000,2017,7,22,13,838,770,1608,1670
3405-000,2017,7,22,14,828,760,1588,1608
3405-000,2017,7,22,15,863,723,1586,1588
3405-000,2017,7,22,16,856,768,1624,1586
3405-000,2017,7,22,17,852,754,1606,1624
3405-000,2017,7,22,18,1075,865,1940,1606
3405-000,2017,7,22,19,860,716,1576,1940
3405-000,2017,7,22,20,527,516,1043,1576
3405-000,2017,7,22,21,423,425,848,1043
3405-000,2017,7,22,22,354,319,673,848
3405-000,2017,7,22,23,245,250,495,673
3405-000,2017,7,22,24,141,169,310,495
3405-000,2017,7,23,1,120,96,216,310
3405-000,2017,7,23,2,60,52,112,216
3405-000,2017,7,23,3,50,37,87,112
3405-000,2017,7,23,4,41,42,83,87
3405-000,2017,7,23,5,99,49,148,83
3405-000,2017,7,23,6,162,97,259,148
3405-000,2017,7,23,7,286,192,478,259
3405-000,2017,7,23,8,373,306,679,478
3405-000,2017,7,23,9,447,346,793,679
3405-000,2017,7,23,10,485,370,855,793
3405-000,2017,7,23,11,493,411,904,855
3405-000,2017,7,23,12,520,422,942,904
3405-000,2017,7,23,13,474,552,1026,942
3405-000,2017,7,23,14,511,583,1094,1026
3405-000,2017,7,23,15,603,580,1183,1094
3405-000,2017,7,23,16,550,577,1127,1183
3405-000,2017,7,23,17,677,605,1282,1127
3405-000,2017,7,23,18,621,622,1243,1282
3405-000,2017,7,23,19,455,570,1025,1243
3405-000,2017,7,23,20,410,520,930,1025
3405-000,2017,7,23,21,325,406,731,930
3405-000,2017,7,23,22,261,333,594,731
3405-000,2017,7,23,23,176,282,458,594
3405-000,2017,7,23,24,116,164,280,458
3405-000,2017,7,24,1,58,85,143,280
3405-000,2017,7,24,2,47,51,98,143
3405-000,2017,7,24,3,38,53,91,98
3405-000,2017,7,24,4,57,68,125,91
3405-000,2017,7,24,5,118,101,219,125
3405-000,2017,7,24,6,313,296,609,219
3405-000,2017,7,24,7,664,731,1395,609
3405-000,2017,7,24,8,1279,1643,2922,1395
3405-000,2017,7,24,9,1311,1365,2676,2922
3405-000,2017,7,24,10,1042,979,2021,2676
3405-000,2017,7,24,11,1088,970,2058,2021
3405-000,2017,7,24,12,1043,960,2003,2058
3405-000,2017,7,24,13,855,839,1694,2003
3405-000,2017,7,24,14,917,969,1886,1694
3405-000,2017,7,24,15,1053,954,2007,1886
3405-000,2017,7,24,16,1101,967,2068,2007
3405-000,2017,7,24,17,1015,978,1993,2068
3405-000,2017,7,24,18,1138,956,2094,1993
3405-000,2017,7,24,19,1026,1021,2047,2094
3405-000,2017,7,24,20,718,664,1382,2047
3405-000,2017,7,24,21,534,609,1143,1382
3405-000,2017,7,24,22,370,382,752,1143
3405-000,2017,7,24,23,249,218,467,752
3405-000,2017,7,24,24,127,154,281,467
3405-000,2017,7,25,1,107,96,203,281
3405-000,2017,7,25,2,56,68,124,203
3405-000,2017,7,25,3,47,68,115,124
3405-000,2017,7,25,4,56,68,124,115
3405-000,2017,7,25,5,100,89,189,124
3405-000,2017,7,25,6,270,229,499,189
3405-000,2017,7,25,7,573,479,1052,499
3405-000,2017,7,25,8,1183,1338,2521,1052
3405-000,2017,7,25,9,1372,1261,2633,2521
3405-000,2017,7,25,10,1120,957,2077,2633
3405-000,2017,7,25,11,1135,1100,2235,2077
3405-000,2017,7,25,12,1093,968,2061,2235
3405-000,2017,7,25,13,865,836,1701,2061
3405-000,2017,7,25,14,1043,986,2029,1701
3405-000,2017,7,25,15,1206,1022,2228,2029
3405-000,2017,7,25,16,1130,1109,2239,2228
3405-000,2017,7,25,17,1164,1096,2260,2239
3405-000,2017,7,25,18,1245,1050,2295,2260
3405-000,2017,7,25,19,1122,1054,2176,2295
3405-000,2017,7,25,20,762,724,1486,2176
3405-000,2017,7,25,21,613,612,1225,1486
3405-000,2017,7,25,22,457,441,898,1225
3405-000,2017,7,25,23,285,276,561,898
3405-000,2017,7,25,24,150,204,354,561
3405-000,2017,7,26,1,100,115,215,354
3405-000,2017,7,26,2,65,75,140,215
3405-000,2017,7,26,3,81,54,135,140
3405-000,2017,7,26,4,66,77,143,135
3405-000,2017,7,26,5,123,90,213,143
3405-000,2017,7,26,6,292,250,542,213
3405-000,2017,7,26,7,650,581,1231,542
3405-000,2017,7,26,8,1183,1337,2520,1231
3405-000,2017,7,26,9,1339,1274,2613,2520
3405-000,2017,7,26,10,1121,969,2090,2613
3405-000,2017,7,26,11,1147,1011,2158,2090
3405-000,2017,7,26,12,1075,1011,2086,2158
3405-000,2017,7,26,13,862,843,1705,2086
3405-000,2017,7,26,14,971,1006,1977,1705
3405-000,2017,7,26,15,1095,1070,2165,1977
3405-000,2017,7,26,16,1158,982,2140,2165
3405-000,2017,7,26,17,1170,991,2161,2140
3405-000,2017,7,26,18,1357,1102,2459,2161
3405-000,2017,7,26,19,1235,1174,2409,2459
3405-000,2017,7,26,20,798,737,1535,2409
3405-000,2017,7,26,21,599,558,1157,1535
3405-000,2017,7,26,22,418,388,806,1157
3405-000,2017,7,26,23,289,217,506,806
3405-000,2017,7,26,24,170,210,380,506
3405-000,2017,7,27,1,112,105,217,380
3405-000,2017,7,27,2,81,80,161,217
3405-000,2017,7,27,3,47,67,114,161
3405-000,2017,7,27,4,75,83,158,114
3405-000,2017,7,27,5,109,103,212,158
3405-000,2017,7,27,6,322,228,550,212
3405-000,2017,7,27,7,683,570,1253,550
3405-000,2017,7,27,8,1215,1365,2580,1253
3405-000,2017,7,27,9,1339,1297,2636,2580
3405-000,2017,7,27,10,1131,1045,2176,2636
3405-000,2017,7,27,11,1113,1040,2153,2176
3405-000,2017,7,27,12,1129,943,2072,2153
3405-000,2017,7,27,13,902,823,1725,2072
3405-000,2017,7,27,14,1044,1006,2050,1725
3405-000,2017,7,27,15,1196,1109,2305,2050
3405-000,2017,7,27,16,1088,1025,2113,2305
3405-000,2017,7,27,17,1090,1044,2134,2113
3405-000,2017,7,27,18,1229,1110,2339,2134
3405-000,2017,7,27,19,1226,1056,2282,2339
3405-000,2017,7,27,20,815,706,1521,2282
3405-000,2017,7,27,21,587,628,1215,1521
3405-000,2017,7,27,22,438,457,895,1215
3405-000,2017,7,27,23,277,259,536,895
3405-000,2017,7,27,24,181,168,349,536
3405-000,2017,7,28,1,125,126,251,349
3405-000,2017,7,28,2,78,80,158,251
3405-000,2017,7,28,3,64,59,123,158
3405-000,2017,7,28,4,62,79,141,123
3405-000,2017,7,28,5,134,87,221,141
3405-000,2017,7,28,6,275,209,484,221
3405-000,2017,7,28,7,608,543,1151,484
3405-000,2017,7,28,8,1116,1237,2353,1151
3405-000,2017,7,28,9,1299,1208,2507,2353
3405-000,2017,7,28,10,1044,932,1976,2507
3405-000,2017,7,28,11,1127,934,2061,1976
3405-000,2017,7,28,12,1095,851,1946,2061
3405-000,2017,7,28,13,952,810,1762,1946
3405-000,2017,7,28,14,1001,942,1943,1762
3405-000,2017,7,28,15,1111,1007,2118,1943
3405-000,2017,7,28,16,1133,1011,2144,2118
3405-000,2017,7,28,17,1125,897,2022,2144
3405-000,2017,7,28,18,1366,1121,2487,2022
3405-000,2017,7,28,19,1440,1088,2528,2487
3405-000,2017,7,28,20,976,832,1808,2528
3405-000,2017,7,28,21,594,613,1207,1808
3405-000,2017,7,28,22,438,361,799,1207
3405-000,2017,7,28,23,314,255,569,799
3405-000,2017,7,28,24,193,172,365,569
3405-000,2017,7,29,1,108,112,220,365
3405-000,2017,7,29,2,81,82,163,220
3405-000,2017,7,29,3,88,61,149,163
3405-000,2017,7,29,4,65,77,142,149
3405-000,2017,7,29,5,131,90,221,142
3405-000,2017,7,29,6,278,163,441,221
3405-000,2017,7,29,7,488,368,856,441
3405-000,2017,7,29,8,791,625,1416,856
3405-000,2017,7,29,9,851,740,1591,1416
3405-000,2017,7,29,10,882,900,1782,1591
3405-000,2017,7,29,11,1009,842,1851,1782
3405-000,2017,7,29,12,1049,878,1927,1851
3405-000,2017,7,29,13,889,770,1659,1927
3405-000,2017,7,29,14,829,723,1552,1659
3405-000,2017,7,29,15,859,747,1606,1552
3405-000,2017,7,29,16,946,745,1691,1606
3405-000,2017,7,29,17,774,713,1487,1691
3405-000,2017,7,29,18,909,805,1714,1487
3405-000,2017,7,29,19,828,664,1492,1714
3405-000,2017,7,29,20,508,484,992,1492
3405-000,2017,7,29,21,372,396,768,992
3405-000,2017,7,29,22,305,291,596,768
3405-000,2017,7,29,23,220,228,448,596
3405-000,2017,7,29,24,134,148,282,448
3405-000,2017,7,30,1,92,104,196,282
3405-000,2017,7,30,2,73,58,131,196
3405-000,2017,7,30,3,69,56,125,131
3405-000,2017,7,30,4,46,43,89,125
3405-000,2017,7,30,5,88,48,136,89
3405-000,2017,7,30,6,167,87,254,136
3405-000,2017,7,30,7,321,194,515,254
3405-000,2017,7,30,8,420,340,760,515
3405-000,2017,7,30,9,496,371,867,760
3405-000,2017,7,30,10,594,386,980,867
3405-000,2017,7,30,11,697,466,1163,980
3405-000,2017,7,30,12,658,524,1182,1163
3405-000,2017,7,30,13,574,514,1088,1182
3405-000,2017,7,30,14,612,533,1145,1088
3405-000,2017,7,30,15,620,619,1239,1145
3405-000,2017,7,30,16,629,624,1253,1239
3405-000,2017,7,30,17,735,647,1382,1253
3405-000,2017,7,30,18,676,640,1316,1382
3405-000,2017,7,30,19,589,604,1193,1316
3405-000,2017,7,30,20,449,541,990,1193
3405-000,2017,7,30,21,423,461,884,990
3405-000,2017,7,30,22,311,405,716,884
3405-000,2017,7,30,23,220,326,546,716
3405-000,2017,7,30,24,157,209,366,546
3405-000,2017,7,31,1,63,125,188,366
3405-000,2017,7,31,2,61,70,131,188
3405-000,2017,7,31,3,52,50,102,131
3405-000,2017,7,31,4,65,71,136,102
3405-000,2017,7,31,5,112,93,205,136
3405-000,2017,7,31,6,285,223,508,205
3405-000,2017,7,31,7,569,498,1067,508
3405-000,2017,7,31,8,966,986,1952,1067
3405-000,2017,7,31,9,1058,1082,2140,1952
3405-000,2017,7,31,10,840,702,1542,2140
3405-000,2017,7,31,11,886,722,1608,1542
3405-000,2017,7,31,12,819,700,1519,1608
3405-000,2017,7,31,13,790,719,1509,1519
3405-000,2017,7,31,14,904,833,1737,1509
3405-000,2017,7,31,15,885,790,1675,1737
3405-000,2017,7,31,16,911,800,1711,1675
3405-000,2017,7,31,17,833,814,1647,1711
3405-000,2017,7,31,18,962,791,1753,1647
3405-000,2017,7,31,19,893,790,1683,1753
3405-000,2017,7,31,20,579,579,1158,1683
3405-000,2017,7,31,21,399,427,826,1158
3405-000,2017,7,31,22,310,304,614,826
3405-000,2017,7,31,23,184,185,369,614
3405-000,2017,7,31,24,119,143,262,369
3405-000,2017,8,1,1,83,84,167,262
3405-000,2017,8,1,2,59,67,126,167
3405-000,2017,8,1,3,51,39,90,126
3405-000,2017,8,1,4,54,74,128,90
3405-000,2017,8,1,5,89,69,158,128
3405-000,2017,8,1,6,245,175,420,158
3405-000,2017,8,1,7,485,395,880,420
3405-000,2017,8,1,8,855,882,1737,880
3405-000,2017,8,1,9,956,944,1900,1737
3405-000,2017,8,1,10,980,721,1701,1900
3405-000,2017,8,1,11,944,814,1758,1701
3405-000,2017,8,1,12,1007,812,1819,1758
3405-000,2017,8,1,13,848,796,1644,1819
3405-000,2017,8,1,14,924,766,1690,1644
3405-000,2017,8,1,15,914,878,1792,1690
3405-000,2017,8,1,16,954,846,1800,1792
3405-000,2017,8,1,17,905,798,1703,1800
3405-000,2017,8,1,18,991,943,1934,1703
3405-000,2017,8,1,19,989,961,1950,1934
3405-000,2017,8,1,20,627,656,1283,1950
3405-000,2017,8,1,21,527,536,1063,1283
3405-000,2017,8,1,22,334,421,755,1063
3405-000,2017,8,1,23,245,242,487,755
3405-000,2017,8,1,24,130,172,302,487
3405-000,2017,8,2,1,87,107,194,302
3405-000,2017,8,2,2,63,90,153,194
3405-000,2017,8,2,3,59,46,105,153
3405-000,2017,8,2,4,41,69,110,105
3405-000,2017,8,2,5,110,101,211,110
3405-000,2017,8,2,6,274,189,463,211
3405-000,2017,8,2,7,505,436,941,463
3405-000,2017,8,2,8,907,889,1796,941
3405-000,2017,8,2,9,1084,946,2030,1796
3405-000,2017,8,2,10,914,731,1645,2030
3405-000,2017,8,2,11,1013,853,1866,1645
3405-000,2017,8,2,12,996,750,1746,1866
3405-000,2017,8,2,13,804,720,1524,1746
3405-000,2017,8,2,14,842,866,1708,1524
3405-000,2017,8,2,15,916,882,1798,1708
3405-000,2017,8,2,16,940,707,1647,1798
3405-000,2017,8,2,17,957,817,1774,1647
3405-000,2017,8,2,18,949,906,1855,1774
3405-000,2017,8,2,19,971,957,1928,1855
3405-000,2017,8,2,20,620,657,1277,1928
3405-000,2017,8,2,21,460,492,952,1277
3405-000,2017,8,2,22,368,389,757,952
3405-000,2017,8,2,23,299,248,547,757
3405-000,2017,8,2,24,143,206,349,547
3405-000,2017,8,3,1,86,108,194,349
3405-000,2017,8,3,2,65,81,146,194
3405-000,2017,8,3,3,66,46,112,146
3405-000,2017,8,3,4,52,62,114,112
3405-000,2017,8,3,5,133,88,221,114
3405-000,2017,8,3,6,247,224,471,221
3405-000,2017,8,3,7,603,480,1083,471
3405-000,2017,8,3,8,946,947,1893,1083
3405-000,2017,8,3,9,1111,1000,2111,1893
3405-000,2017,8,3,10,1077,908,1985,2111
3405-000,2017,8,3,11,982,842,1824,1985
3405-000,2017,8,3,12,984,907,1891,1824
3405-000,2017,8,3,13,874,721,1595,1891
3405-000,2017,8,3,14,855,853,1708,1595
3405-000,2017,8,3,15,946,874,1820,1708
3405-000,2017,8,3,16,948,811,1759,1820
3405-000,2017,8,3,17,854,901,1755,1759
3405-000,2017,8,3,18,988,989,1977,1755
3405-000,2017,8,3,19,896,886,1782,1977
3405-000,2017,8,3,20,626,653,1279,1782
3405-000,2017,8,3,21,450,571,1021,1279
3405-000,2017,8,3,22,303,362,665,1021
3405-000,2017,8,3,23,194,251,445,665
3405-000,2017,8,3,24,131,143,274,445
3405-000,2017,8,4,1,79,101,180,274
3405-000,2017,8,4,2,78,79,157,180
3405-000,2017,8,4,3,51,46,97,157
3405-000,2017,8,4,4,60,72,132,97
3405-000,2017,8,4,5,100,97,197,132
3405-000,2017,8,4,6,297,178,475,197
3405-000,2017,8,4,7,541,460,1001,475
3405-000,2017,8,4,8,997,976,1973,1001
3405-000,2017,8,4,9,1066,976,2042,1973
3405-000,2017,8,4,10,1003,862,1865,2042
3405-000,2017,8,4,11,979,911,1890,1865
3405-000,2017,8,4,12,965,802,1767,1890
3405-000,2017,8,4,13,887,770,1657,1767
3405-000,2017,8,4,14,897,898,1795,1657
3405-000,2017,8,4,15,965,868,1833,1795
3405-000,2017,8,4,16,990,852,1842,1833
3405-000,2017,8,4,17,961,927,1888,1842
3405-000,2017,8,4,18,1136,1034,2170,1888
3405-000,2017,8,4,19,1232,1004,2236,2170
3405-000,2017,8,4,20,754,776,1530,2236
3405-000,2017,8,4,21,545,609,1154,1530
3405-000,2017,8,4,22,376,458,834,1154
3405-000,2017,8,4,23,220,288,508,834
3405-000,2017,8,4,24,168,166,334,508
3405-000,2017,8,5,1,90,116,206,334
3405-000,2017,8,5,2,62,78,140,206
3405-000,2017,8,5,3,61,56,117,140
3405-000,2017,8,5,4,78,58,136,117
3405-000,2017,8,5,5,131,77,208,136
3405-000,2017,8,5,6,290,152,442,208
3405-000,2017,8,5,7,487,374,861,442
3405-000,2017,8,5,8,689,518,1207,861
3405-000,2017,8,5,9,817,681,1498,1207
3405-000,2017,8,5,10,815,756,1571,1498
3405-000,2017,8,5,11,838,699,1537,1571
3405-000,2017,8,5,12,813,768,1581,1537
3405-000,2017,8,5,13,733,719,1452,1581
3405-000,2017,8,5,14,747,710,1457,1452
3405-000,2017,8,5,15,774,756,1530,1457
3405-000,2017,8,5,16,962,772,1734,1530
3405-000,2017,8,5,17,806,772,1578,1734
3405-000,2017,8,5,18,832,781,1613,1578
3405-000,2017,8,5,19,703,729,1432,1613
3405-000,2017,8,5,20,486,667,1153,1432
3405-000,2017,8,5,21,356,423,779,1153
3405-000,2017,8,5,22,260,346,606,779
3405-000,2017,8,5,23,198,288,486,606
3405-000,2017,8,5,24,137,208,345,486
3405-000,2017,8,6,1,66,127,193,345
3405-000,2017,8,6,2,49,70,119,193
3405-000,2017,8,6,3,34,49,83,119
3405-000,2017,8,6,4,52,39,91,83
3405-000,2017,8,6,5,81,37,118,91
3405-000,2017,8,6,6,156,78,234,118
3405-000,2017,8,6,7,260,190,450,234
3405-000,2017,8,6,8,342,287,629,450
3405-000,2017,8,6,9,445,336,781,629
3405-000,2017,8,6,10,496,385,881,781
3405-000,2017,8,6,11,536,448,984,881
3405-000,2017,8,6,12,539,501,1040,984
3405-000,2017,8,6,13,511,567,1078,1040
3405-000,2017,8,6,14,534,538,1072,1078
3405-000,2017,8,6,15,600,563,1163,1072
3405-000,2017,8,6,16,632,624,1256,1163
3405-000,2017,8,6,17,613,646,1259,1256
3405-000,2017,8,6,18,584,637,1221,1259
3405-000,2017,8,6,19,518,646,1164,1221
3405-000,2017,8,6,20,395,516,911,1164
3405-000,2017,8,6,21,369,440,809,911
3405-000,2017,8,6,22,251,428,679,809
3405-000,2017,8,6,23,189,334,523,679
3405-000,2017,8,6,24,111,215,326,523
3405-000,2017,8,7,1,86,126,212,326
3405-000,2017,8,7,2,53,84,137,212
3405-000,2017,8,7,3,43,69,112,137
3405-000,2017,8,7,4,73,74,147,112
3405-000,2017,8,7,5,129,111,240,147
3405-000,2017,8,7,6,281,262,543,240
3405-000,2017,8,7,7,700,668,1368,543
3405-000,2017,8,7,8,1163,1509,2672,1368
3405-000,2017,8,7,9,1225,1226,2451,2672
3405-000,2017,8,7,10,1027,912,1939,2451
3405-000,2017,8,7,11,1065,865,1930,1939
3405-000,2017,8,7,12,1045,886,1931,1930
3405-000,2017,8,7,13,857,855,1712,1931
3405-000,2017,8,7,14,877,987,1864,1712
3405-000,2017,8,7,15,1113,967,2080,1864
3405-000,2017,8,7,16,1076,1035,2111,2080
3405-000,2017,8,7,17,1076,965,2041,2111
3405-000,2017,8,7,18,1100,1044,2144,2041
3405-000,2017,8,7,19,1048,1019,2067,2144
3405-000,2017,8,7,20,701,728,1429,2067
3405-000,2017,8,7,21,501,627,1128,1429
3405-000,2017,8,7,22,360,415,775,1128
3405-000,2017,8,7,23,225,277,502,775
3405-000,2017,8,7,24,169,155,324,502
3405-000,2017,8,8,1,83,93,176,324
3405-000,2017,8,8,2,56,61,117,176
3405-000,2017,8,8,3,78,65,143,117
3405-000,2017,8,8,4,73,79,152,143
3405-000,2017,8,8,5,111,104,215,152
3405-000,2017,8,8,6,288,228,516,215
3405-000,2017,8,8,7,636,565,1201,516
3405-000,2017,8,8,8,1101,1229,2330,1201
3405-000,2017,8,8,9,1254,1275,2529,2330
3405-000,2017,8,8,10,1132,973,2105,2529
3405-000,2017,8,8,11,1104,1050,2154,2105
3405-000,2017,8,8,12,1103,947,2050,2154
3405-000,2017,8,8,13,946,928,1874,2050
3405-000,2017,8,8,14,984,999,1983,1874
3405-000,2017,8,8,15,1167,993,2160,1983
3405-000,2017,8,8,16,1175,1094,2269,2160
3405-000,2017,8,8,17,1054,1109,2163,2269
3405-000,2017,8,8,18,1127,1067,2194,2163
3405-000,2017,8,8,19,1032,1036,2068,2194
3405-000,2017,8,8,20,708,684,1392,2068
3405-000,2017,8,8,21,564,637,1201,1392
3405-000,2017,8,8,22,355,390,745,1201
3405-000,2017,8,8,23,221,212,433,745
3405-000,2017,8,8,24,143,191,334,433
3405-000,2017,8,9,1,117,103,220,334
3405-000,2017,8,9,2,62,87,149,220
3405-000,2017,8,9,3,53,50,103,149
3405-000,2017,8,9,4,78,71,149,103
3405-000,2017,8,9,5,117,104,221,149
3405-000,2017,8,9,6,233,208,441,221
3405-000,2017,8,9,7,576,495,1071,441
3405-000,2017,8,9,8,1136,1214,2350,1071
3405-000,2017,8,9,9,1215,1248,2463,2350
3405-000,2017,8,9,10,1058,952,2010,2463
3405-000,2017,8,9,11,1014,1013,2027,2010
3405-000,2017,8,9,12,1084,942,2026,2027
3405-000,2017,8,9,13,909,845,1754,2026
3405-000,2017,8,9,14,998,1049,2047,1754
3405-000,2017,8,9,15,1102,1097,2199,2047
3405-000,2017,8,9,16,1093,1035,2128,2199
3405-000,2017,8,9,17,1060,1035,2095,2128
3405-000,2017,8,9,18,1228,1113,2341,2095
3405-000,2017,8,9,19,1109,1047,2156,2341
3405-000,2017,8,9,20,690,751,1441,2156
3405-000,2017,8,9,21,508,548,1056,1441
3405-000,2017,8,9,22,345,385,730,1056
3405-000,2017,8,9,23,211,247,458,730
3405-000,2017,8,9,24,164,164,328,458
3405-000,2017,8,10,1,92,96,188,328
3405-000,2017,8,10,2,58,67,125,188
3405-000,2017,8,10,3,57,55,112,125
3405-000,2017,8,10,4,65,68,133,112
3405-000,2017,8,10,5,156,111,267,133
3405-000,2017,8,10,6,241,219,460,267
3405-000,2017,8,10,7,628,505,1133,460
3405-000,2017,8,10,8,1037,1192,2229,1133
3405-000,2017,8,10,9,1290,1237,2527,2229
3405-000,2017,8,10,10,1033,908,1941,2527
3405-000,2017,8,10,11,1077,1000,2077,1941
3405-000,2017,8,10,12,1046,902,1948,2077
3405-000,2017,8,10,13,952,825,1777,1948
3405-000,2017,8,10,14,962,885,1847,1777
3405-000,2017,8,10,15,1068,1006,2074,1847
3405-000,2017,8,10,16,1058,1020,2078,2074
3405-000,2017,8,10,17,1060,987,2047,2078
3405-000,2017,8,10,18,1147,1028,2175,2047
3405-000,2017,8,10,19,1093,1028,2121,2175
3405-000,2017,8,10,20,693,731,1424,2121
3405-000,2017,8,10,21,550,585,1135,1424
3405-000,2017,8,10,22,418,376,794,1135
3405-000,2017,8,10,23,259,254,513,794
3405-000,2017,8,10,24,154,166,320,513
3405-000,2017,8,11,1,97,86,183,320
3405-000,2017,8,11,2,76,66,142,183
3405-000,2017,8,11,3,67,62,129,142
3405-000,2017,8,11,4,77,74,151,129
3405-000,2017,8,11,5,125,96,221,151
3405-000,2017,8,11,6,271,212,483,221
3405-000,2017,8,11,7,641,548,1189,483
3405-000,2017,8,11,8,1138,1264,2402,1189
3405-000,2017,8,11,9,1208,1235,2443,2402
3405-000,2017,8,11,10,1129,957,2086,2443
3405-000,2017,8,11,11,1166,1043,2209,2086
3405-000,2017,8,11,12,1116,979,2095,2209
3405-000,2017,8,11,13,926,866,1792,2095
3405-000,2017,8,11,14,1053,1002,2055,1792
3405-000,2017,8,11,15,1088,1029,2117,2055
3405-000,2017,8,11,16,998,1038,2036,2117
3405-000,2017,8,11,17,813,994,1807,2036
3405-000,2017,8,11,18,897,1136,2033,1807
3405-000,2017,8,11,19,1048,1160,2208,2033
3405-000,2017,8,11,20,789,838,1627,2208
3405-000,2017,8,11,21,572,606,1178,1627
3405-000,2017,8,11,22,447,402,849,1178
3405-000,2017,8,11,23,289,266,555,849
3405-000,2017,8,11,24,162,191,353,555
3405-000,2017,8,12,1,112,109,221,353
3405-000,2017,8,12,2,59,75,134,221
3405-000,2017,8,12,3,70,69,139,134
3405-000,2017,8,12,4,62,69,131,139
3405-000,2017,8,12,5,114,83,197,131
3405-000,2017,8,12,6,266,176,442,197
3405-000,2017,8,12,7,554,399,953,442
3405-000,2017,8,12,8,827,703,1530,953
3405-000,2017,8,12,9,995,782,1777,1530
3405-000,2017,8,12,10,961,791,1752,1777
3405-000,2017,8,12,11,1007,834,1841,1752
3405-000,2017,8,12,12,948,1050,1998,1841
3405-000,2017,8,12,13,841,1010,1851,1998
3405-000,2017,8,12,14,824,905,1729,1851
3405-000,2017,8,12,15,838,865,1703,1729
3405-000,2017,8,12,16,848,861,1709,1703
3405-000,2017,8,12,17,764,827,1591,1709
3405-000,2017,8,12,18,970,919,1889,1591
3405-000,2017,8,12,19,727,660,1387,1889
3405-000,2017,8,12,20,493,513,1006,1387
3405-000,2017,8,12,21,361,415,776,1006
3405-000,2017,8,12,22,295,295,590,776
3405-000,2017,8,12,23,224,204,428,590
3405-000,2017,8,12,24,137,182,319,428
3405-000,2017,8,13,1,87,111,198,319
3405-000,2017,8,13,2,71,44,115,198
3405-000,2017,8,13,3,46,61,107,115
3405-000,2017,8,13,4,49,45,94,107
3405-000,2017,8,13,5,73,44,117,94
3405-000,2017,8,13,6,143,81,224,117
3405-000,2017,8,13,7,286,168,454,224
3405-000,2017,8,13,8,363,309,672,454
3405-000,2017,8,13,9,445,370,815,672
3405-000,2017,8,13,10,544,386,930,815
3405-000,2017,8,13,11,615,456,1071,930
3405-000,2017,8,13,12,600,494,1094,1071
3405-000,2017,8,13,13,513,521,1034,1094
3405-000,2017,8,13,14,534,560,1094,1034
3405-000,2017,8,13,15,624,599,1223,1094
3405-000,2017,8,13,16,612,641,1253,1223
3405-000,2017,8,13,17,626,657,1283,1253
3405-000,2017,8,13,18,580,716,1296,1283
3405-000,2017,8,13,19,505,605,1110,1296
3405-000,2017,8,13,20,435,542,977,1110
3405-000,2017,8,13,21,345,479,824,977
3405-000,2017,8,13,22,279,397,676,824
3405-000,2017,8,13,23,204,310,514,676
3405-000,2017,8,13,24,134,211,345,514
3405-000,2017,8,14,1,65,107,172,345
3405-000,2017,8,14,2,54,59,113,172
3405-000,2017,8,14,3,41,50,91,113
3405-000,2017,8,14,4,56,77,133,91
3405-000,2017,8,14,5,114,102,216,133
3405-000,2017,8,14,6,271,226,497,216
3405-000,2017,8,14,7,622,599,1221,497
3405-000,2017,8,14,8,1034,1266,2300,1221
3405-000,2017,8,14,9,1083,1169,2252,2300
3405-000,2017,8,14,10,998,870,1868,2252
3405-000,2017,8,14,11,1026,957,1983,1868
3405-000,2017,8,14,12,940,806,1746,1983
3405-000,2017,8,14,13,851,831,1682,1746
3405-000,2017,8,14,14,939,884,1823,1682
3405-000,2017,8,14,15,1049,924,1973,1823
3405-000,2017,8,14,16,1006,1019,2025,1973
3405-000,2017,8,14,17,1043,1091,2134,2025
3405-000,2017,8,14,18,1092,1084,2176,2134
3405-000,2017,8,14,19,1111,1060,2171,2176
3405-000,2017,8,14,20,683,740,1423,2171
3405-000,2017,8,14,21,554,560,1114,1423
3405-000,2017,8,14,22,324,368,692,1114
3405-000,2017,8,14,23,225,224,449,692
3405-000,2017,8,14,24,120,192,312,449
3405-000,2017,8,15,1,82,99,181,312
3405-000,2017,8,15,2,49,67,116,181
3405-000,2017,8,15,3,54,61,115,116
3405-000,2017,8,15,4,63,54,117,115
3405-000,2017,8,15,5,71,59,130,117
3405-000,2017,8,15,6,153,151,304,130
3405-000,2017,8,15,7,391,293,684,304
3405-000,2017,8,15,8,624,544,1168,684
3405-000,2017,8,15,9,720,597,1317,1168
3405-000,2017,8,15,10,643,560,1203,1317
3405-000,2017,8,15,11,707,614,1321,1203
3405-000,2017,8,15,12,689,628,1317,1321
3405-000,2017,8,15,13,640,620,1260,1317
3405-000,2017,8,15,14,614,607,1221,1260
3405-000,2017,8,15,15,659,652,1311,1221
3405-000,2017,8,15,16,635,703,1338,1311
3405-000,2017,8,15,17,609,637,1246,1338
3405-000,2017,8,15,18,636,757,1393,1246
3405-000,2017,8,15,19,527,654,1181,1393
3405-000,2017,8,15,20,379,475,854,1181
3405-000,2017,8,15,21,304,408,712,854
3405-000,2017,8,15,22,206,270,476,712
3405-000,2017,8,15,23,164,202,366,476
3405-000,2017,8,15,24,110,131,241,366
3405-000,2017,8,16,1,66,99,165,241
3405-000,2017,8,16,2,55,71,126,165
3405-000,2017,8,16,3,47,40,87,126
3405-000,2017,8,16,4,52,67,119,87
3405-000,2017,8,16,5,130,69,199,119
3405-000,2017,8,16,6,244,229,473,199
3405-000,2017,8,16,7,633,556,1189,473
3405-000,2017,8,16,8,1129,1403,2532,1189
3405-000,2017,8,16,9,1198,1307,2505,2532
3405-000,2017,8,16,10,1045,988,2033,2505
3405-000,2017,8,16,11,1133,980,2113,2033
3405-000,2017,8,16,12,1114,900,2014,2113
3405-000,2017,8,16,13,974,884,1858,2014
3405-000,2017,8,16,14,995,996,1991,1858
3405-000,2017,8,16,15,1122,979,2101,1991
3405-000,2017,8,16,16,1127,1024,2151,2101
3405-000,2017,8,16,17,1041,1006,2047,2151
3405-000,2017,8,16,18,1218,1094,2312,2047
3405-000,2017,8,16,19,1058,1041,2099,2312
3405-000,2017,8,16,20,750,786,1536,2099
3405-000,2017,8,16,21,510,549,1059,1536
3405-000,2017,8,16,22,372,420,792,1059
3405-000,2017,8,16,23,213,216,429,792
3405-000,2017,8,16,24,133,148,281,429
3405-000,2017,8,17,1,90,116,206,281
3405-000,2017,8,17,2,71,74,145,206
3405-000,2017,8,17,3,60,67,127,145
3405-000,2017,8,17,4,88,79,167,127
3405-000,2017,8,17,5,131,102,233,167
3405-000,2017,8,17,6,239,211,450,233
3405-000,2017,8,17,7,635,499,1134,450
3405-000,2017,8,17,8,1103,1278,2381,1134
3405-000,2017,8,17,9,1277,1308,2585,2381
3405-000,2017,8,17,10,1094,974,2068,2585
3405-000,2017,8,17,11,1120,1051,2171,2068
3405-000,2017,8,17,12,1103,877,1980,2171
3405-000,2017,8,17,13,880,820,1700,1980
3405-000,2017,8,17,14,965,990,1955,1700
3405-000,2017,8,17,15,1096,1149,2245,1955
3405-000,2017,8,17,16,1154,995,2149,2245
3405-000,2017,8,17,17,1096,1048,2144,2149
3405-000,2017,8,17,18,1114,1082,2196,2144
3405-000,2017,8,17,19,1045,1042,2087,2196
3405-000,2017,8,17,20,709,705,1414,2087
3405-000,2017,8,17,21,563,618,1181,1414
3405-000,2017,8,17,22,351,431,782,1181
3405-000,2017,8,17,23,242,242,484,782
3405-000,2017,8,17,24,162,170,332,484
3405-000,2017,8,18,1,105,103,208,332
3405-000,2017,8,18,2,66,68,134,208
3405-000,2017,8,18,3,54,64,118,134
3405-000,2017,8,18,4,76,73,149,118
3405-000,2017,8,18,5,135,120,255,149
3405-000,2017,8,18,6,274,209,483,255
3405-000,2017,8,18,7,614,590,1204,483
3405-000,2017,8,18,8,1104,1248,2352,1204
3405-000,2017,8,18,9,1273,1275,2548,2352
3405-000,2017,8,18,10,1101,1025,2126,2548
3405-000,2017,8,18,11,1146,1016,2162,2126
3405-000,2017,8,18,12,1078,967,2045,2162
3405-000,2017,8,18,13,957,839,1796,2045
3405-000,2017,8,18,14,1036,959,1995,1796
3405-000,2017,8,18,15,1181,964,2145,1995
3405-000,2017,8,18,16,1142,1063,2205,2145
3405-000,2017,8,18,17,1162,1017,2179,2205
3405-000,2017,8,18,18,1328,1146,2474,2179
3405-000,2017,8,18,19,1354,1259,2613,2474
3405-000,2017,8,18,20,856,801,1657,2613
3405-000,2017,8,18,21,661,613,1274,1657
3405-000,2017,8,18,22,471,443,914,1274
3405-000,2017,8,18,23,279,260,539,914
3405-000,2017,8,18,24,177,178,355,539
3405-000,2017,8,19,1,113,104,217,355
3405-000,2017,8,19,2,72,79,151,217
3405-000,2017,8,19,3,72,69,141,151
3405-000,2017,8,19,4,85,85,170,141
3405-000,2017,8,19,5,119,74,193,170
3405-000,2017,8,19,6,278,179,457,193
3405-000,2017,8,19,7,565,409,974,457
3405-000,2017,8,19,8,761,616,1377,974
3405-000,2017,8,19,9,908,817,1725,1377
3405-000,2017,8,19,10,914,720,1634,1725
3405-000,2017,8,19,11,958,804,1762,1634
3405-000,2017,8,19,12,911,754,1665,1762
3405-000,2017,8,19,13,801,745,1546,1665
3405-000,2017,8,19,14,798,780,1578,1546
3405-000,2017,8,19,15,863,711,1574,1578
3405-000,2017,8,19,16,864,810,1674,1574
3405-000,2017,8,19,17,810,838,1648,1674
3405-000,2017,8,19,18,938,855,1793,1648
3405-000,2017,8,19,19,753,730,1483,1793
3405-000,2017,8,19,20,511,560,1071,1483
3405-000,2017,8,19,21,346,348,694,1071
3405-000,2017,8,19,22,314,313,627,694
3405-000,2017,8,19,23,156,222,378,627
3405-000,2017,8,19,24,102,159,261,378
3405-000,2017,8,20,1,101,86,187,261
3405-000,2017,8,20,2,54,49,103,187
3405-000,2017,8,20,3,56,40,96,103
3405-000,2017,8,20,4,36,36,72,96
3405-000,2017,8,20,5,51,48,99,72
3405-000,2017,8,20,6,137,66,203,99
3405-000,2017,8,20,7,175,140,315,203
3405-000,2017,8,20,8,286,249,535,315
3405-000,2017,8,20,9,348,323,671,535
3405-000,2017,8,20,10,343,323,666,671
3405-000,2017,8,20,11,448,390,838,666
3405-000,2017,8,20,12,485,409,894,838
3405-000,2017,8,20,13,468,542,1010,894
3405-000,2017,8,20,14,511,550,1061,1010
3405-000,2017,8,20,15,607,638,1245,1061
3405-000,2017,8,20,16,578,620,1198,1245
3405-000,2017,8,20,17,536,667,1203,1198
3405-000,2017,8,20,18,532,557,1089,1203
3405-000,2017,8,20,19,438,605,1043,1089
3405-000,2017,8,20,20,380,491,871,1043
3405-000,2017,8,20,21,321,403,724,871
3405-000,2017,8,20,22,228,317,545,724
3405-000,2017,8,20,23,158,269,427,545
3405-000,2017,8,20,24,98,165,263,427
3405-000,2017,8,21,1,56,100,156,263
3405-000,2017,8,21,2,56,69,125,156
3405-000,2017,8,21,3,45,40,85,125
3405-000,2017,8,21,4,72,65,137,85
3405-000,2017,8,21,5,111,96,207,137
3405-000,2017,8,21,6,263,229,492,207
3405-000,2017,8,21,7,658,661,1319,492
3405-000,2017,8,21,8,1159,1503,2662,1319
3405-000,2017,8,21,9,1187,1339,2526,2662
3405-000,2017,8,21,10,931,936,1867,2526
3405-000,2017,8,21,11,1021,968,1989,1867
3405-000,2017,8,21,12,1001,1327,2328,1989
3405-000,2017,8,21,13,938,755,1693,2328
3405-000,2017,8,21,14,957,899,1856,1693
3405-000,2017,8,21,15,1143,1022,2165,1856
3405-000,2017,8,21,16,1134,1015,2149,2165
3405-000,2017,8,21,17,959,967,1926,2149
3405-000,2017,8,21,18,980,956,1936,1926
3405-000,2017,8,21,19,1050,1043,2093,1936
3405-000,2017,8,21,20,654,688,1342,2093
3405-000,2017,8,21,21,565,642,1207,1342
3405-000,2017,8,21,22,363,377,740,1207
3405-000,2017,8,21,23,212,229,441,740
3405-000,2017,8,21,24,118,134,252,441
3405-000,2017,8,22,1,100,85,185,252
3405-000,2017,8,22,2,67,71,138,185
3405-000,2017,8,22,3,49,55,104,138
3405-000,2017,8,22,4,72,81,153,104
3405-000,2017,8,22,5,136,104,240,153
3405-000,2017,8,22,6,265,223,488,240
3405-000,2017,8,22,7,654,553,1207,488
3405-000,2017,8,22,8,1124,1336,2460,1207
3405-000,2017,8,22,9,1291,1275,2566,2460
3405-000,2017,8,22,10,1063,930,1993,2566
3405-000,2017,8,22,11,1105,976,2081,1993
3405-000,2017,8,22,12,1043,955,1998,2081
3405-000,2017,8,22,13,894,847,1741,1998
3405-000,2017,8,22,14,1045,1042,2087,1741
3405-000,2017,8,22,15,1093,995,2088,2087
3405-000,2017,8,22,16,1180,984,2164,2088
3405-000,2017,8,22,17,1049,1001,2050,2164
3405-000,2017,8,22,18,1148,1075,2223,2050
3405-000,2017,8,22,19,1074,1088,2162,2223
3405-000,2017,8,22,20,689,722,1411,2162
3405-000,2017,8,22,21,565,667,1232,1411
3405-000,2017,8,22,22,353,436,789,1232
3405-000,2017,8,22,23,248,227,475,789
3405-000,2017,8,22,24,134,152,286,475
3405-000,2017,8,23,1,93,86,179,286
3405-000,2017,8,23,2,79,65,144,179
3405-000,2017,8,23,3,54,56,110,144
3405-000,2017,8,23,4,69,82,151,110
3405-000,2017,8,23,5,119,84,203,151
3405-000,2017,8,23,6,236,206,442,203
3405-000,2017,8,23,7,578,479,1057,442
3405-000,2017,8,23,8,1118,1198,2316,1057
3405-000,2017,8,23,9,1244,1265,2509,2316
3405-000,2017,8,23,10,1040,927,1967,2509
3405-000,2017,8,23,11,1086,1014,2100,1967
3405-000,2017,8,23,12,1023,873,1896,2100
3405-000,2017,8,23,13,896,801,1697,1896
3405-000,2017,8,23,14,980,911,1891,1697
3405-000,2017,8,23,15,1097,1018,2115,1891
3405-000,2017,8,23,16,1148,963,2111,2115
3405-000,2017,8,23,17,1085,946,2031,2111
3405-000,2017,8,23,18,1176,1100,2276,2031
3405-000,2017,8,23,19,1082,1056,2138,2276
3405-000,2017,8,23,20,687,679,1366,2138
3405-000,2017,8,23,21,505,535,1040,1366
3405-000,2017,8,23,22,363,369,732,1040
3405-000,2017,8,23,23,227,220,447,732
3405-000,2017,8,23,24,150,155,305,447
3405-000,2017,8,24,1,88,105,193,305
3405-000,2017,8,24,2,67,65,132,193
3405-000,2017,8,24,3,51,55,106,132
3405-000,2017,8,24,4,81,93,174,106
3405-000,2017,8,24,5,130,96,226,174
3405-000,2017,8,24,6,282,202,484,226
3405-000,2017,8,24,7,595,505,1100,484
3405-000,2017,8,24,8,1086,1249,2335,1100
3405-000,2017,8,24,9,1237,1295,2532,2335
3405-000,2017,8,24,10,1057,924,1981,2532
3405-000,2017,8,24,11,1097,969,2066,1981
3405-000,2017,8,24,12,974,882,1856,2066
3405-000,2017,8,24,13,893,770,1663,1856
3405-000,2017,8,24,14,988,940,1928,1663
3405-000,2017,8,24,15,1081,993,2074,1928
3405-000,2017,8,24,16,1042,932,1974,2074
3405-000,2017,8,24,17,935,1002,1937,1974
3405-000,2017,8,24,18,1116,1105,2221,1937
3405-000,2017,8,24,19,1100,1058,2158,2221
3405-000,2017,8,24,20,665,653,1318,2158
3405-000,2017,8,24,21,519,531,1050,1318
3405-000,2017,8,24,22,361,365,726,1050
3405-000,2017,8,24,23,223,200,423,726
3405-000,2017,8,24,24,151,163,314,423
3405-000,2017,8,25,1,87,93,180,314
3405-000,2017,8,25,2,99,82,181,180
3405-000,2017,8,25,3,49,59,108,181
3405-000,2017,8,25,4,78,84,162,108
3405-000,2017,8,25,5,126,97,223,162
3405-000,2017,8,25,6,237,221,458,223
3405-000,2017,8,25,7,605,541,1146,458
3405-000,2017,8,25,8,1183,1303,2486,1146
3405-000,2017,8,25,9,1299,1344,2643,2486
3405-000,2017,8,25,10,1101,989,2090,2643
3405-000,2017,8,25,11,1176,1030,2206,2090
3405-000,2017,8,25,12,1103,920,2023,2206
3405-000,2017,8,25,13,962,835,1797,2023
3405-000,2017,8,25,14,1030,950,1980,1797
3405-000,2017,8,25,15,1089,1088,2177,1980
3405-000,2017,8,25,16,1191,1041,2232,2177
3405-000,2017,8,25,17,1126,1048,2174,2232
3405-000,2017,8,25,18,1398,1217,2615,2174
3405-000,2017,8,25,19,1437,1285,2722,2615
3405-000,2017,8,25,20,937,853,1790,2722
3405-000,2017,8,25,21,684,692,1376,1790
3405-000,2017,8,25,22,488,442,930,1376
3405-000,2017,8,25,23,282,274,556,930
3405-000,2017,8,25,24,172,168,340,556
3405-000,2017,8,26,1,125,134,259,340
3405-000,2017,8,26,2,68,81,149,259
3405-000,2017,8,26,3,78,71,149,149
3405-000,2017,8,26,4,60,70,130,149
3405-000,2017,8,26,5,128,106,234,130
3405-000,2017,8,26,6,271,189,460,234
3405-000,2017,8,26,7,596,375,971,460
3405-000,2017,8,26,8,769,704,1473,971
3405-000,2017,8,26,9,944,767,1711,1473
3405-000,2017,8,26,10,948,796,1744,1711
3405-000,2017,8,26,11,1006,851,1857,1744
3405-000,2017,8,26,12,999,841,1840,1857
3405-000,2017,8,26,13,844,802,1646,1840
3405-000,2017,8,26,14,811,875,1686,1646
3405-000,2017,8,26,15,887,784,1671,1686
3405-000,2017,8,26,16,965,868,1833,1671
3405-000,2017,8,26,17,919,767,1686,1833
3405-000,2017,8,26,18,1009,896,1905,1686
3405-000,2017,8,26,19,826,782,1608,1905
3405-000,2017,8,26,20,624,594,1218,1608
3405-000,2017,8,26,21,380,455,835,1218
3405-000,2017,8,26,22,307,356,663,835
3405-000,2017,8,26,23,217,237,454,663
3405-000,2017,8,26,24,133,184,317,454
3405-000,2017,8,27,1,96,108,204,317
3405-000,2017,8,27,2,38,77,115,204
3405-000,2017,8,27,3,45,39,84,115
3405-000,2017,8,27,4,45,32,77,84
3405-000,2017,8,27,5,79,46,125,77
3405-000,2017,8,27,6,169,91,260,125
3405-000,2017,8,27,7,272,217,489,260
3405-000,2017,8,27,8,353,271,624,489
3405-000,2017,8,27,9,486,372,858,624
3405-000,2017,8,27,10,509,436,945,858
3405-000,2017,8,27,11,555,537,1092,945
3405-000,2017,8,27,12,584,568,1152,1092
3405-000,2017,8,27,13,518,551,1069,1152
3405-000,2017,8,27,14,567,631,1198,1069
3405-000,2017,8,27,15,711,662,1373,1198
3405-000,2017,8,27,16,784,686,1470,1373
3405-000,2017,8,27,17,783,719,1502,1470
3405-000,2017,8,27,18,813,714,1527,1502
3405-000,2017,8,27,19,722,698,1420,1527
3405-000,2017,8,27,20,609,610,1219,1420
3405-000,2017,8,27,21,621,561,1182,1219
3405-000,2017,8,27,22,387,576,963,1182
3405-000,2017,8,27,23,213,372,585,963
3405-000,2017,8,27,24,133,234,367,585
3405-000,2017,8,28,1,72,112,184,367
3405-000,2017,8,28,2,40,84,124,184
3405-000,2017,8,28,3,60,55,115,124
3405-000,2017,8,28,4,56,77,133,115
3405-000,2017,8,28,5,115,124,239,133
3405-000,2017,8,28,6,310,278,588,239
3405-000,2017,8,28,7,733,780,1513,588
3405-000,2017,8,28,8,1257,1808,3065,1513
3405-000,2017,8,28,9,1288,1509,2797,3065
3405-000,2017,8,28,10,1134,1032,2166,2797
3405-000,2017,8,28,11,1181,1039,2220,2166
3405-000,2017,8,28,12,1152,970,2122,2220
3405-000,2017,8,28,13,974,916,1890,2122
3405-000,2017,8,28,14,1093,1054,2147,1890
3405-000,2017,8,28,15,1195,1093,2288,2147
3405-000,2017,8,28,16,1185,1076,2261,2288
3405-000,2017,8,28,17,1140,1068,2208,2261
3405-000,2017,8,28,18,1222,1154,2376,2208
3405-000,2017,8,28,19,1071,917,1988,2376
3405-000,2017,8,28,20,786,763,1549,1988
3405-000,2017,8,28,21,584,577,1161,1549
3405-000,2017,8,28,22,338,408,746,1161
3405-000,2017,8,28,23,243,228,471,746
3405-000,2017,8,28,24,112,163,275,471
3405-000,2017,8,29,1,93,95,188,275
3405-000,2017,8,29,2,69,76,145,188
3405-000,2017,8,29,3,53,61,114,145
3405-000,2017,8,29,4,98,74,172,114
3405-000,2017,8,29,5,132,116,248,172
3405-000,2017,8,29,6,244,218,462,248
3405-000,2017,8,29,7,673,588,1261,462
3405-000,2017,8,29,8,1109,1461,2570,1261
3405-000,2017,8,29,9,1291,1445,2736,2570
3405-000,2017,8,29,10,1189,1037,2226,2736
3405-000,2017,8,29,11,1157,981,2138,2226
3405-000,2017,8,29,12,1173,965,2138,2138
3405-000,2017,8,29,13,928,890,1818,2138
3405-000,2017,8,29,14,1011,1027,2038,1818
3405-000,2017,8,29,15,1198,1201,2399,2038
3405-000,2017,8,29,16,1157,1048,2205,2399
3405-000,2017,8,29,17,1158,1030,2188,2205
3405-000,2017,8,29,18,1297,1150,2447,2188
3405-000,2017,8,29,19,1141,1066,2207,2447
3405-000,2017,8,29,20,787,768,1555,2207
3405-000,2017,8,29,21,585,669,1254,1555
3405-000,2017,8,29,22,420,408,828,1254
3405-000,2017,8,29,23,266,247,513,828
3405-000,2017,8,29,24,136,169,305,513
3405-000,2017,8,30,1,103,96,199,305
3405-000,2017,8,30,2,75,82,157,199
3405-000,2017,8,30,3,51,65,116,157
3405-000,2017,8,30,4,73,74,147,116
3405-000,2017,8,30,5,139,96,235,147
3405-000,2017,8,30,6,281,227,508,235
3405-000,2017,8,30,7,648,599,1247,508
3405-000,2017,8,30,8,1174,1491,2665,1247
3405-000,2017,8,30,9,1349,1490,2839,2665
3405-000,2017,8,30,10,1159,989,2148,2839
3405-000,2017,8,30,11,1185,1096,2281,2148
3405-000,2017,8,30,12,1147,1011,2158,2281
3405-000,2017,8,30,13,926,945,1871,2158
3405-000,2017,8,30,14,1077,1091,2168,1871
3405-000,2017,8,30,15,1253,1063,2316,2168
3405-000,2017,8,30,16,1262,1140,2402,2316
3405-000,2017,8,30,17,1170,1053,2223,2402
3405-000,2017,8,30,18,1415,1233,2648,2223
3405-000,2017,8,30,19,1289,1090,2379,2648
3405-000,2017,8,30,20,823,771,1594,2379
3405-000,2017,8,30,21,555,548,1103,1594
3405-000,2017,8,30,22,436,441,877,1103
3405-000,2017,8,30,23,235,217,452,877
3405-000,2017,8,30,24,118,167,285,452
3405-000,2017,8,31,1,113,113,226,285
3405-000,2017,8,31,2,62,64,126,226
3405-000,2017,8,31,3,65,60,125,126
3405-000,2017,8,31,4,95,74,169,125
3405-000,2017,8,31,5,156,102,258,169
3405-000,2017,8,31,6,266,218,484,258
3405-000,2017,8,31,7,661,643,1304,484
3405-000,2017,8,31,8,1167,1484,2651,1304
3405-000,2017,8,31,9,1356,1446,2802,2651
3405-000,2017,8,31,10,1159,1050,2209,2802
3405-000,2017,8,31,11,1082,1135,2217,2209
3405-000,2017,8,31,12,1069,1000,2069,2217
3405-000,2017,8,31,13,921,879,1800,2069
3405-000,2017,8,31,14,1004,976,1980,1800
3405-000,2017,8,31,15,1172,1136,2308,1980
3405-000,2017,8,31,16,1168,1047,2215,2308
3405-000,2017,8,31,17,1182,1111,2293,2215
3405-000,2017,8,31,18,1281,1129,2410,2293
3405-000,2017,8,31,19,1222,1132,2354,2410
3405-000,2017,8,31,20,804,761,1565,2354
3405-000,2017,8,31,21,643,612,1255,1565
3405-000,2017,8,31,22,411,436,847,1255
3405-000,2017,8,31,23,258,269,527,847
3405-000,2017,8,31,24,164,182,346,527
3405-000,2017,9,1,1,121,100,221,346
3405-000,2017,9,1,2,65,97,162,221
3405-000,2017,9,1,3,53,67,120,162
3405-000,2017,9,1,4,78,78,156,120
3405-000,2017,9,1,5,125,109,234,156
3405-000,2017,9,1,6,303,230,533,234
3405-000,2017,9,1,7,649,635,1284,533
3405-000,2017,9,1,8,1200,1491,2691,1284
3405-000,2017,9,1,9,1311,1427,2738,2691
3405-000,2017,9,1,10,1120,985,2105,2738
3405-000,2017,9,1,11,1196,1013,2209,2105
3405-000,2017,9,1,12,1151,1006,2157,2209
3405-000,2017,9,1,13,996,952,1948,2157
3405-000,2017,9,1,14,1112,1023,2135,1948
3405-000,2017,9,1,15,1242,1133,2375,2135
3405-000,2017,9,1,16,1318,1152,2470,2375
3405-000,2017,9,1,17,1262,1085,2347,2470
3405-000,2017,9,1,18,1584,1232,2816,2347
3405-000,2017,9,1,19,1584,1289,2873,2816
3405-000,2017,9,1,20,1087,959,2046,2873
3405-000,2017,9,1,21,719,787,1506,2046
3405-000,2017,9,1,22,499,437,936,1506
3405-000,2017,9,1,23,285,270,555,936
3405-000,2017,9,1,24,183,170,353,555
3405-000,2017,9,2,1,125,93,218,353
3405-000,2017,9,2,2,91,75,166,218
3405-000,2017,9,2,3,75,80,155,166
3405-000,2017,9,2,4,72,73,145,155
3405-000,2017,9,2,5,153,85,238,145
3405-000,2017,9,2,6,289,189,478,238
3405-000,2017,9,2,7,510,442,952,478
3405-000,2017,9,2,8,857,733,1590,952
3405-000,2017,9,2,9,960,895,1855,1590
3405-000,2017,9,2,10,899,796,1695,1855
3405-000,2017,9,2,11,965,877,1842,1695
3405-000,2017,9,2,12,1032,848,1880,1842
3405-000,2017,9,2,13,852,854,1706,1880
3405-000,2017,9,2,14,929,909,1838,1706
3405-000,2017,9,2,15,948,833,1781,1838
3405-000,2017,9,2,16,996,859,1855,1781
3405-000,2017,9,2,17,983,808,1791,1855
3405-000,2017,9,2,18,1086,1046,2132,1791
3405-000,2017,9,2,19,938,916,1854,2132
3405-000,2017,9,2,20,601,688,1289,1854
3405-000,2017,9,2,21,410,488,898,1289
3405-000,2017,9,2,22,288,381,669,898
3405-000,2017,9,2,23,202,228,430,669
3405-000,2017,9,2,24,135,177,312,430
3405-000,2017,9,3,1,99,85,184,312
3405-000,2017,9,3,2,53,69,122,184
3405-000,2017,9,3,3,46,49,95,122
3405-000,2017,9,3,4,50,55,105,95
3405-000,2017,9,3,5,69,45,114,105
3405-000,2017,9,3,6,126,98,224,114
3405-000,2017,9,3,7,282,228,510,224
3405-000,2017,9,3,8,368,314,682,510
3405-000,2017,9,3,9,468,369,837,682
3405-000,2017,9,3,10,529,421,950,837
3405-000,2017,9,3,11,681,523,1204,950
3405-000,2017,9,3,12,583,554,1137,1204
3405-000,2017,9,3,13,607,604,1211,1137
3405-000,2017,9,3,14,650,664,1314,1211
3405-000,2017,9,3,15,676,686,1362,1314
3405-000,2017,9,3,16,747,663,1410,1362
3405-000,2017,9,3,17,767,842,1609,1410
3405-000,2017,9,3,18,773,772,1545,1609
3405-000,2017,9,3,19,768,721,1489,1545
3405-000,2017,9,3,20,610,648,1258,1489
3405-000,2017,9,3,21,468,661,1129,1258
3405-000,2017,9,3,22,346,501,847,1129
3405-000,2017,9,3,23,223,326,549,847
3405-000,2017,9,3,24,146,211,357,549
3405-000,2017,9,4,1,67,126,193,357
3405-000,2017,9,4,2,64,72,136,193
3405-000,2017,9,4,3,58,60,118,136
3405-000,2017,9,4,4,71,75,146,118
3405-000,2017,9,4,5,143,109,252,146
3405-000,2017,9,4,6,289,304,593,252
3405-000,2017,9,4,7,749,782,1531,593
3405-000,2017,9,4,8,1231,1778,3009,1531
3405-000,2017,9,4,9,1310,1562,2872,3009
3405-000,2017,9,4,10,1121,1061,2182,2872
3405-000,2017,9,4,11,1181,989,2170,2182
3405-000,2017,9,4,12,1116,953,2069,2170
3405-000,2017,9,4,13,894,945,1839,2069
3405-000,2017,9,4,14,1041,1102,2143,1839
3405-000,2017,9,4,15,1154,1131,2285,2143
3405-000,2017,9,4,16,1184,1091,2275,2285
3405-000,2017,9,4,17,1173,1013,2186,2275
3405-000,2017,9,4,18,1331,1178,2509,2186
3405-000,2017,9,4,19,1223,1168,2391,2509
3405-000,2017,9,4,20,773,809,1582,2391
3405-000,2017,9,4,21,629,626,1255,1582
3405-000,2017,9,4,22,435,428,863,1255
3405-000,2017,9,4,23,255,242,497,863
3405-000,2017,9,4,24,132,159,291,497
3405-000,2017,9,5,1,87,119,206,291
3405-000,2017,9,5,2,64,76,140,206
3405-000,2017,9,5,3,74,61,135,140
3405-000,2017,9,5,4,85,81,166,135
3405-000,2017,9,5,5,115,103,218,166
3405-000,2017,9,5,6,269,217,486,218
3405-000,2017,9,5,7,651,675,1326,486
3405-000,2017,9,5,8,1207,1471,2678,1326
3405-000,2017,9,5,9,1390,1462,2852,2678
3405-000,2017,9,5,10,1187,1091,2278,2852
3405-000,2017,9,5,11,1302,1119,2421,2278
3405-000,2017,9,5,12,1188,1012,2200,2421
3405-000,2017,9,5,13,1033,925,1958,2200
3405-000,2017,9,5,14,1034,990,2024,1958
3405-000,2017,9,5,15,1224,1109,2333,2024
3405-000,2017,9,5,16,1254,1090,2344,2333
3405-000,2017,9,5,17,1211,1077,2288,2344
3405-000,2017,9,5,18,1344,1128,2472,2288
3405-000,2017,9,5,19,1174,1144,2318,2472
3405-000,2017,9,5,20,773,744,1517,2318
3405-000,2017,9,5,21,605,615,1220,1517
3405-000,2017,9,5,22,397,428,825,1220
3405-000,2017,9,5,23,248,218,466,825
3405-000,2017,9,5,24,161,154,315,466
3405-000,2017,9,6,1,104,126,230,315
3405-000,2017,9,6,2,70,78,148,230
3405-000,2017,9,6,3,62,59,121,148
3405-000,2017,9,6,4,81,75,156,121
3405-000,2017,9,6,5,128,95,223,156
3405-000,2017,9,6,6,253,177,430,223
3405-000,2017,9,6,7,632,561,1193,430
3405-000,2017,9,6,8,1167,1516,2683,1193
3405-000,2017,9,6,9,1329,1475,2804,2683
3405-000,2017,9,6,10,1154,1044,2198,2804
3405-000,2017,9,6,11,1101,1040,2141,2198
3405-000,2017,9,6,12,1121,978,2099,2141
3405-000,2017,9,6,13,932,860,1792,2099
3405-000,2017,9,6,14,958,1058,2016,1792
3405-000,2017,9,6,15,1148,1037,2185,2016
3405-000,2017,9,6,16,1228,1044,2272,2185
3405-000,2017,9,6,17,1149,1032,2181,2272
3405-000,2017,9,6,18,1324,1098,2422,2181
3405-000,2017,9,6,19,1193,1080,2273,2422
3405-000,2017,9,6,20,768,663,1431,2273
3405-000,2017,9,6,21,500,558,1058,1431
3405-000,2017,9,6,22,388,345,733,1058
3405-000,2017,9,6,23,257,256,513,733
3405-000,2017,9,6,24,141,148,289,513
3405-000,2017,9,7,1,86,102,188,289
3405-000,2017,9,7,2,76,82,158,188
3405-000,2017,9,7,3,80,56,136,158
3405-000,2017,9,7,4,83,88,171,136
3405-000,2017,9,7,5,142,97,239,171
3405-000,2017,9,7,6,266,206,472,239
3405-000,2017,9,7,7,672,634,1306,472
3405-000,2017,9,7,8,1221,1553,2774,1306
3405-000,2017,9,7,9,1331,1482,2813,2774
3405-000,2017,9,7,10,1157,1065,2222,2813
3405-000,2017,9,7,11,1206,1139,2345,2222
3405-000,2017,9,7,12,1172,1064,2236,2345
3405-000,2017,9,7,13,974,873,1847,2236
3405-000,2017,9,7,14,1018,1041,2059,1847
3405-000,2017,9,7,15,1163,1173,2336,2059
3405-000,2017,9,7,16,1288,1037,2325,2336
3405-000,2017,9,7,17,1237,1068,2305,2325
3405-000,2017,9,7,18,1378,1117,2495,2305
3405-000,2017,9,7,19,1225,1088,2313,2495
3405-000,2017,9,7,20,748,797,1545,2313
3405-000,2017,9,7,21,628,650,1278,1545
3405-000,2017,9,7,22,421,413,834,1278
3405-000,2017,9,7,23,279,267,546,834
3405-000,2017,9,7,24,172,178,350,546
3405-000,2017,9,8,1,26,93,119,350
3405-000,2017,9,8,2,21,74,95,119
3405-000,2017,9,8,3,17,57,74,95
3405-000,2017,9,8,4,13,74,87,74
3405-000,2017,9,8,5,38,110,148,87
3405-000,2017,9,8,6,116,230,346,148
3405-000,2017,9,8,7,341,653,994,346
3405-000,2017,9,8,8,741,1536,2277,994
3405-000,2017,9,8,9,763,1439,2202,2277
3405-000,2017,9,8,10,545,1022,1567,2202
3405-000,2017,9,8,11,563,1052,1615,1567
3405-000,2017,9,8,12,772,1030,1802,1615
3405-000,2017,9,8,13,1062,991,2053,1802
3405-000,2017,9,8,14,1296,1056,2352,2053
3405-000,2017,9,8,15,1401,1016,2417,2352
3405-000,2017,9,8,16,1378,1100,2478,2417
3405-000,2017,9,8,17,1441,1156,2597,2478
3405-000,2017,9,8,18,1809,1338,3147,2597
3405-000,2017,9,8,19,1809,1314,3123,3147
3405-000,2017,9,8,20,1237,945,2182,3123
3405-000,2017,9,8,21,786,696,1482,2182
3405-000,2017,9,8,22,540,512,1052,1482
3405-000,2017,9,8,23,337,263,600,1052
3405-000,2017,9,8,24,191,180,371,600
3405-000,2017,9,9,1,109,111,220,371
3405-000,2017,9,9,2,87,87,174,220
3405-000,2017,9,9,3,73,59,132,174
3405-000,2017,9,9,4,70,85,155,132
3405-000,2017,9,9,5,108,87,195,155
3405-000,2017,9,9,6,266,196,462,195
3405-000,2017,9,9,7,575,411,986,462
3405-000,2017,9,9,8,886,749,1635,986
3405-000,2017,9,9,9,1052,872,1924,1635
3405-000,2017,9,9,10,1004,930,1934,1924
3405-000,2017,9,9,11,1084,1119,2203,1934
3405-000,2017,9,9,12,1028,1082,2110,2203
3405-000,2017,9,9,13,891,1006,1897,2110
3405-000,2017,9,9,14,963,1097,2060,1897
3405-000,2017,9,9,15,974,974,1948,2060
3405-000,2017,9,9,16,982,885,1867,1948
3405-000,2017,9,9,17,1079,924,2003,1867
3405-000,2017,9,9,18,1230,998,2228,2003
3405-000,2017,9,9,19,1009,847,1856,2228
3405-000,2017,9,9,20,671,599,1270,1856
3405-000,2017,9,9,21,446,464,910,1270
3405-000,2017,9,9,22,343,317,660,910
3405-000,2017,9,9,23,213,224,437,660
3405-000,2017,9,9,24,156,168,324,437
3405-000,2017,9,10,1,101,110,211,324
3405-000,2017,9,10,2,61,70,131,211
3405-000,2017,9,10,3,40,53,93,131
3405-000,2017,9,10,4,53,33,86,93
3405-000,2017,9,10,5,86,61,147,86
3405-000,2017,9,10,6,161,83,244,147
3405-000,2017,9,10,7,293,221,514,244
3405-000,2017,9,10,8,503,322,825,514
3405-000,2017,9,10,9,540,368,908,825
3405-000,2017,9,10,10,586,429,1015,908
3405-000,2017,9,10,11,711,497,1208,1015
3405-000,2017,9,10,12,663,543,1206,1208
3405-000,2017,9,10,13,656,607,1263,1206
3405-000,2017,9,10,14,675,653,1328,1263
3405-000,2017,9,10,15,752,718,1470,1328
3405-000,2017,9,10,16,819,733,1552,1470
3405-000,2017,9,10,17,784,764,1548,1552
3405-000,2017,9,10,18,849,785,1634,1548
3405-000,2017,9,10,19,692,694,1386,1634
3405-000,2017,9,10,20,596,562,1158,1386
3405-000,2017,9,10,21,431,528,959,1158
3405-000,2017,9,10,22,303,441,744,959
3405-000,2017,9,10,23,221,305,526,744
3405-000,2017,9,10,24,121,206,327,526
3405-000,2017,9,11,1,56,86,142,327
3405-000,2017,9,11,2,36,76,112,142
3405-000,2017,9,11,3,44,60,104,112
3405-000,2017,9,11,4,63,77,140,104
3405-000,2017,9,11,5,134,79,213,140
3405-000,2017,9,11,6,266,218,484,213
3405-000,2017,9,11,7,649,621,1270,484
3405-000,2017,9,11,8,1273,1543,2816,1270
3405-000,2017,9,11,9,1316,1440,2756,2816
3405-000,2017,9,11,10,1057,957,2014,2756
3405-000,2017,9,11,11,1078,973,2051,2014
3405-000,2017,9,11,12,1020,899,1919,2051
3405-000,2017,9,11,13,967,872,1839,1919
3405-000,2017,9,11,14,968,1041,2009,1839
3405-000,2017,9,11,15,1118,1006,2124,2009
3405-000,2017,9,11,16,1120,1009,2129,2124
3405-000,2017,9,11,17,1036,971,2007,2129
3405-000,2017,9,11,18,1224,1008,2232,2007
3405-000,2017,9,11,19,1097,1063,2160,2232
3405-000,2017,9,11,20,801,745,1546,2160
3405-000,2017,9,11,21,589,615,1204,1546
3405-000,2017,9,11,22,421,432,853,1204
3405-000,2017,9,11,23,248,253,501,853
3405-000,2017,9,11,24,140,168,308,501
3405-000,2017,9,12,1,103,113,216,308
3405-000,2017,9,12,2,60,66,126,216
3405-000,2017,9,12,3,58,64,122,126
3405-000,2017,9,12,4,67,89,156,122
3405-000,2017,9,12,5,132,102,234,156
3405-000,2017,9,12,6,244,202,446,234
3405-000,2017,9,12,7,687,583,1270,446
3405-000,2017,9,12,8,1271,1411,2682,1270
3405-000,2017,9,12,9,1224,1421,2645,2682
3405-000,2017,9,12,10,1234,1005,2239,2645
3405-000,2017,9,12,11,1171,1063,2234,2239
3405-000,2017,9,12,12,1134,1018,2152,2234
3405-000,2017,9,12,13,915,891,1806,2152
3405-000,2017,9,12,14,1093,1038,2131,1806
3405-000,2017,9,12,15,1204,1062,2266,2131
3405-000,2017,9,12,16,1179,1054,2233,2266
3405-000,2017,9,12,17,1166,1087,2253,2233
3405-000,2017,9,12,18,1360,1173,2533,2253
3405-000,2017,9,12,19,1201,1108,2309,2533
3405-000,2017,9,12,20,805,787,1592,2309
3405-000,2017,9,12,21,600,594,1194,1592
3405-000,2017,9,12,22,431,453,884,1194
3405-000,2017,9,12,23,251,262,513,884
3405-000,2017,9,12,24,170,147,317,513
3405-000,2017,9,13,1,100,99,199,317
3405-000,2017,9,13,2,59,77,136,199
3405-000,2017,9,13,3,55,63,118,136
3405-000,2017,9,13,4,56,88,144,118
3405-000,2017,9,13,5,134,87,221,144
3405-000,2017,9,13,6,265,190,455,221
3405-000,2017,9,13,7,685,586,1271,455
3405-000,2017,9,13,8,1204,1449,2653,1271
3405-000,2017,9,13,9,1393,1387,2780,2653
3405-000,2017,9,13,10,1175,1004,2179,2780
3405-000,2017,9,13,11,1210,1044,2254,2179
3405-000,2017,9,13,12,1113,950,2063,2254
3405-000,2017,9,13,13,917,872,1789,2063
3405-000,2017,9,13,14,1019,963,1982,1789
3405-000,2017,9,13,15,1241,1064,2305,1982
3405-000,2017,9,13,16,1218,1057,2275,2305
3405-000,2017,9,13,17,1255,987,2242,2275
3405-000,2017,9,13,18,1492,1113,2605,2242
3405-000,2017,9,13,19,1338,1183,2521,2605
3405-000,2017,9,13,20,800,754,1554,2521
3405-000,2017,9,13,21,576,623,1199,1554
3405-000,2017,9,13,22,415,423,838,1199
3405-000,2017,9,13,23,271,284,555,838
3405-000,2017,9,13,24,174,151,325,555
3405-000,2017,9,14,1,117,117,234,325
3405-000,2017,9,14,2,58,81,139,234
3405-000,2017,9,14,3,73,83,156,139
3405-000,2017,9,14,4,87,82,169,156
3405-000,2017,9,14,5,132,112,244,169
3405-000,2017,9,14,6,278,236,514,244
3405-000,2017,9,14,7,645,602,1247,514
3405-000,2017,9,14,8,1300,1434,2734,1247
3405-000,2017,9,14,9,1462,1337,2799,2734
3405-000,2017,9,14,10,1140,1063,2203,2799
3405-000,2017,9,14,11,1155,1056,2211,2203
3405-000,2017,9,14,12,1132,968,2100,2211
3405-000,2017,9,14,13,913,876,1789,2100
3405-000,2017,9,14,14,1091,989,2080,1789
3405-000,2017,9,14,15,1239,1032,2271,2080
3405-000,2017,9,14,16,1217,1130,2347,2271
3405-000,2017,9,14,17,1259,1077,2336,2347
3405-000,2017,9,14,18,1325,1128,2453,2336
3405-000,2017,9,14,19,1264,1144,2408,2453
3405-000,2017,9,14,20,761,726,1487,2408
3405-000,2017,9,14,21,639,655,1294,1487
3405-000,2017,9,14,22,403,478,881,1294
3405-000,2017,9,14,23,271,302,573,881
3405-000,2017,9,14,24,141,156,297,573
3405-000,2017,9,15,1,101,89,190,297
3405-000,2017,9,15,2,54,82,136,190
3405-000,2017,9,15,3,54,56,110,136
3405-000,2017,9,15,4,72,82,154,110
3405-000,2017,9,15,5,122,112,234,154
3405-000,2017,9,15,6,278,206,484,234
3405-000,2017,9,15,7,650,594,1244,484
3405-000,2017,9,15,8,1289,1413,2702,1244
3405-000,2017,9,15,9,1356,1446,2802,2702
3405-000,2017,9,15,10,1179,1049,2228,2802
3405-000,2017,9,15,11,1219,1145,2364,2228
3405-000,2017,9,15,12,1241,1028,2269,2364
3405-000,2017,9,15,13,1060,928,1988,2269
3405-000,2017,9,15,14,1167,1034,2201,1988
3405-000,2017,9,15,15,1213,1273,2486,2201
3405-000,2017,9,15,16,1231,1276,2507,2486
3405-000,2017,9,15,17,1374,1176,2550,2507
3405-000,2017,9,15,18,1657,1245,2902,2550
3405-000,2017,9,15,19,1672,1349,3021,2902
3405-000,2017,9,15,20,1037,909,1946,3021
3405-000,2017,9,15,21,802,666,1468,1946
3405-000,2017,9,15,22,529,502,1031,1468
3405-000,2017,9,15,23,319,280,599,1031
3405-000,2017,9,15,24,202,177,379,599
3405-000,2017,9,16,1,118,132,250,379
3405-000,2017,9,16,2,90,61,151,250
3405-000,2017,9,16,3,77,76,153,151
3405-000,2017,9,16,4,84,88,172,153
3405-000,2017,9,16,5,132,95,227,172
3405-000,2017,9,16,6,275,198,473,227
3405-000,2017,9,16,7,627,429,1056,473
3405-000,2017,9,16,8,930,780,1710,1056
3405-000,2017,9,16,9,1059,909,1968,1710
3405-000,2017,9,16,10,994,924,1918,1968
3405-000,2017,9,16,11,1098,952,2050,1918
3405-000,2017,9,16,12,982,965,1947,2050
3405-000,2017,9,16,13,885,993,1878,1947
3405-000,2017,9,16,14,928,879,1807,1878
3405-000,2017,9,16,15,995,824,1819,1807
3405-000,2017,9,16,16,1034,915,1949,1819
3405-000,2017,9,16,17,999,862,1861,1949
3405-000,2017,9,16,18,1217,1102,2319,1861
3405-000,2017,9,16,19,979,897,1876,2319
3405-000,2017,9,16,20,686,651,1337,1876
3405-000,2017,9,16,21,477,444,921,1337
3405-000,2017,9,16,22,327,346,673,921
3405-000,2017,9,16,23,222,274,496,673
3405-000,2017,9,16,24,156,180,336,496
3405-000,2017,9,17,1,96,101,197,336
3405-000,2017,9,17,2,71,69,140,197
3405-000,2017,9,17,3,49,36,85,140
3405-000,2017,9,17,4,43,41,84,85
3405-000,2017,9,17,5,75,66,141,84
3405-000,2017,9,17,6,210,111,321,141
3405-000,2017,9,17,7,379,236,615,321
3405-000,2017,9,17,8,562,318,880,615
3405-000,2017,9,17,9,630,368,998,880
3405-000,2017,9,17,10,611,425,1036,998
3405-000,2017,9,17,11,701,510,1211,1036
3405-000,2017,9,17,12,685,548,1233,1211
3405-000,2017,9,17,13,623,539,1162,1233
3405-000,2017,9,17,14,715,703,1418,1162
3405-000,2017,9,17,15,752,795,1547,1418
3405-000,2017,9,17,16,749,811,1560,1547
3405-000,2017,9,17,17,799,830,1629,1560
3405-000,2017,9,17,18,924,856,1780,1629
3405-000,2017,9,17,19,800,943,1743,1780
3405-000,2017,9,17,20,648,852,1500,1743
3405-000,2017,9,17,21,512,711,1223,1500
3405-000,2017,9,17,22,401,496,897,1223
3405-000,2017,9,17,23,257,298,555,897
3405-000,2017,9,17,24,137,188,325,555
3405-000,2017,9,18,1,74,137,211,325
3405-000,2017,9,18,2,38,83,121,211
3405-000,2017,9,18,3,45,37,82,121
3405-000,2017,9,18,4,66,30,96,82
3405-000,2017,9,18,5,148,115,263,96
3405-000,2017,9,18,6,318,290,608,263
3405-000,2017,9,18,7,750,721,1471,608
3405-000,2017,9,18,8,1347,1667,3014,1471
3405-000,2017,9,18,9,1411,1449,2860,3014
3405-000,2017,9,18,10,1163,1024,2187,2860
3405-000,2017,9,18,11,1173,1073,2246,2187
3405-000,2017,9,18,12,1134,1046,2180,2246
3405-000,2017,9,18,13,936,861,1797,2180
3405-000,2017,9,18,14,1074,1068,2142,1797
3405-000,2017,9,18,15,1152,1147,2299,2142
3405-000,2017,9,18,16,1207,1136,2343,2299
3405-000,2017,9,18,17,1166,1061,2227,2343
3405-000,2017,9,18,18,1286,1117,2403,2227
3405-000,2017,9,18,19,1213,1093,2306,2403
3405-000,2017,9,18,20,823,772,1595,2306
3405-000,2017,9,18,21,622,613,1235,1595
3405-000,2017,9,18,22,432,455,887,1235
3405-000,2017,9,18,23,272,245,517,887
3405-000,2017,9,18,24,136,138,274,517
3405-000,2017,9,19,1,96,97,193,274
3405-000,2017,9,19,2,56,63,119,193
3405-000,2017,9,19,3,62,69,131,119
3405-000,2017,9,19,4,84,94,178,131
3405-000,2017,9,19,5,130,90,220,178
3405-000,2017,9,19,6,296,227,523,220
3405-000,2017,9,19,7,627,592,1219,523
3405-000,2017,9,19,8,1306,1389,2695,1219
3405-000,2017,9,19,9,1426,1384,2810,2695
3405-000,2017,9,19,10,1229,1048,2277,2810
3405-000,2017,9,19,11,1241,1091,2332,2277
3405-000,2017,9,19,12,1123,1015,2138,2332
3405-000,2017,9,19,13,961,908,1869,2138
3405-000,2017,9,19,14,1046,1048,2094,1869
3405-000,2017,9,19,15,1206,1067,2273,2094
3405-000,2017,9,19,16,1169,1139,2308,2273
3405-000,2017,9,19,17,1190,1050,2240,2308
3405-000,2017,9,19,18,1361,1125,2486,2240
3405-000,2017,9,19,19,1181,1077,2258,2486
3405-000,2017,9,19,20,793,762,1555,2258
3405-000,2017,9,19,21,628,614,1242,1555
3405-000,2017,9,19,22,429,454,883,1242
3405-000,2017,9,19,23,275,251,526,883
3405-000,2017,9,19,24,127,153,280,526
3405-000,2017,9,20,1,101,123,224,280
3405-000,2017,9,20,2,56,74,130,224
3405-000,2017,9,20,3,52,62,114,130
3405-000,2017,9,20,4,70,75,145,114
3405-000,2017,9,20,5,136,110,246,145
3405-000,2017,9,20,6,274,217,491,246
3405-000,2017,9,20,7,685,598,1283,491
3405-000,2017,9,20,8,1291,1416,2707,1283
3405-000,2017,9,20,9,1429,1335,2764,2707
3405-000,2017,9,20,10,1205,1003,2208,2764
3405-000,2017,9,20,11,1202,1088,2290,2208
3405-000,2017,9,20,12,1170,1066,2236,2290
3405-000,2017,9,20,13,993,936,1929,2236
3405-000,2017,9,20,14,1100,1074,2174,1929
3405-000,2017,9,20,15,1274,1091,2365,2174
3405-000,2017,9,20,16,1207,1137,2344,2365
3405-000,2017,9,20,17,1186,1083,2269,2344
3405-000,2017,9,20,18,1468,1234,2702,2269
3405-000,2017,9,20,19,1344,1134,2478,2702
3405-000,2017,9,20,20,863,721,1584,2478
3405-000,2017,9,20,21,559,526,1085,1584
3405-000,2017,9,20,22,398,449,847,1085
3405-000,2017,9,20,23,239,259,498,847
3405-000,2017,9,20,24,155,160,315,498
3405-000,2017,9,21,1,111,100,211,315
3405-000,2017,9,21,2,80,79,159,211
3405-000,2017,9,21,3,50,66,116,159
3405-000,2017,9,21,4,85,68,153,116
3405-000,2017,9,21,5,131,106,237,153
3405-000,2017,9,21,6,258,213,471,237
3405-000,2017,9,21,7,676,598,1274,471
3405-000,2017,9,21,8,1250,1420,2670,1274
3405-000,2017,9,21,9,1400,1330,2730,2670
3405-000,2017,9,21,10,1229,1074,2303,2730
3405-000,2017,9,21,11,1178,1049,2227,2303
3405-000,2017,9,21,12,1168,1024,2192,2227
3405-000,2017,9,21,13,1025,873,1898,2192
3405-000,2017,9,21,14,1094,1042,2136,1898
3405-000,2017,9,21,15,1155,1044,2199,2136
3405-000,2017,9,21,16,1245,1055,2300,2199
3405-000,2017,9,21,17,1235,1144,2379,2300
3405-000,2017,9,21,18,1372,1130,2502,2379
3405-000,2017,9,21,19,1205,1019,2224,2502
3405-000,2017,9,21,20,772,770,1542,2224
3405-000,2017,9,21,21,645,669,1314,1542
3405-000,2017,9,21,22,418,514,932,1314
3405-000,2017,9,21,23,281,260,541,932
3405-000,2017,9,21,24,148,168,316,541
3405-000,2017,9,22,1,94,117,211,316
3405-000,2017,9,22,2,53,79,132,211
3405-000,2017,9,22,3,57,70,127,132
3405-000,2017,9,22,4,68,80,148,127
3405-000,2017,9,22,5,164,113,277,148
3405-000,2017,9,22,6,329,249,578,277
3405-000,2017,9,22,7,656,642,1298,578
3405-000,2017,9,22,8,1284,1474,2758,1298
3405-000,2017,9,22,9,1425,1421,2846,2758
3405-000,2017,9,22,10,1275,1014,2289,2846
3405-000,2017,9,22,11,1297,1127,2424,2289
3405-000,2017,9,22,12,1218,980,2198,2424
3405-000,2017,9,22,13,1011,945,1956,2198
3405-000,2017,9,22,14,1123,1097,2220,1956
3405-000,2017,9,22,15,1211,1102,2313,2220
3405-000,2017,9,22,16,1384,1064,2448,2313
3405-000,2017,9,22,17,1432,1119,2551,2448
3405-000,2017,9,22,18,1639,1324,2963,2551
3405-000,2017,9,22,19,1643,1259,2902,2963
3405-000,2017,9,22,20,1098,845,1943,2902
3405-000,2017,9,22,21,773,731,1504,1943
3405-000,2017,9,22,22,499,495,994,1504
3405-000,2017,9,22,23,322,303,625,994
3405-000,2017,9,22,24,181,187,368,625
3405-000,2017,9,23,1,118,137,255,368
3405-000,2017,9,23,2,73,81,154,255
3405-000,2017,9,23,3,63,78,141,154
3405-000,2017,9,23,4,65,81,146,141
3405-000,2017,9,23,5,132,117,249,146
3405-000,2017,9,23,6,272,182,454,249
3405-000,2017,9,23,7,627,477,1104,454
3405-000,2017,9,23,8,949,778,1727,1104
3405-000,2017,9,23,9,1114,952,2066,1727
3405-000,2017,9,23,10,1051,866,1917,2066
3405-000,2017,9,23,11,1153,947,2100,1917
3405-000,2017,9,23,12,980,938,1918,2100
3405-000,2017,9,23,13,880,894,1774,1918
3405-000,2017,9,23,14,933,857,1790,1774
3405-000,2017,9,23,15,955,880,1835,1790
3405-000,2017,9,23,16,983,913,1896,1835
3405-000,2017,9,23,17,1109,894,2003,1896
3405-000,2017,9,23,18,1335,1077,2412,2003
3405-000,2017,9,23,19,1044,969,2013,2412
3405-000,2017,9,23,20,690,753,1443,2013
3405-000,2017,9,23,21,479,516,995,1443
3405-000,2017,9,23,22,333,395,728,995
3405-000,2017,9,23,23,204,287,491,728
3405-000,2017,9,23,24,143,169,312,491
3405-000,2017,9,24,1,107,106,213,312
3405-000,2017,9,24,2,64,61,125,213
3405-000,2017,9,24,3,49,37,86,125
3405-000,2017,9,24,4,49,37,86,86
3405-000,2017,9,24,5,86,44,130,86
3405-000,2017,9,24,6,181,105,286,130
3405-000,2017,9,24,7,351,212,563,286
3405-000,2017,9,24,8,510,398,908,563
3405-000,2017,9,24,9,589,403,992,908
3405-000,2017,9,24,10,657,470,1127,992
3405-000,2017,9,24,11,739,583,1322,1127
3405-000,2017,9,24,12,685,552,1237,1322
3405-000,2017,9,24,13,657,586,1243,1237
3405-000,2017,9,24,14,691,713,1404,1243
3405-000,2017,9,24,15,794,749,1543,1404
3405-000,2017,9,24,16,789,815,1604,1543
3405-000,2017,9,24,17,812,792,1604,1604
3405-000,2017,9,24,18,873,795,1668,1604
3405-000,2017,9,24,19,734,659,1393,1668
3405-000,2017,9,24,20,531,568,1099,1393
3405-000,2017,9,24,21,411,489,900,1099
3405-000,2017,9,24,22,292,397,689,900
3405-000,2017,9,24,23,251,296,547,689
3405-000,2017,9,24,24,128,199,327,547
3405-000,2017,9,25,1,78,96,174,327
3405-000,2017,9,25,2,46,73,119,174
3405-000,2017,9,25,3,47,55,102,119
3405-000,2017,9,25,4,63,72,135,102
3405-000,2017,9,25,5,148,121,269,135
3405-000,2017,9,25,6,338,274,612,269
3405-000,2017,9,25,7,760,785,1545,612
3405-000,2017,9,25,8,1346,1752,3098,1545
3405-000,2017,9,25,9,1380,1472,2852,3098
3405-000,2017,9,25,10,1225,1019,2244,2852
3405-000,2017,9,25,11,1176,1051,2227,2244
3405-000,2017,9,25,12,1164,1051,2215,2227
3405-000,2017,9,25,13,1010,957,1967,2215
3405-000,2017,9,25,14,1087,1068,2155,1967
3405-000,2017,9,25,15,1226,1150,2376,2155
3405-000,2017,9,25,16,1116,1222,2338,2376
3405-000,2017,9,25,17,1208,1248,2456,2338
3405-000,2017,9,25,18,1397,1165,2562,2456
3405-000,2017,9,25,19,1305,1093,2398,2562
3405-000,2017,9,25,20,817,743,1560,2398
3405-000,2017,9,25,21,651,703,1354,1560
3405-000,2017,9,25,22,429,517,946,1354
3405-000,2017,9,25,23,252,263,515,946
3405-000,2017,9,25,24,165,149,314,515
3405-000,2017,9,26,1,101,108,209,314
3405-000,2017,9,26,2,65,85,150,209
3405-000,2017,9,26,3,59,73,132,150
3405-000,2017,9,26,4,85,87,172,132
3405-000,2017,9,26,5,146,121,267,172
3405-000,2017,9,26,6,286,238,524,267
3405-000,2017,9,26,7,702,606,1308,524
3405-000,2017,9,26,8,1337,1491,2828,1308
3405-000,2017,9,26,9,1474,1367,2841,2828
3405-000,2017,9,26,10,1219,1059,2278,2841
3405-000,2017,9,26,11,1257,1093,2350,2278
3405-000,2017,9,26,12,1179,1020,2199,2350
3405-000,2017,9,26,13,938,892,1830,2199
3405-000,2017,9,26,14,1094,1076,2170,1830
3405-000,2017,9,26,15,1246,1167,2413,2170
3405-000,2017,9,26,16,1321,1105,2426,2413
3405-000,2017,9,26,17,1204,1108,2312,2426
3405-000,2017,9,26,18,1366,1190,2556,2312
3405-000,2017,9,26,19,1291,1122,2413,2556
3405-000,2017,9,26,20,799,788,1587,2413
3405-000,2017,9,26,21,691,662,1353,1587
3405-000,2017,9,26,22,428,478,906,1353
3405-000,2017,9,26,23,275,268,543,906
3405-000,2017,9,26,24,175,173,348,543
3405-000,2017,9,27,1,115,128,243,348
3405-000,2017,9,27,2,71,78,149,243
3405-000,2017,9,27,3,52,58,110,149
3405-000,2017,9,27,4,69,87,156,110
3405-000,2017,9,27,5,144,112,256,156
3405-000,2017,9,27,6,274,228,502,256
3405-000,2017,9,27,7,649,512,1161,502
3405-000,2017,9,27,8,1222,1432,2654,1161
3405-000,2017,9,27,9,1404,1375,2779,2654
3405-000,2017,9,27,10,1209,1027,2236,2779
3405-000,2017,9,27,11,1257,1121,2378,2236
3405-000,2017,9,27,12,1181,1042,2223,2378
3405-000,2017,9,27,13,1040,907,1947,2223
3405-000,2017,9,27,14,1154,1080,2234,1947
3405-000,2017,9,27,15,1295,1101,2396,2234
3405-000,2017,9,27,16,1342,1098,2440,2396
3405-000,2017,9,27,17,1224,1135,2359,2440
3405-000,2017,9,27,18,1440,1248,2688,2359
3405-000,2017,9,27,19,1314,1169,2483,2688
3405-000,2017,9,27,20,842,740,1582,2483
3405-000,2017,9,27,21,610,648,1258,1582
3405-000,2017,9,27,22,404,450,854,1258
3405-000,2017,9,27,23,281,228,509,854
3405-000,2017,9,27,24,182,147,329,509
3405-000,2017,9,28,1,119,113,232,329
3405-000,2017,9,28,2,67,79,146,232
3405-000,2017,9,28,3,54,67,121,146
3405-000,2017,9,28,4,78,86,164,121
3405-000,2017,9,28,5,133,126,259,164
3405-000,2017,9,28,6,271,231,502,259
3405-000,2017,9,28,7,672,600,1272,502
3405-000,2017,9,28,8,1264,1483,2747,1272
3405-000,2017,9,28,9,1512,1440,2952,2747
3405-000,2017,9,28,10,1266,1081,2347,2952
3405-000,2017,9,28,11,1293,1061,2354,2347
3405-000,2017,9,28,12,1157,1069,2226,2354
3405-000,2017,9,28,13,984,991,1975,2226
3405-000,2017,9,28,14,1197,1094,2291,1975
3405-000,2017,9,28,15,1248,1148,2396,2291
3405-000,2017,9,28,16,1273,1229,2502,2396
3405-000,2017,9,28,17,1329,1159,2488,2502
3405-000,2017,9,28,18,1353,1235,2588,2488
3405-000,2017,9,28,19,1337,1196,2533,2588
3405-000,2017,9,28,20,878,771,1649,2533
3405-000,2017,9,28,21,705,686,1391,1649
3405-000,2017,9,28,22,522,435,957,1391
3405-000,2017,9,28,23,342,269,611,957
3405-000,2017,9,28,24,184,215,399,611
3405-000,2017,9,29,1,116,103,219,399
3405-000,2017,9,29,2,62,80,142,219
3405-000,2017,9,29,3,59,63,122,142
3405-000,2017,9,29,4,75,81,156,122
3405-000,2017,9,29,5,146,112,258,156
3405-000,2017,9,29,6,244,228,472,258
3405-000,2017,9,29,7,667,618,1285,472
3405-000,2017,9,29,8,1281,1444,2725,1285
3405-000,2017,9,29,9,1475,1434,2909,2725
3405-000,2017,9,29,10,1210,1032,2242,2909
3405-000,2017,9,29,11,1230,1136,2366,2242
3405-000,2017,9,29,12,1226,1004,2230,2366
3405-000,2017,9,29,13,1047,936,1983,2230
3405-000,2017,9,29,14,1212,1066,2278,1983
3405-000,2017,9,29,15,1211,1188,2399,2278
3405-000,2017,9,29,16,1375,1170,2545,2399
3405-000,2017,9,29,17,1253,1148,2401,2545
3405-000,2017,9,29,18,1576,1284,2860,2401
3405-000,2017,9,29,19,1510,1304,2814,2860
3405-000,2017,9,29,20,1057,877,1934,2814
3405-000,2017,9,29,21,687,698,1385,1934
3405-000,2017,9,29,22,461,498,959,1385
3405-000,2017,9,29,23,328,292,620,959
3405-000,2017,9,29,24,207,182,389,620
3405-000,2017,9,30,1,107,259,366,389
3405-000,2017,9,30,2,95,71,166,366
3405-000,2017,9,30,3,68,77,145,166
3405-000,2017,9,30,4,109,84,193,145
3405-000,2017,9,30,5,145,106,251,193
3405-000,2017,9,30,6,289,190,479,251
3405-000,2017,9,30,7,557,453,1010,479
3405-000,2017,9,30,8,857,779,1636,1010
3405-000,2017,9,30,9,982,930,1912,1636
3405-000,2017,9,30,10,1050,895,1945,1912
3405-000,2017,9,30,11,1003,950,1953,1945
3405-000,2017,9,30,12,997,952,1949,1953
3405-000,2017,9,30,13,932,944,1876,1949
3405-000,2017,9,30,14,966,868,1834,1876
3405-000,2017,9,30,15,961,852,1813,1834
3405-000,2017,9,30,16,999,914,1913,1813
3405-000,2017,9,30,17,916,878,1794,1913
3405-000,2017,9,30,18,1062,1090,2152,1794
3405-000,2017,9,30,19,878,933,1811,2152
3405-000,2017,9,30,20,555,702,1257,1811
3405-000,2017,9,30,21,387,480,867,1257
3405-000,2017,9,30,22,305,370,675,867
3405-000,2017,9,30,23,227,280,507,675
3405-000,2017,9,30,24,117,174,291,507
3405-000,2017,10,1,1,97,84,181,291
3405-000,2017,10,1,2,69,90,159,181
3405-000,2017,10,1,3,39,42,81,159
3405-000,2017,10,1,4,51,57,108,81
3405-000,2017,10,1,5,94,62,156,108
3405-000,2017,10,1,6,164,128,292,156
3405-000,2017,10,1,7,341,276,617,292
3405-000,2017,10,1,8,524,448,972,617
3405-000,2017,10,1,9,640,505,1145,972
3405-000,2017,10,1,10,672,535,1207,1145
3405-000,2017,10,1,11,702,540,1242,1207
3405-000,2017,10,1,12,731,695,1426,1242
3405-000,2017,10,1,13,661,658,1319,1426
3405-000,2017,10,1,14,665,680,1345,1319
3405-000,2017,10,1,15,714,725,1439,1345
3405-000,2017,10,1,16,645,573,1218,1439
3405-000,2017,10,1,17,649,713,1362,1218
3405-000,2017,10,1,18,714,714,1428,1362
3405-000,2017,10,1,19,553,520,1073,1428
3405-000,2017,10,1,20,417,443,860,1073
3405-000,2017,10,1,21,296,419,715,860
3405-000,2017,10,1,22,216,313,529,715
3405-000,2017,10,1,23,142,208,350,529
3405-000,2017,10,1,24,123,178,301,350
3405-000,2017,10,2,1,67,126,193,301
3405-000,2017,10,2,2,46,52,98,193
3405-000,2017,10,2,3,37,39,76,98
3405-000,2017,10,2,4,28,30,58,76
3405-000,2017,10,2,5,109,84,193,58
3405-000,2017,10,2,6,209,220,429,193
3405-000,2017,10,2,7,377,394,771,429
3405-000,2017,10,2,8,674,974,1648,771
3405-000,2017,10,2,9,724,864,1588,1648
3405-000,2017,10,2,10,800,758,1558,1588
3405-000,2017,10,2,11,937,785,1722,1558
3405-000,2017,10,2,12,944,807,1751,1722
3405-000,2017,10,2,13,918,971,1889,1751
3405-000,2017,10,2,14,964,1021,1985,1889
3405-000,2017,10,2,15,1009,989,1998,1985
3405-000,2017,10,2,16,1088,1003,2091,1998
3405-000,2017,10,2,17,895,773,1668,2091
3405-000,2017,10,2,18,943,835,1778,1668
3405-000,2017,10,2,19,738,705,1443,1778
3405-000,2017,10,2,20,489,512,1001,1443
3405-000,2017,10,2,21,381,380,761,1001
3405-000,2017,10,2,22,282,278,560,761
3405-000,2017,10,2,23,207,197,404,560
3405-000,2017,10,2,24,147,178,325,404
3405-000,2017,10,3,1,111,152,263,325
3405-000,2017,10,3,2,65,78,143,263
3405-000,2017,10,3,3,62,52,114,143
3405-000,2017,10,3,4,64,61,125,114
3405-000,2017,10,3,5,86,78,164,125
3405-000,2017,10,3,6,182,147,329,164
3405-000,2017,10,3,7,324,336,660,329
3405-000,2017,10,3,8,442,539,981,660
3405-000,2017,10,3,9,537,565,1102,981
3405-000,2017,10,3,10,694,638,1332,1102
3405-000,2017,10,3,11,798,686,1484,1332
3405-000,2017,10,3,12,822,701,1523,1484
3405-000,2017,10,3,13,597,535,1132,1523
3405-000,2017,10,3,14,616,590,1206,1132
3405-000,2017,10,3,15,611,554,1165,1206
3405-000,2017,10,3,16,582,506,1088,1165
3405-000,2017,10,3,17,532,474,1006,1088
3405-000,2017,10,3,18,477,401,878,1006
3405-000,2017,10,3,19,411,401,812,878
3405-000,2017,10,3,20,273,263,536,812
3405-000,2017,10,3,21,227,231,458,536
3405-000,2017,10,3,22,159,172,331,458
3405-000,2017,10,3,23,138,122,260,331
3405-000,2017,10,3,24,79,76,155,260
3405-000,2017,10,4,1,68,83,151,155
3405-000,2017,10,4,2,26,29,55,151
3405-000,2017,10,4,3,19,19,38,55
3405-000,2017,10,4,4,24,23,47,38
3405-000,2017,10,4,5,37,28,65,47
3405-000,2017,10,4,6,119,84,203,65
3405-000,2017,10,4,7,304,270,574,203
3405-000,2017,10,4,8,464,603,1067,574
3405-000,2017,10,4,9,479,532,1011,1067
3405-000,2017,10,4,10,633,573,1206,1011
3405-000,2017,10,4,11,1029,972,2001,1206
3405-000,2017,10,4,12,1285,1122,2407,2001
3405-000,2017,10,4,13,1357,1253,2610,2407
3405-000,2017,10,4,14,1182,1306,2488,2610
3405-000,2017,10,4,15,1312,1186,2498,2488
3405-000,2017,10,4,16,1021,869,1890,2498
3405-000,2017,10,4,17,925,831,1756,1890
3405-000,2017,10,4,18,1009,837,1846,1756
3405-000,2017,10,4,19,507,459,966,1846
3405-000,2017,10,4,20,504,436,940,966
3405-000,2017,10,4,21,363,406,769,940
3405-000,2017,10,4,22,306,273,579,769
3405-000,2017,10,4,23,196,196,392,579
3405-000,2017,10,4,24,148,156,304,392
3405-000,2017,10,5,1,85,101,186,304
3405-000,2017,10,5,2,56,61,117,186
3405-000,2017,10,5,3,32,23,55,117
3405-000,2017,10,5,4,24,26,50,55
3405-000,2017,10,5,5,47,33,80,50
3405-000,2017,10,5,6,118,92,210,80
3405-000,2017,10,5,7,194,184,378,210
3405-000,2017,10,5,8,287,366,653,378
3405-000,2017,10,5,9,385,429,814,653
3405-000,2017,10,5,10,554,510,1064,814
3405-000,2017,10,5,11,830,784,1614,1064
3405-000,2017,10,5,12,939,853,1792,1614
3405-000,2017,10,5,13,737,661,1398,1792
3405-000,2017,10,5,14,694,710,1404,1398
3405-000,2017,10,5,15,728,735,1463,1404
3405-000,2017,10,5,16,844,680,1524,1463
3405-000,2017,10,5,17,739,639,1378,1524
3405-000,2017,10,5,18,712,578,1290,1378
3405-000,2017,10,5,19,528,469,997,1290
3405-000,2017,10,5,20,477,509,986,997
3405-000,2017,10,5,21,451,467,918,986
3405-000,2017,10,5,22,295,290,585,918
3405-000,2017,10,5,23,363,348,711,585
3405-000,2017,10,5,24,259,269,528,711
3405-000,2017,10,6,1,260,108,368,528
3405-000,2017,10,6,2,103,64,167,368
3405-000,2017,10,6,3,61,30,91,167
3405-000,2017,10,6,4,41,40,81,91
3405-000,2017,10,6,5,73,52,125,81
3405-000,2017,10,6,6,105,102,207,125
3405-000,2017,10,6,7,220,196,416,207
3405-000,2017,10,6,8,371,394,765,416
3405-000,2017,10,6,9,427,462,889,765
3405-000,2017,10,6,10,586,546,1132,889
3405-000,2017,10,6,11,729,755,1484,1132
3405-000,2017,10,6,12,772,814,1586,1484
3405-000,2017,10,6,13,684,639,1323,1586
3405-000,2017,10,6,14,660,538,1198,1323
3405-000,2017,10,6,15,719,522,1241,1198
3405-000,2017,10,6,16,728,582,1310,1241
3405-000,2017,10,6,17,700,562,1262,1310
3405-000,2017,10,6,18,624,462,1086,1262
3405-000,2017,10,6,19,554,403,957,1086
3405-000,2017,10,6,20,461,353,814,957
3405-000,2017,10,6,21,309,274,583,814
3405-000,2017,10,6,22,349,331,680,583
3405-000,2017,10,6,23,224,175,399,680
3405-000,2017,10,6,24,165,156,321,399
3405-000,2017,10,7,1,112,115,227,321
3405-000,2017,10,7,2,65,66,131,227
3405-000,2017,10,7,3,45,37,82,131
3405-000,2017,10,7,4,43,53,96,82
3405-000,2017,10,7,5,86,70,156,96
3405-000,2017,10,7,6,150,111,261,156
3405-000,2017,10,7,7,291,209,500,261
3405-000,2017,10,7,8,497,421,918,500
3405-000,2017,10,7,9,595,494,1089,918
3405-000,2017,10,7,10,629,583,1212,1089
3405-000,2017,10,7,11,703,726,1429,1212
3405-000,2017,10,7,12,737,776,1513,1429
3405-000,2017,10,7,13,760,859,1619,1513
3405-000,2017,10,7,14,697,794,1491,1619
3405-000,2017,10,7,15,791,792,1583,1491
3405-000,2017,10,7,16,788,711,1499,1583
3405-000,2017,10,7,17,785,673,1458,1499
3405-000,2017,10,7,18,817,663,1480,1458
3405-000,2017,10,7,19,683,574,1257,1480
3405-000,2017,10,7,20,505,451,956,1257
3405-000,2017,10,7,21,376,392,768,956
3405-000,2017,10,7,22,288,267,555,768
3405-000,2017,10,7,23,187,197,384,555
3405-000,2017,10,7,24,132,143,275,384
3405-000,2017,10,8,1,99,108,207,275
3405-000,2017,10,8,2,59,68,127,207
3405-000,2017,10,8,3,34,46,80,127
3405-000,2017,10,8,4,39,25,64,80
3405-000,2017,10,8,5,51,37,88,64
3405-000,2017,10,8,6,133,69,202,88
3405-000,2017,10,8,7,227,172,399,202
3405-000,2017,10,8,8,380,244,624,399
3405-000,2017,10,8,9,513,350,863,624
3405-000,2017,10,8,10,551,404,955,863
3405-000,2017,10,8,11,624,437,1061,955
3405-000,2017,10,8,12,635,521,1156,1061
3405-000,2017,10,8,13,641,594,1235,1156
3405-000,2017,10,8,14,657,636,1293,1235
3405-000,2017,10,8,15,715,683,1398,1293
3405-000,2017,10,8,16,793,710,1503,1398
3405-000,2017,10,8,17,684,667,1351,1503
3405-000,2017,10,8,18,760,703,1463,1351
3405-000,2017,10,8,19,644,646,1290,1463
3405-000,2017,10,8,20,444,419,863,1290
3405-000,2017,10,8,21,354,434,788,863
3405-000,2017,10,8,22,284,414,698,788
3405-000,2017,10,8,23,211,292,503,698
3405-000,2017,10,8,24,123,210,333,503
3405-000,2017,10,9,1,80,123,203,333
3405-000,2017,10,9,2,49,104,153,203
3405-000,2017,10,9,3,48,66,114,153
3405-000,2017,10,9,4,55,68,123,114
3405-000,2017,10,9,5,104,62,166,123
3405-000,2017,10,9,6,237,195,432,166
3405-000,2017,10,9,7,450,431,881,432
3405-000,2017,10,9,8,826,1002,1828,881
3405-000,2017,10,9,9,805,881,1686,1828
3405-000,2017,10,9,10,686,622,1308,1686
3405-000,2017,10,9,11,865,781,1646,1308
3405-000,2017,10,9,12,771,680,1451,1646
3405-000,2017,10,9,13,660,596,1256,1451
3405-000,2017,10,9,14,757,815,1572,1256
3405-000,2017,10,9,15,783,705,1488,1572
3405-000,2017,10,9,16,763,688,1451,1488
3405-000,2017,10,9,17,799,749,1548,1451
3405-000,2017,10,9,18,878,724,1602,1548
3405-000,2017,10,9,19,775,751,1526,1602
3405-000,2017,10,9,20,495,461,956,1526
3405-000,2017,10,9,21,381,398,779,956
3405-000,2017,10,9,22,267,274,541,779
3405-000,2017,10,9,23,198,202,400,541
3405-000,2017,10,9,24,130,156,286,400
3405-000,2017,10,10,1,71,78,149,286
3405-000,2017,10,10,2,32,36,68,149
3405-000,2017,10,10,3,39,44,83,68
3405-000,2017,10,10,4,62,83,145,83
3405-000,2017,10,10,5,113,88,201,145
3405-000,2017,10,10,6,290,241,531,201
3405-000,2017,10,10,7,641,544,1185,531
3405-000,2017,10,10,8,1313,1458,2771,1185
3405-000,2017,10,10,9,1362,1582,2944,2771
3405-000,2017,10,10,10,1072,874,1946,2944
3405-000,2017,10,10,11,1076,977,2053,1946
3405-000,2017,10,10,12,1044,938,1982,2053
3405-000,2017,10,10,13,907,884,1791,1982
3405-000,2017,10,10,14,955,907,1862,1791
3405-000,2017,10,10,15,1208,1066,2274,1862
3405-000,2017,10,10,16,1164,1041,2205,2274
3405-000,2017,10,10,17,1058,987,2045,2205
3405-000,2017,10,10,18,1346,1161,2507,2045
3405-000,2017,10,10,19,1236,1141,2377,2507
3405-000,2017,10,10,20,760,744,1504,2377
3405-000,2017,10,10,21,561,556,1117,1504
3405-000,2017,10,10,22,399,420,819,1117
3405-000,2017,10,10,23,253,265,518,819
3405-000,2017,10,10,24,142,123,265,518
3405-000,2017,10,11,1,85,85,170,265
3405-000,2017,10,11,2,62,81,143,170
3405-000,2017,10,11,3,55,64,119,143
3405-000,2017,10,11,4,72,114,186,119
3405-000,2017,10,11,5,118,77,195,186
3405-000,2017,10,11,6,225,162,387,195
3405-000,2017,10,11,7,569,487,1056,387
3405-000,2017,10,11,8,1113,1340,2453,1056
3405-000,2017,10,11,9,1375,1370,2745,2453
3405-000,2017,10,11,10,1121,958,2079,2745
3405-000,2017,10,11,11,1081,933,2014,2079
3405-000,2017,10,11,12,1042,890,1932,2014
3405-000,2017,10,11,13,861,819,1680,1932
3405-000,2017,10,11,14,1033,977,2010,1680
3405-000,2017,10,11,15,1208,1036,2244,2010
3405-000,2017,10,11,16,1153,1001,2154,2244
3405-000,2017,10,11,17,1101,866,1967,2154
3405-000,2017,10,11,18,1302,972,2274,1967
3405-000,2017,10,11,19,1201,1062,2263,2274
3405-000,2017,10,11,20,702,662,1364,2263
3405-000,2017,10,11,21,547,592,1139,1364
3405-000,2017,10,11,22,355,362,717,1139
3405-000,2017,10,11,23,211,222,433,717
3405-000,2017,10,11,24,165,144,309,433
3405-000,2017,10,12,1,90,90,180,309
3405-000,2017,10,12,2,41,58,99,180
3405-000,2017,10,12,3,56,64,120,99
3405-000,2017,10,12,4,69,66,135,120
3405-000,2017,10,12,5,126,107,233,135
3405-000,2017,10,12,6,282,240,522,233
3405-000,2017,10,12,7,604,564,1168,522
3405-000,2017,10,12,8,1231,1358,2589,1168
3405-000,2017,10,12,9,1397,1278,2675,2589
3405-000,2017,10,12,10,1245,1161,2406,2675
3405-000,2017,10,12,11,1160,1061,2221,2406
3405-000,2017,10,12,12,1209,1034,2243,2221
3405-000,2017,10,12,13,983,875,1858,2243
3405-000,2017,10,12,14,1052,954,2006,1858
3405-000,2017,10,12,15,1178,982,2160,2006
3405-000,2017,10,12,16,1187,1103,2290,2160
3405-000,2017,10,12,17,1113,953,2066,2290
3405-000,2017,10,12,18,1273,1084,2357,2066
3405-000,2017,10,12,19,1107,1002,2109,2357
3405-000,2017,10,12,20,770,735,1505,2109
3405-000,2017,10,12,21,580,595,1175,1505
3405-000,2017,10,12,22,367,436,803,1175
3405-000,2017,10,12,23,248,277,525,803
3405-000,2017,10,12,24,155,172,327,525
3405-000,2017,10,13,1,84,75,159,327
3405-000,2017,10,13,2,65,99,164,159
3405-000,2017,10,13,3,65,68,133,164
3405-000,2017,10,13,4,71,81,152,133
3405-000,2017,10,13,5,114,105,219,152
3405-000,2017,10,13,6,278,206,484,219
3405-000,2017,10,13,7,628,574,1202,484
3405-000,2017,10,13,8,1234,1353,2587,1202
3405-000,2017,10,13,9,1461,1558,3019,2587
3405-000,2017,10,13,10,1212,1079,2291,3019
3405-000,2017,10,13,11,1253,1177,2430,2291
3405-000,2017,10,13,12,1264,1048,2312,2430
3405-000,2017,10,13,13,1139,998,2137,2312
3405-000,2017,10,13,14,1183,1049,2232,2137
3405-000,2017,10,13,15,1275,1339,2614,2232
3405-000,2017,10,13,16,1340,1389,2729,2614
3405-000,2017,10,13,17,1246,1067,2313,2729
3405-000,2017,10,13,18,1669,1255,2924,2313
3405-000,2017,10,13,19,1570,1267,2837,2924
3405-000,2017,10,13,20,983,862,1845,2837
3405-000,2017,10,13,21,653,543,1196,1845
3405-000,2017,10,13,22,469,446,915,1196
3405-000,2017,10,13,23,283,249,532,915
3405-000,2017,10,13,24,172,151,323,532
3405-000,2017,10,14,1,112,126,238,323
3405-000,2017,10,14,2,70,48,118,238
3405-000,2017,10,14,3,66,66,132,118
3405-000,2017,10,14,4,69,73,142,132
3405-000,2017,10,14,5,116,84,200,142
3405-000,2017,10,14,6,236,170,406,200
3405-000,2017,10,14,7,541,371,912,406
3405-000,2017,10,14,8,896,752,1648,912
3405-000,2017,10,14,9,1004,862,1866,1648
3405-000,2017,10,14,10,950,884,1834,1866
3405-000,2017,10,14,11,994,862,1856,1834
3405-000,2017,10,14,12,950,829,1779,1856
3405-000,2017,10,14,13,852,956,1808,1779
3405-000,2017,10,14,14,874,828,1702,1808
3405-000,2017,10,14,15,989,820,1809,1702
3405-000,2017,10,14,16,1019,902,1921,1809
3405-000,2017,10,14,17,1027,887,1914,1921
3405-000,2017,10,14,18,1197,1084,2281,1914
3405-000,2017,10,14,19,932,854,1786,2281
3405-000,2017,10,14,20,572,543,1115,1786
3405-000,2017,10,14,21,370,345,715,1115
3405-000,2017,10,14,22,269,285,554,715
3405-000,2017,10,14,23,184,228,412,554
3405-000,2017,10,14,24,122,141,263,412
3405-000,2017,10,15,1,88,93,181,263
3405-000,2017,10,15,2,46,45,91,181
3405-000,2017,10,15,3,41,31,72,91
3405-000,2017,10,15,4,48,46,94,72
3405-000,2017,10,15,5,68,60,128,94
3405-000,2017,10,15,6,166,88,254,128
3405-000,2017,10,15,7,269,168,437,254
3405-000,2017,10,15,8,446,315,761,437
3405-000,2017,10,15,9,561,399,960,761
3405-000,2017,10,15,10,616,418,1034,960
3405-000,2017,10,15,11,715,504,1219,1034
3405-000,2017,10,15,12,660,542,1202,1219
3405-000,2017,10,15,13,640,554,1194,1202
3405-000,2017,10,15,14,656,645,1301,1194
3405-000,2017,10,15,15,707,748,1455,1301
3405-000,2017,10,15,16,740,802,1542,1455
3405-000,2017,10,15,17,756,786,1542,1542
3405-000,2017,10,15,18,837,776,1613,1542
3405-000,2017,10,15,19,670,790,1460,1613
3405-000,2017,10,15,20,509,670,1179,1460
3405-000,2017,10,15,21,384,534,918,1179
3405-000,2017,10,15,22,273,338,611,918
3405-000,2017,10,15,23,189,220,409,611
3405-000,2017,10,15,24,127,175,302,409
3405-000,2017,10,16,1,64,119,183,302
3405-000,2017,10,16,2,33,73,106,183
3405-000,2017,10,16,3,51,42,93,106
3405-000,2017,10,16,4,63,29,92,93
3405-000,2017,10,16,5,133,104,237,92
3405-000,2017,10,16,6,304,278,582,237
3405-000,2017,10,16,7,721,694,1415,582
3405-000,2017,10,16,8,1328,1644,2972,1415
3405-000,2017,10,16,9,1404,1442,2846,2972
3405-000,2017,10,16,10,1136,1001,2137,2846
3405-000,2017,10,16,11,1158,1060,2218,2137
3405-000,2017,10,16,12,1150,1061,2211,2218
3405-000,2017,10,16,13,976,898,1874,2211
3405-000,2017,10,16,14,1052,1047,2099,1874
3405-000,2017,10,16,15,1223,1218,2441,2099
3405-000,2017,10,16,16,1144,1077,2221,2441
3405-000,2017,10,16,17,1153,1050,2203,2221
3405-000,2017,10,16,18,1369,1190,2559,2203
3405-000,2017,10,16,19,1189,1072,2261,2559
3405-000,2017,10,16,20,777,729,1506,2261
3405-000,2017,10,16,21,610,602,1212,1506
3405-000,2017,10,16,22,405,427,832,1212
3405-000,2017,10,16,23,240,217,457,832
3405-000,2017,10,16,24,146,149,295,457
3405-000,2017,10,17,1,85,86,171,295
3405-000,2017,10,17,2,59,67,126,171
3405-000,2017,10,17,3,54,61,115,126
3405-000,2017,10,17,4,57,64,121,115
3405-000,2017,10,17,5,123,86,209,121
3405-000,2017,10,17,6,243,187,430,209
3405-000,2017,10,17,7,672,635,1307,430
3405-000,2017,10,17,8,1281,1363,2644,1307
3405-000,2017,10,17,9,1416,1375,2791,2644
3405-000,2017,10,17,10,1234,1011,2245,2791
3405-000,2017,10,17,11,1216,1054,2270,2245
3405-000,2017,10,17,12,1205,1054,2259,2270
3405-000,2017,10,17,13,993,920,1913,2259
3405-000,2017,10,17,14,1096,1099,2195,1913
3405-000,2017,10,17,15,1239,1097,2336,2195
3405-000,2017,10,17,16,1199,1169,2368,2336
3405-000,2017,10,17,17,1235,1090,2325,2368
3405-000,2017,10,17,18,1493,1235,2728,2325
3405-000,2017,10,17,19,1238,1129,2367,2728
3405-000,2017,10,17,20,714,687,1401,2367
3405-000,2017,10,17,21,607,594,1201,1401
3405-000,2017,10,17,22,427,452,879,1201
3405-000,2017,10,17,23,238,218,456,879
3405-000,2017,10,17,24,166,200,366,456
3405-000,2017,10,18,1,100,122,222,366
3405-000,2017,10,18,2,58,77,135,222
3405-000,2017,10,18,3,69,83,152,135
3405-000,2017,10,18,4,70,76,146,152
3405-000,2017,10,18,5,129,105,234,146
3405-000,2017,10,18,6,249,198,447,234
3405-000,2017,10,18,7,613,536,1149,447
3405-000,2017,10,18,8,1249,1370,2619,1149
3405-000,2017,10,18,9,1469,1373,2842,2619
3405-000,2017,10,18,10,1226,1021,2247,2842
3405-000,2017,10,18,11,1158,1049,2207,2247
3405-000,2017,10,18,12,1147,1046,2193,2207
3405-000,2017,10,18,13,999,942,1941,2193
3405-000,2017,10,18,14,1073,1048,2121,1941
3405-000,2017,10,18,15,1170,1002,2172,2121
3405-000,2017,10,18,16,1219,1149,2368,2172
3405-000,2017,10,18,17,1198,1094,2292,2368
3405-000,2017,10,18,18,1418,1192,2610,2292
3405-000,2017,10,18,19,1355,1144,2499,2610
3405-000,2017,10,18,20,694,580,1274,2499
3405-000,2017,10,18,21,594,599,1193,1274
3405-000,2017,10,18,22,412,470,882,1193
3405-000,2017,10,18,23,229,249,478,882
3405-000,2017,10,18,24,156,162,318,478
3405-000,2017,10,19,1,0,0,0,318
3405-000,2017,10,19,2,63,63,126,0
3405-000,2017,10,19,3,46,61,107,126
3405-000,2017,10,19,4,74,60,134,107
3405-000,2017,10,19,5,133,108,241,134
3405-000,2017,10,19,6,270,223,493,241
3405-000,2017,10,19,7,586,519,1105,493
3405-000,2017,10,19,8,1290,1466,2756,1105
3405-000,2017,10,19,9,1460,1388,2848,2756
3405-000,2017,10,19,10,1193,1043,2236,2848
3405-000,2017,10,19,11,1212,1080,2292,2236
3405-000,2017,10,19,12,1147,1006,2153,2292
3405-000,2017,10,19,13,957,816,1773,2153
3405-000,2017,10,19,14,1092,1041,2133,1773
3405-000,2017,10,19,15,1240,1121,2361,2133
3405-000,2017,10,19,16,1226,1039,2265,2361
3405-000,2017,10,19,17,1134,1051,2185,2265
3405-000,2017,10,19,18,1370,1129,2499,2185
3405-000,2017,10,19,19,1170,990,2160,2499
3405-000,2017,10,19,20,742,741,1483,2160
3405-000,2017,10,19,21,582,604,1186,1483
3405-000,2017,10,19,22,396,487,883,1186
3405-000,2017,10,19,23,276,256,532,883
3405-000,2017,10,19,24,151,172,323,532
3405-000,2017,10,20,1,97,121,218,323
3405-000,2017,10,20,2,62,93,155,218
3405-000,2017,10,20,3,55,68,123,155
3405-000,2017,10,20,4,76,90,166,123
3405-000,2017,10,20,5,131,91,222,166
3405-000,2017,10,20,6,247,187,434,222
3405-000,2017,10,20,7,625,612,1237,434
3405-000,2017,10,20,8,1270,1458,2728,1237
3405-000,2017,10,20,9,1431,1427,2858,2728
3405-000,2017,10,20,10,1190,947,2137,2858
3405-000,2017,10,20,11,1197,1041,2238,2137
3405-000,2017,10,20,12,1166,939,2105,2238
3405-000,2017,10,20,13,1037,970,2007,2105
3405-000,2017,10,20,14,1185,1158,2343,2007
3405-000,2017,10,20,15,1325,1206,2531,2343
3405-000,2017,10,20,16,1257,967,2224,2531
3405-000,2017,10,20,17,1229,961,2190,2224
3405-000,2017,10,20,18,1634,1320,2954,2190
3405-000,2017,10,20,19,1658,1271,2929,2954
3405-000,2017,10,20,20,977,752,1729,2929
3405-000,2017,10,20,21,649,614,1263,1729
3405-000,2017,10,20,22,470,467,937,1263
3405-000,2017,10,20,23,320,302,622,937
3405-000,2017,10,20,24,202,209,411,622
3405-000,2017,10,21,1,133,155,288,411
3405-000,2017,10,21,2,73,82,155,288
3405-000,2017,10,21,3,73,91,164,155
3405-000,2017,10,21,4,65,82,147,164
3405-000,2017,10,21,5,140,125,265,147
3405-000,2017,10,21,6,237,159,396,265
3405-000,2017,10,21,7,577,439,1016,396
3405-000,2017,10,21,8,909,746,1655,1016
3405-000,2017,10,21,9,1141,976,2117,1655
3405-000,2017,10,21,10,994,820,1814,2117
3405-000,2017,10,21,11,1015,834,1849,1814
3405-000,2017,10,21,12,935,895,1830,1849
3405-000,2017,10,21,13,912,927,1839,1830
3405-000,2017,10,21,14,819,753,1572,1839
3405-000,2017,10,21,15,927,855,1782,1572
3405-000,2017,10,21,16,1022,950,1972,1782
3405-000,2017,10,21,17,951,767,1718,1972
3405-000,2017,10,21,18,1186,957,2143,1718
3405-000,2017,10,21,19,1011,939,1950,2143
3405-000,2017,10,21,20,655,715,1370,1950
3405-000,2017,10,21,21,417,450,867,1370
3405-000,2017,10,21,22,307,365,672,867
3405-000,2017,10,21,23,216,304,520,672
3405-000,2017,10,21,24,128,152,280,520
3405-000,2017,10,22,1,71,71,142,280
3405-000,2017,10,22,2,65,62,127,142
3405-000,2017,10,22,3,49,38,87,127
3405-000,2017,10,22,4,52,40,92,87
3405-000,2017,10,22,5,63,33,96,92
3405-000,2017,10,22,6,146,85,231,96
3405-000,2017,10,22,7,280,170,450,231
3405-000,2017,10,22,8,433,338,771,450
3405-000,2017,10,22,9,554,380,934,771
3405-000,2017,10,22,10,603,432,1035,934
3405-000,2017,10,22,11,725,572,1297,1035
3405-000,2017,10,22,12,697,562,1259,1297
3405-000,2017,10,22,13,638,570,1208,1259
3405-000,2017,10,22,14,634,655,1289,1208
3405-000,2017,10,22,15,677,639,1316,1289
3405-000,2017,10,22,16,753,778,1531,1316
3405-000,2017,10,22,17,759,741,1500,1531
3405-000,2017,10,22,18,726,662,1388,1500
3405-000,2017,10,22,19,693,623,1316,1388
3405-000,2017,10,22,20,517,554,1071,1316
3405-000,2017,10,22,21,383,456,839,1071
3405-000,2017,10,22,22,262,357,619,839
3405-000,2017,10,22,23,227,268,495,619
3405-000,2017,10,22,24,109,170,279,495
3405-000,2017,10,23,1,59,73,132,279
3405-000,2017,10,23,2,45,72,117,132
3405-000,2017,10,23,3,39,46,85,117
3405-000,2017,10,23,4,67,77,144,85
3405-000,2017,10,23,5,141,116,257,144
3405-000,2017,10,23,6,298,242,540,257
3405-000,2017,10,23,7,754,779,1533,540
3405-000,2017,10,23,8,1336,1739,3075,1533
3405-000,2017,10,23,9,1402,1496,2898,3075
3405-000,2017,10,23,10,1170,974,2144,2898
3405-000,2017,10,23,11,1141,1020,2161,2144
3405-000,2017,10,23,12,1117,1009,2126,2161
3405-000,2017,10,23,13,894,848,1742,2126
3405-000,2017,10,23,14,1098,1079,2177,1742
3405-000,2017,10,23,15,1224,1149,2373,2177
3405-000,2017,10,23,16,1158,1268,2426,2373
3405-000,2017,10,23,17,1173,1212,2385,2426
3405-000,2017,10,23,18,1262,1053,2315,2385
3405-000,2017,10,23,19,1222,1024,2246,2315
3405-000,2017,10,23,20,752,684,1436,2246
3405-000,2017,10,23,21,603,652,1255,1436
3405-000,2017,10,23,22,373,450,823,1255
3405-000,2017,10,23,23,284,297,581,823
3405-000,2017,10,23,24,152,138,290,581
3405-000,2017,10,24,1,85,91,176,290
3405-000,2017,10,24,2,66,87,153,176
3405-000,2017,10,24,3,66,82,148,153
3405-000,2017,10,24,4,66,68,134,148
3405-000,2017,10,24,5,154,128,282,134
3405-000,2017,10,24,6,252,210,462,282
3405-000,2017,10,24,7,632,546,1178,462
3405-000,2017,10,24,8,1294,1444,2738,1178
3405-000,2017,10,24,9,1483,1376,2859,2738
3405-000,2017,10,24,10,1185,1030,2215,2859
3405-000,2017,10,24,11,1188,1034,2222,2215
3405-000,2017,10,24,12,1135,982,2117,2222
3405-000,2017,10,24,13,941,895,1836,2117
3405-000,2017,10,24,14,1068,1051,2119,1836
3405-000,2017,10,24,15,1170,1096,2266,2119
3405-000,2017,10,24,16,1168,978,2146,2266
3405-000,2017,10,24,17,1156,1064,2220,2146
3405-000,2017,10,24,18,1303,1136,2439,2220
3405-000,2017,10,24,19,1149,999,2148,2439
3405-000,2017,10,24,20,762,752,1514,2148
3405-000,2017,10,24,21,586,562,1148,1514
3405-000,2017,10,24,22,401,448,849,1148
3405-000,2017,10,24,23,264,258,522,849
3405-000,2017,10,24,24,130,129,259,522
3405-000,2017,10,25,1,101,113,214,259
3405-000,2017,10,25,2,56,62,118,214
3405-000,2017,10,25,3,55,62,117,118
3405-000,2017,10,25,4,61,77,138,117
3405-000,2017,10,25,5,135,106,241,138
3405-000,2017,10,25,6,256,214,470,241
3405-000,2017,10,25,7,665,525,1190,470
3405-000,2017,10,25,8,1206,1414,2620,1190
3405-000,2017,10,25,9,1472,1442,2914,2620
3405-000,2017,10,25,10,1110,943,2053,2914
3405-000,2017,10,25,11,1235,1102,2337,2053
3405-000,2017,10,25,12,1161,1025,2186,2337
3405-000,2017,10,25,13,958,836,1794,2186
3405-000,2017,10,25,14,1092,1022,2114,1794
3405-000,2017,10,25,15,1271,1081,2352,2114
3405-000,2017,10,25,16,1059,867,1926,2352
3405-000,2017,10,25,17,1115,1034,2149,1926
3405-000,2017,10,25,18,1382,1198,2580,2149
3405-000,2017,10,25,19,1308,1164,2472,2580
3405-000,2017,10,25,20,713,627,1340,2472
3405-000,2017,10,25,21,537,571,1108,1340
3405-000,2017,10,25,22,384,428,812,1108
3405-000,2017,10,25,23,245,199,444,812
3405-000,2017,10,25,24,145,118,263,444
3405-000,2017,10,26,1,90,95,185,263
3405-000,2017,10,26,2,53,68,121,185
3405-000,2017,10,26,3,60,58,118,121
3405-000,2017,10,26,4,81,75,156,118
3405-000,2017,10,26,5,152,111,263,156
3405-000,2017,10,26,6,264,219,483,263
3405-000,2017,10,26,7,638,515,1153,483
3405-000,2017,10,26,8,1245,1392,2637,1153
3405-000,2017,10,26,9,1413,1344,2757,2637
3405-000,2017,10,26,10,1134,1030,2164,2757
3405-000,2017,10,26,11,1096,1028,2124,2164
3405-000,2017,10,26,12,1118,972,2090,2124
3405-000,2017,10,26,13,941,801,1742,2090
3405-000,2017,10,26,14,1112,982,2094,1742
3405-000,2017,10,26,15,1150,1103,2253,2094
3405-000,2017,10,26,16,1245,1033,2278,2253
3405-000,2017,10,26,17,1153,1100,2253,2278
3405-000,2017,10,26,18,1262,1217,2479,2253
3405-000,2017,10,26,19,1265,1017,2282,2479
3405-000,2017,10,26,20,750,686,1436,2282
3405-000,2017,10,26,21,549,621,1170,1436
3405-000,2017,10,26,22,404,449,853,1170
3405-000,2017,10,26,23,235,235,470,853
3405-000,2017,10,26,24,167,149,316,470
3405-000,2017,10,27,1,101,99,200,316
3405-000,2017,10,27,2,69,65,134,200
3405-000,2017,10,27,3,53,49,102,134
3405-000,2017,10,27,4,71,69,140,102
3405-000,2017,10,27,5,127,116,243,140
3405-000,2017,10,27,6,265,200,465,243
3405-000,2017,10,27,7,645,540,1185,465
3405-000,2017,10,27,8,1259,1391,2650,1185
3405-000,2017,10,27,9,1419,1403,2822,2650
3405-000,2017,10,27,10,1218,1025,2243,2822
3405-000,2017,10,27,11,1162,1026,2188,2243
3405-000,2017,10,27,12,1200,1037,2237,2188
3405-000,2017,10,27,13,1029,877,1906,2237
3405-000,2017,10,27,14,1098,969,2067,1906
3405-000,2017,10,27,15,1278,1038,2316,2067
3405-000,2017,10,27,16,1277,1003,2280,2316
3405-000,2017,10,27,17,1238,1041,2279,2280
3405-000,2017,10,27,18,1585,1266,2851,2279
3405-000,2017,10,27,19,1609,1196,2805,2851
3405-000,2017,10,27,20,1041,825,1866,2805
3405-000,2017,10,27,21,646,610,1256,1866
3405-000,2017,10,27,22,434,441,875,1256
3405-000,2017,10,27,23,308,266,574,875
3405-000,2017,10,27,24,189,194,383,574
3405-000,2017,10,28,1,114,111,225,383
3405-000,2017,10,28,2,74,75,149,225
3405-000,2017,10,28,3,57,72,129,149
3405-000,2017,10,28,4,80,90,170,129
3405-000,2017,10,28,5,125,91,216,170
3405-000,2017,10,28,6,239,166,405,216
3405-000,2017,10,28,7,534,405,939,405
3405-000,2017,10,28,8,827,763,1590,939
3405-000,2017,10,28,9,1067,919,1986,1590
3405-000,2017,10,28,10,1045,924,1969,1986
3405-000,2017,10,28,11,987,976,1963,1969
3405-000,2017,10,28,12,1061,1083,2144,1963
3405-000,2017,10,28,13,870,1057,1927,2144
3405-000,2017,10,28,14,894,930,1824,1927
3405-000,2017,10,28,15,952,862,1814,1824
3405-000,2017,10,28,16,1019,936,1955,1814
3405-000,2017,10,28,17,1144,854,1998,1955
3405-000,2017,10,28,18,1284,1095,2379,1998
3405-000,2017,10,28,19,1005,906,1911,2379
3405-000,2017,10,28,20,643,618,1261,1911
3405-000,2017,10,28,21,441,424,865,1261
3405-000,2017,10,28,22,305,316,621,865
3405-000,2017,10,28,23,207,196,403,621
3405-000,2017,10,28,24,130,166,296,403
3405-000,2017,10,29,1,94,85,179,296
3405-000,2017,10,29,2,76,49,125,179
3405-000,2017,10,29,3,53,49,102,125
3405-000,2017,10,29,4,57,42,99,102
3405-000,2017,10,29,5,80,43,123,99
3405-000,2017,10,29,6,152,78,230,123
3405-000,2017,10,29,7,264,182,446,230
3405-000,2017,10,29,8,404,296,700,446
3405-000,2017,10,29,9,576,378,954,700
3405-000,2017,10,29,10,648,431,1079,954
3405-000,2017,10,29,11,678,496,1174,1079
3405-000,2017,10,29,12,634,597,1231,1174
3405-000,2017,10,29,13,569,598,1167,1231
3405-000,2017,10,29,14,663,653,1316,1167
3405-000,2017,10,29,15,739,678,1417,1316
3405-000,2017,10,29,16,793,723,1516,1417
3405-000,2017,10,29,17,784,798,1582,1516
3405-000,2017,10,29,18,840,826,1666,1582
3405-000,2017,10,29,19,698,684,1382,1666
3405-000,2017,10,29,20,514,550,1064,1382
3405-000,2017,10,29,21,462,485,947,1064
3405-000,2017,10,29,22,271,408,679,947
3405-000,2017,10,29,23,187,306,493,679
3405-000,2017,10,29,24,116,155,271,493
3405-000,2017,10,30,1,85,123,208,271
3405-000,2017,10,30,2,44,63,107,208
3405-000,2017,10,30,3,48,45,93,107
3405-000,2017,10,30,4,75,63,138,93
3405-000,2017,10,30,5,138,106,244,138
3405-000,2017,10,30,6,277,276,553,244
3405-000,2017,10,30,7,695,715,1410,553
3405-000,2017,10,30,8,1279,1607,2886,1410
3405-000,2017,10,30,9,1364,1521,2885,2886
3405-000,2017,10,30,10,1144,988,2132,2885
3405-000,2017,10,30,11,1166,1031,2197,2132
3405-000,2017,10,30,12,1089,955,2044,2197
3405-000,2017,10,30,13,926,909,1835,2044
3405-000,2017,10,30,14,938,1081,2019,1835
3405-000,2017,10,30,15,1171,1150,2321,2019
3405-000,2017,10,30,16,1219,1115,2334,2321
3405-000,2017,10,30,17,1184,1048,2232,2334
3405-000,2017,10,30,18,1245,1158,2403,2232
3405-000,2017,10,30,19,1236,1063,2299,2403
3405-000,2017,10,30,20,716,698,1414,2299
3405-000,2017,10,30,21,583,625,1208,1414
3405-000,2017,10,30,22,430,419,849,1208
3405-000,2017,10,30,23,231,215,446,849
3405-000,2017,10,30,24,148,142,290,446
3405-000,2017,10,31,1,73,105,178,290
3405-000,2017,10,31,2,53,65,118,178
3405-000,2017,10,31,3,50,53,103,118
3405-000,2017,10,31,4,73,81,154,103
3405-000,2017,10,31,5,121,114,235,154
3405-000,2017,10,31,6,237,207,444,235
3405-000,2017,10,31,7,556,539,1095,444
3405-000,2017,10,31,8,1256,1409,2665,1095
3405-000,2017,10,31,9,1459,1386,2845,2665
3405-000,2017,10,31,10,1191,1039,2230,2845
3405-000,2017,10,31,11,1192,1072,2264,2230
3405-000,2017,10,31,12,1127,976,2103,2264
3405-000,2017,10,31,13,954,890,1844,2103
3405-000,2017,10,31,14,1081,985,2066,1844
3405-000,2017,10,31,15,1262,1092,2354,2066
3405-000,2017,10,31,16,1190,1099,2289,2354
3405-000,2017,10,31,17,1182,995,2177,2289
3405-000,2017,10,31,18,1340,1154,2494,2177
3405-000,2017,10,31,19,1235,1088,2323,2494
3405-000,2017,10,31,20,754,641,1395,2323
3405-000,2017,10,31,21,598,617,1215,1395
3405-000,2017,10,31,22,427,429,856,1215
3405-000,2017,10,31,23,255,242,497,856
3405-000,2017,10,31,24,182,170,352,497
3405-000,2017,11,1,1,86,100,186,352
3405-000,2017,11,1,2,74,78,152,186
3405-000,2017,11,1,3,59,71,130,152
3405-000,2017,11,1,4,78,92,170,130
3405-000,2017,11,1,5,129,86,215,170
3405-000,2017,11,1,6,272,187,459,215
3405-000,2017,11,1,7,608,560,1168,459
3405-000,2017,11,1,8,1203,1386,2589,1168
3405-000,2017,11,1,9,1465,1364,2829,2589
3405-000,2017,11,1,10,1094,976,2070,2829
3405-000,2017,11,1,11,1115,1119,2234,2070
3405-000,2017,11,1,12,1060,969,2029,2234
3405-000,2017,11,1,13,892,875,1767,2029
3405-000,2017,11,1,14,1070,1039,2109,1767
3405-000,2017,11,1,15,1201,1092,2293,2109
3405-000,2017,11,1,16,1158,1090,2248,2293
3405-000,2017,11,1,17,1157,1071,2228,2248
3405-000,2017,11,1,18,1380,1212,2592,2228
3405-000,2017,11,1,19,1297,1054,2351,2592
3405-000,2017,11,1,20,735,659,1394,2351
3405-000,2017,11,1,21,538,515,1053,1394
3405-000,2017,11,1,22,379,391,770,1053
3405-000,2017,11,1,23,227,226,453,770
3405-000,2017,11,1,24,136,161,297,453
3405-000,2017,11,2,1,81,103,184,297
3405-000,2017,11,2,2,76,73,149,184
3405-000,2017,11,2,3,47,85,132,149
3405-000,2017,11,2,4,69,77,146,132
3405-000,2017,11,2,5,139,113,252,146
3405-000,2017,11,2,6,247,194,441,252
3405-000,2017,11,2,7,652,524,1176,441
3405-000,2017,11,2,8,1246,1382,2628,1176
3405-000,2017,11,2,9,1429,1358,2787,2628
3405-000,2017,11,2,10,1181,1005,2186,2787
3405-000,2017,11,2,11,1179,1046,2225,2186
3405-000,2017,11,2,12,1113,948,2061,2225
3405-000,2017,11,2,13,961,875,1836,2061
3405-000,2017,11,2,14,1117,987,2104,1836
3405-000,2017,11,2,15,1184,1137,2321,2104
3405-000,2017,11,2,16,1209,1116,2325,2321
3405-000,2017,11,2,17,1170,1099,2269,2325
3405-000,2017,11,2,18,1314,1082,2396,2269
3405-000,2017,11,2,19,1191,982,2173,2396
3405-000,2017,11,2,20,754,628,1382,2173
3405-000,2017,11,2,21,595,583,1178,1382
3405-000,2017,11,2,22,387,416,803,1178
3405-000,2017,11,2,23,243,219,462,803
3405-000,2017,11,2,24,150,148,298,462
3405-000,2017,11,3,1,90,91,181,298
3405-000,2017,11,3,2,62,71,133,181
3405-000,2017,11,3,3,57,64,121,133
3405-000,2017,11,3,4,69,66,135,121
3405-000,2017,11,3,5,122,96,218,135
3405-000,2017,11,3,6,227,199,426,218
3405-000,2017,11,3,7,579,531,1110,426
3405-000,2017,11,3,8,1195,1378,2573,1110
3405-000,2017,11,3,9,1395,1352,2747,2573
3405-000,2017,11,3,10,1134,965,2099,2747
3405-000,2017,11,3,11,1101,1006,2107,2099
3405-000,2017,11,3,12,1111,913,2024,2107
3405-000,2017,11,3,13,971,751,1722,2024
3405-000,2017,11,3,14,1023,947,1970,1722
3405-000,2017,11,3,15,1262,1054,2316,1970
3405-000,2017,11,3,16,1283,1078,2361,2316
3405-000,2017,11,3,17,1184,1038,2222,2361
3405-000,2017,11,3,18,1557,1165,2722,2222
3405-000,2017,11,3,19,1544,1199,2743,2722
3405-000,2017,11,3,20,893,734,1627,2743
3405-000,2017,11,3,21,690,574,1264,1627
3405-000,2017,11,3,22,451,449,900,1264
3405-000,2017,11,3,23,309,243,552,900
3405-000,2017,11,3,24,171,157,328,552
3405-000,2017,11,4,1,122,98,220,328
3405-000,2017,11,4,2,58,62,120,220
3405-000,2017,11,4,3,55,58,113,120
3405-000,2017,11,4,4,56,76,132,113
3405-000,2017,11,4,5,107,96,203,132
3405-000,2017,11,4,6,233,159,392,203
3405-000,2017,11,4,7,497,370,867,392
3405-000,2017,11,4,8,794,690,1484,867
3405-000,2017,11,4,9,1012,845,1857,1484
3405-000,2017,11,4,10,992,825,1817,1857
3405-000,2017,11,4,11,951,892,1843,1817
3405-000,2017,11,4,12,995,939,1934,1843
3405-000,2017,11,4,13,829,1073,1902,1934
3405-000,2017,11,4,14,813,838,1651,1902
3405-000,2017,11,4,15,911,876,1787,1651
3405-000,2017,11,4,16,992,899,1891,1787
3405-000,2017,11,4,17,1064,891,1955,1891
3405-000,2017,11,4,18,1196,916,2112,1955
3405-000,2017,11,4,19,900,755,1655,2112
3405-000,2017,11,4,20,561,542,1103,1655
3405-000,2017,11,4,21,375,389,764,1103
3405-000,2017,11,4,22,317,304,621,764
3405-000,2017,11,4,23,190,203,393,621
3405-000,2017,11,4,24,125,146,271,393
3405-000,2017,11,5,1,97,96,193,271
3405-000,2017,11,5,2,49,61,110,193
3405-000,2017,11,5,3,33,45,78,110
3405-000,2017,11,5,4,40,30,70,78
3405-000,2017,11,5,5,72,38,110,70
3405-000,2017,11,5,6,117,61,178,110
3405-000,2017,11,5,7,245,194,439,178
3405-000,2017,11,5,8,417,257,674,439
3405-000,2017,11,5,9,493,359,852,674
3405-000,2017,11,5,10,582,423,1005,852
3405-000,2017,11,5,11,721,492,1213,1005
3405-000,2017,11,5,12,661,504,1165,1213
3405-000,2017,11,5,13,606,583,1189,1165
3405-000,2017,11,5,14,648,658,1306,1189
3405-000,2017,11,5,15,777,713,1490,1306
3405-000,2017,11,5,16,853,700,1553,1490
3405-000,2017,11,5,17,799,830,1629,1553
3405-000,2017,11,5,18,842,873,1715,1629
3405-000,2017,11,5,19,696,735,1431,1715
3405-000,2017,11,5,20,540,535,1075,1431
3405-000,2017,11,5,21,424,498,922,1075
3405-000,2017,11,5,22,328,385,713,922
3405-000,2017,11,5,23,206,295,501,713
3405-000,2017,11,5,24,134,181,315,501
3405-000,2017,11,6,1,73,105,178,315
3405-000,2017,11,6,2,34,73,107,178
3405-000,2017,11,6,3,46,55,101,107
3405-000,2017,11,6,4,63,67,130,101
3405-000,2017,11,6,5,149,105,254,130
3405-000,2017,11,6,6,304,232,536,254
3405-000,2017,11,6,7,714,682,1396,536
3405-000,2017,11,6,8,1250,1658,2908,1396
3405-000,2017,11,6,9,1351,1488,2839,2908
3405-000,2017,11,6,10,1131,1003,2134,2839
3405-000,2017,11,6,11,1134,996,2130,2134
3405-000,2017,11,6,12,1078,963,2041,2130
3405-000,2017,11,6,13,936,831,1767,2041
3405-000,2017,11,6,14,1044,1034,2078,1767
3405-000,2017,11,6,15,1207,1167,2374,2078
3405-000,2017,11,6,16,1253,1098,2351,2374
3405-000,2017,11,6,17,1226,1028,2254,2351
3405-000,2017,11,6,18,1313,1186,2499,2254
3405-000,2017,11,6,19,1225,1073,2298,2499
3405-000,2017,11,6,20,723,691,1414,2298
3405-000,2017,11,6,21,549,614,1163,1414
3405-000,2017,11,6,22,344,419,763,1163
3405-000,2017,11,6,23,272,223,495,763
3405-000,2017,11,6,24,148,140,288,495
3405-000,2017,11,7,1,78,94,172,288
3405-000,2017,11,7,2,70,71,141,172
3405-000,2017,11,7,3,40,53,93,141
3405-000,2017,11,7,4,78,74,152,93
3405-000,2017,11,7,5,151,107,258,152
3405-000,2017,11,7,6,263,228,491,258
3405-000,2017,11,7,7,613,510,1123,491
3405-000,2017,11,7,8,1240,1441,2681,1123
3405-000,2017,11,7,9,1425,1373,2798,2681
3405-000,2017,11,7,10,1158,954,2112,2798
3405-000,2017,11,7,11,1260,1114,2374,2112
3405-000,2017,11,7,12,1130,1022,2152,2374
3405-000,2017,11,7,13,889,837,1726,2152
3405-000,2017,11,7,14,1057,1029,2086,1726
3405-000,2017,11,7,15,1245,1123,2368,2086
3405-000,2017,11,7,16,1285,1017,2302,2368
3405-000,2017,11,7,17,1125,1056,2181,2302
3405-000,2017,11,7,18,1344,1081,2425,2181
3405-000,2017,11,7,19,1172,1047,2219,2425
3405-000,2017,11,7,20,690,719,1409,2219
3405-000,2017,11,7,21,580,597,1177,1409
3405-000,2017,11,7,22,397,381,778,1177
3405-000,2017,11,7,23,258,206,464,778
3405-000,2017,11,7,24,170,138,308,464
3405-000,2017,11,8,1,92,107,199,308
3405-000,2017,11,8,2,59,60,119,199
3405-000,2017,11,8,3,57,47,104,119
3405-000,2017,11,8,4,68,71,139,104
3405-000,2017,11,8,5,138,109,247,139
3405-000,2017,11,8,6,250,213,463,247
3405-000,2017,11,8,7,620,514,1134,463
3405-000,2017,11,8,8,1234,1369,2603,1134
3405-000,2017,11,8,9,1359,1350,2709,2603
3405-000,2017,11,8,10,1125,1029,2154,2709
3405-000,2017,11,8,11,1241,986,2227,2154
3405-000,2017,11,8,12,1116,961,2077,2227
3405-000,2017,11,8,13,910,902,1812,2077
3405-000,2017,11,8,14,1041,1058,2099,1812
3405-000,2017,11,8,15,1222,1080,2302,2099
3405-000,2017,11,8,16,1125,1054,2179,2302
3405-000,2017,11,8,17,1182,1082,2264,2179
3405-000,2017,11,8,18,1393,1194,2587,2264
3405-000,2017,11,8,19,1310,1134,2444,2587
3405-000,2017,11,8,20,726,706,1432,2444
3405-000,2017,11,8,21,506,586,1092,1432
3405-000,2017,11,8,22,393,384,777,1092
3405-000,2017,11,8,23,233,219,452,777
3405-000,2017,11,8,24,155,139,294,452
3405-000,2017,11,9,1,95,103,198,294
3405-000,2017,11,9,2,66,65,131,198
3405-000,2017,11,9,3,60,55,115,131
3405-000,2017,11,9,4,76,71,147,115
3405-000,2017,11,9,5,119,106,225,147
3405-000,2017,11,9,6,248,187,435,225
3405-000,2017,11,9,7,632,514,1146,435
3405-000,2017,11,9,8,1253,1429,2682,1146
3405-000,2017,11,9,9,1455,1460,2915,2682
3405-000,2017,11,9,10,1185,966,2151,2915
3405-000,2017,11,9,11,1191,1063,2254,2151
3405-000,2017,11,9,12,1151,1031,2182,2254
3405-000,2017,11,9,13,903,862,1765,2182
3405-000,2017,11,9,14,1083,1023,2106,1765
3405-000,2017,11,9,15,1159,1158,2317,2106
3405-000,2017,11,9,16,1156,1039,2195,2317
3405-000,2017,11,9,17,1149,1108,2257,2195
3405-000,2017,11,9,18,1431,1135,2566,2257
3405-000,2017,11,9,19,1133,1032,2165,2566
3405-000,2017,11,9,20,735,703,1438,2165
3405-000,2017,11,9,21,586,565,1151,1438
3405-000,2017,11,9,22,401,441,842,1151
3405-000,2017,11,9,23,235,243,478,842
3405-000,2017,11,9,24,160,151,311,478
3405-000,2017,11,10,1,113,109,222,311
3405-000,2017,11,10,2,64,54,118,222
3405-000,2017,11,10,3,61,46,107,118
3405-000,2017,11,10,4,74,60,134,107
3405-000,2017,11,10,5,121,111,232,134
3405-000,2017,11,10,6,266,197,463,232
3405-000,2017,11,10,7,644,543,1187,463
3405-000,2017,11,10,8,1259,1384,2643,1187
3405-000,2017,11,10,9,1435,1467,2902,2643
3405-000,2017,11,10,10,1210,1118,2328,2902
3405-000,2017,11,10,11,1164,1013,2177,2328
3405-000,2017,11,10,12,1163,976,2139,2177
3405-000,2017,11,10,13,969,917,1886,2139
3405-000,2017,11,10,14,1087,975,2062,1886
3405-000,2017,11,10,15,1208,1181,2389,2062
3405-000,2017,11,10,16,1260,1097,2357,2389
3405-000,2017,11,10,17,1243,1052,2295,2357
3405-000,2017,11,10,18,1558,1204,2762,2295
3405-000,2017,11,10,19,1585,1217,2802,2762
3405-000,2017,11,10,20,1007,812,1819,2802
3405-000,2017,11,10,21,688,575,1263,1819
3405-000,2017,11,10,22,413,358,771,1263
3405-000,2017,11,10,23,320,220,540,771
3405-000,2017,11,10,24,178,133,311,540
3405-000,2017,11,11,1,82,96,178,311
3405-000,2017,11,11,2,87,64,151,178
3405-000,2017,11,11,3,63,69,132,151
3405-000,2017,11,11,4,75,78,153,132
3405-000,2017,11,11,5,117,85,202,153
3405-000,2017,11,11,6,246,163,409,202
3405-000,2017,11,11,7,490,365,855,409
3405-000,2017,11,11,8,866,676,1542,855
3405-000,2017,11,11,9,987,860,1847,1542
3405-000,2017,11,11,10,1027,785,1812,1847
3405-000,2017,11,11,11,1023,973,1996,1812
3405-000,2017,11,11,12,900,957,1857,1996
3405-000,2017,11,11,13,869,1017,1886,1857
3405-000,2017,11,11,14,949,915,1864,1886
3405-000,2017,11,11,15,950,877,1827,1864
3405-000,2017,11,11,16,959,811,1770,1827
3405-000,2017,11,11,17,1000,845,1845,1770
3405-000,2017,11,11,18,1155,966,2121,1845
3405-000,2017,11,11,19,927,815,1742,2121
3405-000,2017,11,11,20,556,522,1078,1742
3405-000,2017,11,11,21,347,402,749,1078
3405-000,2017,11,11,22,314,296,610,749
3405-000,2017,11,11,23,209,213,422,610
3405-000,2017,11,11,24,121,121,242,422
3405-000,2017,11,12,1,88,86,174,242
3405-000,2017,11,12,2,56,70,126,174
3405-000,2017,11,12,3,44,37,81,126
3405-000,2017,11,12,4,45,45,90,81
3405-000,2017,11,12,5,47,32,79,90
3405-000,2017,11,12,6,134,70,204,79
3405-000,2017,11,12,7,256,174,430,204
3405-000,2017,11,12,8,377,298,675,430
3405-000,2017,11,12,9,496,381,877,675
3405-000,2017,11,12,10,534,441,975,877
3405-000,2017,11,12,11,600,459,1059,975
3405-000,2017,11,12,12,655,512,1167,1059
3405-000,2017,11,12,13,593,532,1125,1167
3405-000,2017,11,12,14,687,626,1313,1125
3405-000,2017,11,12,15,675,714,1389,1313
3405-000,2017,11,12,16,772,750,1522,1389
3405-000,2017,11,12,17,798,785,1583,1522
3405-000,2017,11,12,18,825,936,1761,1583
3405-000,2017,11,12,19,681,866,1547,1761
3405-000,2017,11,12,20,520,791,1311,1547
3405-000,2017,11,12,21,410,538,948,1311
3405-000,2017,11,12,22,299,475,774,948
3405-000,2017,11,12,23,213,290,503,774
3405-000,2017,11,12,24,122,175,297,503
3405-000,2017,11,13,1,58,84,142,297
3405-000,2017,11,13,2,55,68,123,142
3405-000,2017,11,13,3,46,42,88,123
3405-000,2017,11,13,4,66,71,137,88
3405-000,2017,11,13,5,132,115,247,137
3405-000,2017,11,13,6,304,248,552,247
3405-000,2017,11,13,7,702,642,1344,552
3405-000,2017,11,13,8,1287,1690,2977,1344
3405-000,2017,11,13,9,1322,1472,2794,2977
3405-000,2017,11,13,10,1180,948,2128,2794
3405-000,2017,11,13,11,1158,1057,2215,2128
3405-000,2017,11,13,12,1091,980,2071,2215
3405-000,2017,11,13,13,956,941,1897,2071
3405-000,2017,11,13,14,1040,1064,2104,1897
3405-000,2017,11,13,15,1234,1132,2366,2104
3405-000,2017,11,13,16,1135,1125,2260,2366
3405-000,2017,11,13,17,1085,1090,2175,2260
3405-000,2017,11,13,18,1229,1107,2336,2175
3405-000,2017,11,13,19,1201,1056,2257,2336
3405-000,2017,11,13,20,707,729,1436,2257
3405-000,2017,11,13,21,587,541,1128,1436
3405-000,2017,11,13,22,379,394,773,1128
3405-000,2017,11,13,23,243,221,464,773
3405-000,2017,11,13,24,151,143,294,464
3405-000,2017,11,14,1,88,82,170,294
3405-000,2017,11,14,2,54,54,108,170
3405-000,2017,11,14,3,49,47,96,108
3405-000,2017,11,14,4,66,93,159,96
3405-000,2017,11,14,5,120,118,238,159
3405-000,2017,11,14,6,231,209,440,238
3405-000,2017,11,14,7,628,528,1156,440
3405-000,2017,11,14,8,1288,1396,2684,1156
3405-000,2017,11,14,9,1440,1413,2853,2684
3405-000,2017,11,14,10,1138,1058,2196,2853
3405-000,2017,11,14,11,1136,1101,2237,2196
3405-000,2017,11,14,12,1144,1108,2252,2237
3405-000,2017,11,14,13,962,876,1838,2252
3405-000,2017,11,14,14,1144,1057,2201,1838
3405-000,2017,11,14,15,1192,1056,2248,2201
3405-000,2017,11,14,16,1253,1152,2405,2248
3405-000,2017,11,14,17,1145,1047,2192,2405
3405-000,2017,11,14,18,1353,1130,2483,2192
3405-000,2017,11,14,19,1165,1093,2258,2483
3405-000,2017,11,14,20,749,667,1416,2258
3405-000,2017,11,14,21,626,581,1207,1416
3405-000,2017,11,14,22,387,398,785,1207
3405-000,2017,11,14,23,234,229,463,785
3405-000,2017,11,14,24,140,123,263,463
3405-000,2017,11,15,1,78,74,152,263
3405-000,2017,11,15,2,59,55,114,152
3405-000,2017,11,15,3,54,51,105,114
3405-000,2017,11,15,4,69,59,128,105
3405-000,2017,11,15,5,117,103,220,128
3405-000,2017,11,15,6,251,183,434,220
3405-000,2017,11,15,7,627,519,1146,434
3405-000,2017,11,15,8,1245,1421,2666,1146
3405-000,2017,11,15,9,1461,1437,2898,2666
3405-000,2017,11,15,10,1151,1052,2203,2898
3405-000,2017,11,15,11,1234,1007,2241,2203
3405-000,2017,11,15,12,1120,961,2081,2241
3405-000,2017,11,15,13,962,881,1843,2081
3405-000,2017,11,15,14,1233,915,2148,1843
3405-000,2017,11,15,15,1188,744,1932,2148
3405-000,2017,11,15,16,1280,1096,2376,1932
3405-000,2017,11,15,17,1165,1030,2195,2376
3405-000,2017,11,15,18,1452,1196,2648,2195
3405-000,2017,11,15,19,1250,1085,2335,2648
3405-000,2017,11,15,20,759,700,1459,2335
3405-000,2017,11,15,21,530,507,1037,1459
3405-000,2017,11,15,22,380,366,746,1037
3405-000,2017,11,15,23,249,205,454,746
3405-000,2017,11,15,24,152,148,300,454
3405-000,2017,11,16,1,105,97,202,300
3405-000,2017,11,16,2,52,60,112,202
3405-000,2017,11,16,3,60,53,113,112
3405-000,2017,11,16,4,73,68,141,113
3405-000,2017,11,16,5,119,111,230,141
3405-000,2017,11,16,6,299,185,484,230
3405-000,2017,11,16,7,605,506,1111,484
3405-000,2017,11,16,8,840,1362,2202,1111
3405-000,2017,11,16,9,1027,1432,2459,2202
3405-000,2017,11,16,10,1128,1073,2201,2459
3405-000,2017,11,16,11,1134,1034,2168,2201
3405-000,2017,11,16,12,1072,916,1988,2168
3405-000,2017,11,16,13,937,869,1806,1988
3405-000,2017,11,16,14,1022,1041,2063,1806
3405-000,2017,11,16,15,1104,1059,2163,2063
3405-000,2017,11,16,16,1142,888,2030,2163
3405-000,2017,11,16,17,1147,944,2091,2030
3405-000,2017,11,16,18,1306,1096,2402,2091
3405-000,2017,11,16,19,1215,1067,2282,2402
3405-000,2017,11,16,20,741,719,1460,2282
3405-000,2017,11,16,21,576,560,1136,1460
3405-000,2017,11,16,22,368,386,754,1136
3405-000,2017,11,16,23,245,216,461,754
3405-000,2017,11,16,24,147,130,277,461
3405-000,2017,11,17,1,105,95,200,277
3405-000,2017,11,17,2,45,77,122,200
3405-000,2017,11,17,3,55,50,105,122
3405-000,2017,11,17,4,63,75,138,105
3405-000,2017,11,17,5,111,105,216,138
3405-000,2017,11,17,6,214,187,401,216
3405-000,2017,11,17,7,616,503,1119,401
3405-000,2017,11,17,8,1196,1375,2571,1119
3405-000,2017,11,17,9,1343,1404,2747,2571
3405-000,2017,11,17,10,1177,1033,2210,2747
3405-000,2017,11,17,11,1182,1043,2225,2210
3405-000,2017,11,17,12,1140,996,2136,2225
3405-000,2017,11,17,13,1002,928,1930,2136
3405-000,2017,11,17,14,1141,938,2079,1930
3405-000,2017,11,17,15,1240,1105,2345,2079
3405-000,2017,11,17,16,1223,1085,2308,2345
3405-000,2017,11,17,17,1273,1145,2418,2308
3405-000,2017,11,17,18,1494,1234,2728,2418
3405-000,2017,11,17,19,1539,1161,2700,2728
3405-000,2017,11,17,20,1037,801,1838,2700
3405-000,2017,11,17,21,685,618,1303,1838
3405-000,2017,11,17,22,467,393,860,1303
3405-000,2017,11,17,23,264,239,503,860
3405-000,2017,11,17,24,167,148,315,503
3405-000,2017,11,18,1,105,122,227,315
3405-000,2017,11,18,2,92,63,155,227
3405-000,2017,11,18,3,61,46,107,155
3405-000,2017,11,18,4,59,74,133,107
3405-000,2017,11,18,5,89,95,184,133
3405-000,2017,11,18,6,203,141,344,184
3405-000,2017,11,18,7,505,345,850,344
3405-000,2017,11,18,8,765,641,1406,850
3405-000,2017,11,18,9,948,817,1765,1406
3405-000,2017,11,18,10,938,767,1705,1765
3405-000,2017,11,18,11,1102,804,1906,1705
3405-000,2017,11,18,12,907,871,1778,1906
3405-000,2017,11,18,13,872,806,1678,1778
3405-000,2017,11,18,14,864,800,1664,1678
3405-000,2017,11,18,15,1008,921,1929,1664
3405-000,2017,11,18,16,1020,900,1920,1929
3405-000,2017,11,18,17,952,870,1822,1920
3405-000,2017,11,18,18,1161,930,2091,1822
3405-000,2017,11,18,19,882,762,1644,2091
3405-000,2017,11,18,20,547,477,1024,1644
3405-000,2017,11,18,21,374,403,777,1024
3405-000,2017,11,18,22,293,285,578,777
3405-000,2017,11,18,23,195,202,397,578
3405-000,2017,11,18,24,135,124,259,397
3405-000,2017,11,19,1,68,67,135,259
3405-000,2017,11,19,2,54,44,98,135
3405-000,2017,11,19,3,39,40,79,98
3405-000,2017,11,19,4,29,33,62,79
3405-000,2017,11,19,5,59,43,102,62
3405-000,2017,11,19,6,127,77,204,102
3405-000,2017,11,19,7,231,151,382,204
3405-000,2017,11,19,8,351,260,611,382
3405-000,2017,11,19,9,476,393,869,611
3405-000,2017,11,19,10,574,464,1038,869
3405-000,2017,11,19,11,636,497,1133,1038
3405-000,2017,11,19,12,639,549,1188,1133
3405-000,2017,11,19,13,655,579,1234,1188
3405-000,2017,11,19,14,718,682,1400,1234
3405-000,2017,11,19,15,704,685,1389,1400
3405-000,2017,11,19,16,921,754,1675,1389
3405-000,2017,11,19,17,891,797,1688,1675
3405-000,2017,11,19,18,852,813,1665,1688
3405-000,2017,11,19,19,688,643,1331,1665
3405-000,2017,11,19,20,555,675,1230,1331
3405-000,2017,11,19,21,376,482,858,1230
3405-000,2017,11,19,22,297,399,696,858
3405-000,2017,11,19,23,189,268,457,696
3405-000,2017,11,19,24,125,161,286,457
3405-000,2017,11,20,1,51,78,129,286
3405-000,2017,11,20,2,44,62,106,129
3405-000,2017,11,20,3,47,48,95,106
3405-000,2017,11,20,4,63,57,120,95
3405-000,2017,11,20,5,112,110,222,120
3405-000,2017,11,20,6,274,239,513,222
3405-000,2017,11,20,7,702,670,1372,513
3405-000,2017,11,20,8,1245,1517,2762,1372
3405-000,2017,11,20,9,1426,1477,2903,2762
3405-000,2017,11,20,10,1150,951,2101,2903
3405-000,2017,11,20,11,1115,998,2113,2101
3405-000,2017,11,20,12,1058,1005,2063,2113
3405-000,2017,11,20,13,872,888,1760,2063
3405-000,2017,11,20,14,1026,1004,2030,1760
3405-000,2017,11,20,15,1235,1172,2407,2030
3405-000,2017,11,20,16,1208,1056,2264,2407
3405-000,2017,11,20,17,1182,1032,2214,2264
3405-000,2017,11,20,18,1234,1061,2295,2214
3405-000,2017,11,20,19,1194,1072,2266,2295
3405-000,2017,11,20,20,722,629,1351,2266
3405-000,2017,11,20,21,574,606,1180,1351
3405-000,2017,11,20,22,347,392,739,1180
3405-000,2017,11,20,23,225,205,430,739
3405-000,2017,11,20,24,116,129,245,430
3405-000,2017,11,21,1,77,88,165,245
3405-000,2017,11,21,2,69,53,122,165
3405-000,2017,11,21,3,55,38,93,122
3405-000,2017,11,21,4,75,70,145,93
3405-000,2017,11,21,5,100,99,199,145
3405-000,2017,11,21,6,221,180,401,199
3405-000,2017,11,21,7,590,480,1070,401
3405-000,2017,11,21,8,1198,1230,2428,1070
3405-000,2017,11,21,9,1382,1418,2800,2428
3405-000,2017,11,21,10,1180,1026,2206,2800
3405-000,2017,11,21,11,1215,1072,2287,2206
3405-000,2017,11,21,12,1118,985,2103,2287
3405-000,2017,11,21,13,955,836,1791,2103
3405-000,2017,11,21,14,995,1003,1998,1791
3405-000,2017,11,21,15,1190,1059,2249,1998
3405-000,2017,11,21,16,1183,1026,2209,2249
3405-000,2017,11,21,17,1201,1056,2257,2209
3405-000,2017,11,21,18,1334,1186,2520,2257
3405-000,2017,11,21,19,1231,1121,2352,2520
3405-000,2017,11,21,20,731,679,1410,2352
3405-000,2017,11,21,21,579,567,1146,1410
3405-000,2017,11,21,22,411,392,803,1146
3405-000,2017,11,21,23,226,238,464,803
3405-000,2017,11,21,24,146,127,273,464
3405-000,2017,11,22,1,93,88,181,273
3405-000,2017,11,22,2,71,84,155,181
3405-000,2017,11,22,3,54,61,115,155
3405-000,2017,11,22,4,83,60,143,115
3405-000,2017,11,22,5,100,98,198,143
3405-000,2017,11,22,6,228,177,405,198
3405-000,2017,11,22,7,629,477,1106,405
3405-000,2017,11,22,8,1177,1283,2460,1106
3405-000,2017,11,22,9,1398,1470,2868,2460
3405-000,2017,11,22,10,1148,1006,2154,2868
3405-000,2017,11,22,11,1071,1043,2114,2154
3405-000,2017,11,22,12,1148,924,2072,2114
3405-000,2017,11,22,13,942,829,1771,2072
3405-000,2017,11,22,14,1056,988,2044,1771
3405-000,2017,11,22,15,1148,1140,2288,2044
3405-000,2017,11,22,16,1179,1074,2253,2288
3405-000,2017,11,22,17,1140,1042,2182,2253
3405-000,2017,11,22,18,1447,1200,2647,2182
3405-000,2017,11,22,19,1511,1071,2582,2647
3405-000,2017,11,22,20,678,624,1302,2582
3405-000,2017,11,22,21,526,499,1025,1302
3405-000,2017,11,22,22,376,332,708,1025
3405-000,2017,11,22,23,240,207,447,708
3405-000,2017,11,22,24,148,149,297,447
3405-000,2017,11,23,1,90,98,188,297
3405-000,2017,11,23,2,56,61,117,188
3405-000,2017,11,23,3,65,69,134,117
3405-000,2017,11,23,4,56,82,138,134
3405-000,2017,11,23,5,108,98,206,138
3405-000,2017,11,23,6,205,168,373,206
3405-000,2017,11,23,7,615,495,1110,373
3405-000,2017,11,23,8,1169,1342,2511,1110
3405-000,2017,11,23,9,1344,1420,2764,2511
3405-000,2017,11,23,10,1127,1061,2188,2764
3405-000,2017,11,23,11,840,936,1776,2188
3405-000,2017,11,23,12,877,889,1766,1776
3405-000,2017,11,23,13,867,827,1694,1766
3405-000,2017,11,23,14,917,1010,1927,1694
3405-000,2017,11,23,15,1065,1084,2149,1927
3405-000,2017,11,23,16,1128,993,2121,2149
3405-000,2017,11,23,17,1145,1032,2177,2121
3405-000,2017,11,23,18,1275,1081,2356,2177
3405-000,2017,11,23,19,1252,1027,2279,2356
3405-000,2017,11,23,20,695,681,1376,2279
3405-000,2017,11,23,21,575,566,1141,1376
3405-000,2017,11,23,22,440,406,846,1141
3405-000,2017,11,23,23,269,226,495,846
3405-000,2017,11,23,24,46,133,179,495
3405-000,2017,11,24,1,97,81,178,179
3405-000,2017,11,24,2,49,66,115,178
3405-000,2017,11,24,3,51,56,107,115
3405-000,2017,11,24,4,56,68,124,107
3405-000,2017,11,24,5,87,69,156,124
3405-000,2017,11,24,6,191,134,325,156
3405-000,2017,11,24,7,428,371,799,325
3405-000,2017,11,24,8,913,1088,2001,799
3405-000,2017,11,24,9,1167,1195,2362,2001
3405-000,2017,11,24,10,1051,827,1878,2362
3405-000,2017,11,24,11,1043,947,1990,1878
3405-000,2017,11,24,12,945,880,1825,1990
3405-000,2017,11,24,13,900,807,1707,1825
3405-000,2017,11,24,14,941,942,1883,1707
3405-000,2017,11,24,15,1144,954,2098,1883
3405-000,2017,11,24,16,1134,1001,2135,2098
3405-000,2017,11,24,17,1134,971,2105,2135
3405-000,2017,11,24,18,1429,1160,2589,2105
3405-000,2017,11,24,19,1356,1087,2443,2589
3405-000,2017,11,24,20,800,748,1548,2443
3405-000,2017,11,24,21,582,503,1085,1548
3405-000,2017,11,24,22,383,359,742,1085
3405-000,2017,11,24,23,267,223,490,742
3405-000,2017,11,24,24,137,130,267,490
3405-000,2017,11,25,1,108,82,190,267
3405-000,2017,11,25,2,60,44,104,190
3405-000,2017,11,25,3,49,53,102,104
3405-000,2017,11,25,4,76,79,155,102
3405-000,2017,11,25,5,113,77,190,155
3405-000,2017,11,25,6,181,111,292,190
3405-000,2017,11,25,7,422,329,751,292
3405-000,2017,11,25,8,726,576,1302,751
3405-000,2017,11,25,9,824,759,1583,1302
3405-000,2017,11,25,10,973,780,1753,1583
3405-000,2017,11,25,11,1057,789,1846,1753
3405-000,2017,11,25,12,906,771,1677,1846
3405-000,2017,11,25,13,797,815,1612,1677
3405-000,2017,11,25,14,922,719,1641,1612
3405-000,2017,11,25,15,963,750,1713,1641
3405-000,2017,11,25,16,891,771,1662,1713
3405-000,2017,11,25,17,822,764,1586,1662
3405-000,2017,11,25,18,952,878,1830,1586
3405-000,2017,11,25,19,787,617,1404,1830
3405-000,2017,11,25,20,436,416,852,1404
3405-000,2017,11,25,21,318,354,672,852
3405-000,2017,11,25,22,231,275,506,672
3405-000,2017,11,25,23,162,188,350,506
3405-000,2017,11,25,24,114,128,242,350
3405-000,2017,11,26,1,86,65,151,242
3405-000,2017,11,26,2,45,66,111,151
3405-000,2017,11,26,3,22,44,66,111
3405-000,2017,11,26,4,29,33,62,66
3405-000,2017,11,26,5,60,29,89,62
3405-000,2017,11,26,6,95,49,144,89
3405-000,2017,11,26,7,186,138,324,144
3405-000,2017,11,26,8,285,252,537,324
3405-000,2017,11,26,9,373,325,698,537
3405-000,2017,11,26,10,467,379,846,698
3405-000,2017,11,26,11,538,460,998,846
3405-000,2017,11,26,12,555,497,1052,998
3405-000,2017,11,26,13,535,510,1045,1052
3405-000,2017,11,26,14,613,587,1200,1045
3405-000,2017,11,26,15,681,587,1268,1200
3405-000,2017,11,26,16,768,637,1405,1268
3405-000,2017,11,26,17,714,681,1395,1405
3405-000,2017,11,26,18,783,713,1496,1395
3405-000,2017,11,26,19,604,760,1364,1496
3405-000,2017,11,26,20,461,516,977,1364
3405-000,2017,11,26,21,333,469,802,977
3405-000,2017,11,26,22,302,409,711,802
3405-000,2017,11,26,23,159,320,479,711
3405-000,2017,11,26,24,126,160,286,479
3405-000,2017,11,27,1,54,91,145,286
3405-000,2017,11,27,2,39,61,100,145
3405-000,2017,11,27,3,38,48,86,100
3405-000,2017,11,27,4,52,70,122,86
3405-000,2017,11,27,5,123,87,210,122
3405-000,2017,11,27,6,279,227,506,210
3405-000,2017,11,27,7,673,656,1329,506
3405-000,2017,11,27,8,1236,1621,2857,1329
3405-000,2017,11,27,9,1464,1437,2901,2857
3405-000,2017,11,27,10,1199,991,2190,2901
3405-000,2017,11,27,11,1168,1061,2229,2190
3405-000,2017,11,27,12,1100,974,2074,2229
3405-000,2017,11,27,13,914,866,1780,2074
3405-000,2017,11,27,14,1033,1054,2087,1780
3405-000,2017,11,27,15,1234,1101,2335,2087
3405-000,2017,11,27,16,1172,1056,2228,2335
3405-000,2017,11,27,17,1339,1148,2487,2228
3405-000,2017,11,27,18,1401,1146,2547,2487
3405-000,2017,11,27,19,1298,1016,2314,2547
3405-000,2017,11,27,20,728,645,1373,2314
3405-000,2017,11,27,21,568,568,1136,1373
3405-000,2017,11,27,22,391,387,778,1136
3405-000,2017,11,27,23,270,234,504,778
3405-000,2017,11,27,24,134,143,277,504
3405-000,2017,11,28,1,79,109,188,277
3405-000,2017,11,28,2,50,55,105,188
3405-000,2017,11,28,3,63,67,130,105
3405-000,2017,11,28,4,60,78,138,130
3405-000,2017,11,28,5,118,118,236,138
3405-000,2017,11,28,6,231,187,418,236
3405-000,2017,11,28,7,606,488,1094,418
3405-000,2017,11,28,8,1260,1312,2572,1094
3405-000,2017,11,28,9,1462,1467,2929,2572
3405-000,2017,11,28,10,1153,1014,2167,2929
3405-000,2017,11,28,11,1253,1058,2311,2167
3405-000,2017,11,28,12,1130,1008,2138,2311
3405-000,2017,11,28,13,993,861,1854,2138
3405-000,2017,11,28,14,1114,1040,2154,1854
3405-000,2017,11,28,15,1292,1118,2410,2154
3405-000,2017,11,28,16,1244,1158,2402,2410
3405-000,2017,11,28,17,1301,1011,2312,2402
3405-000,2017,11,28,18,1404,1070,2474,2312
3405-000,2017,11,28,19,1221,1023,2244,2474
3405-000,2017,11,28,20,698,691,1389,2244
3405-000,2017,11,28,21,567,560,1127,1389
3405-000,2017,11,28,22,404,368,772,1127
3405-000,2017,11,28,23,221,201,422,772
3405-000,2017,11,28,24,137,157,294,422
3405-000,2017,11,29,1,91,97,188,294
3405-000,2017,11,29,2,64,79,143,188
3405-000,2017,11,29,3,57,67,124,143
3405-000,2017,11,29,4,70,75,145,124
3405-000,2017,11,29,5,118,96,214,145
3405-000,2017,11,29,6,251,195,446,214
3405-000,2017,11,29,7,622,482,1104,446
3405-000,2017,11,29,8,1213,1350,2563,1104
3405-000,2017,11,29,9,1413,1416,2829,2563
3405-000,2017,11,29,10,1127,1029,2156,2829
3405-000,2017,11,29,11,1214,1077,2291,2156
3405-000,2017,11,29,12,1118,1000,2118,2291
3405-000,2017,11,29,13,925,881,1806,2118
3405-000,2017,11,29,14,1130,1023,2153,1806
3405-000,2017,11,29,15,1142,1105,2247,2153
3405-000,2017,11,29,16,1268,1054,2322,2247
3405-000,2017,11,29,17,1176,1094,2270,2322
3405-000,2017,11,29,18,1515,1164,2679,2270
3405-000,2017,11,29,19,1354,1025,2379,2679
3405-000,2017,11,29,20,709,637,1346,2379
3405-000,2017,11,29,21,478,460,938,1346
3405-000,2017,11,29,22,357,351,708,938
3405-000,2017,11,29,23,244,211,455,708
3405-000,2017,11,29,24,135,137,272,455
3405-000,2017,11,30,1,86,102,188,272
3405-000,2017,11,30,2,65,75,140,188
3405-000,2017,11,30,3,52,70,122,140
3405-000,2017,11,30,4,88,66,154,122
3405-000,2017,11,30,5,108,84,192,154
3405-000,2017,11,30,6,233,206,439,192
3405-000,2017,11,30,7,556,503,1059,439
3405-000,2017,11,30,8,1209,1365,2574,1059
3405-000,2017,11,30,9,1393,1433,2826,2574
3405-000,2017,11,30,10,1154,1035,2189,2826
3405-000,2017,11,30,11,1173,1004,2177,2189
3405-000,2017,11,30,12,1079,947,2026,2177
3405-000,2017,11,30,13,947,905,1852,2026
3405-000,2017,11,30,14,1074,1001,2075,1852
3405-000,2017,11,30,15,1153,1016,2169,2075
3405-000,2017,11,30,16,1227,1090,2317,2169
3405-000,2017,11,30,17,1142,1038,2180,2317
3405-000,2017,11,30,18,1375,1144,2519,2180
3405-000,2017,11,30,19,1205,1015,2220,2519
3405-000,2017,11,30,20,714,568,1282,2220
3405-000,2017,11,30,21,587,551,1138,1282
3405-000,2017,11,30,22,372,395,767,1138
3405-000,2017,11,30,23,252,205,457,767
3405-000,2017,11,30,24,132,145,277,457
3405-000,2017,12,1,1,99,104,203,277
3405-000,2017,12,1,2,55,71,126,203
3405-000,2017,12,1,3,49,62,111,126
3405-000,2017,12,1,4,61,72,133,111
3405-000,2017,12,1,5,110,91,201,133
3405-000,2017,12,1,6,209,164,373,201
3405-000,2017,12,1,7,556,463,1019,373
3405-000,2017,12,1,8,1148,1311,2459,1019
3405-000,2017,12,1,9,1428,1317,2745,2459
3405-000,2017,12,1,10,1188,1028,2216,2745
3405-000,2017,12,1,11,1146,1070,2216,2216
3405-000,2017,12,1,12,1114,970,2084,2216
3405-000,2017,12,1,13,906,829,1735,2084
3405-000,2017,12,1,14,1049,956,2005,1735
3405-000,2017,12,1,15,1204,1073,2277,2005
3405-000,2017,12,1,16,1274,1087,2361,2277
3405-000,2017,12,1,17,1308,1125,2433,2361
3405-000,2017,12,1,18,1666,1189,2855,2433
3405-000,2017,12,1,19,1782,1171,2953,2855
3405-000,2017,12,1,20,949,773,1722,2953
3405-000,2017,12,1,21,622,566,1188,1722
3405-000,2017,12,1,22,433,401,834,1188
3405-000,2017,12,1,23,271,221,492,834
3405-000,2017,12,1,24,146,143,289,492
3405-000,2017,12,2,1,98,105,203,289
3405-000,2017,12,2,2,60,61,121,203
3405-000,2017,12,2,3,47,64,111,121
3405-000,2017,12,2,4,50,61,111,111
3405-000,2017,12,2,5,102,93,195,111
3405-000,2017,12,2,6,201,129,330,195
3405-000,2017,12,2,7,466,330,796,330
3405-000,2017,12,2,8,784,610,1394,796
3405-000,2017,12,2,9,877,811,1688,1394
3405-000,2017,12,2,10,946,708,1654,1688
3405-000,2017,12,2,11,988,821,1809,1654
3405-000,2017,12,2,12,919,779,1698,1809
3405-000,2017,12,2,13,846,761,1607,1698
3405-000,2017,12,2,14,895,732,1627,1607
3405-000,2017,12,2,15,877,707,1584,1627
3405-000,2017,12,2,16,964,788,1752,1584
3405-000,2017,12,2,17,985,800,1785,1752
3405-000,2017,12,2,18,1142,916,2058,1785
3405-000,2017,12,2,19,813,590,1403,2058
3405-000,2017,12,2,20,541,421,962,1403
3405-000,2017,12,2,21,375,346,721,962
3405-000,2017,12,2,22,273,266,539,721
3405-000,2017,12,2,23,179,204,383,539
3405-000,2017,12,2,24,118,134,252,383
3405-000,2017,12,3,1,80,105,185,252
3405-000,2017,12,3,2,47,61,108,185
3405-000,2017,12,3,3,35,38,73,108
3405-000,2017,12,3,4,42,47,89,73
3405-000,2017,12,3,5,48,35,83,89
3405-000,2017,12,3,6,99,48,147,83
3405-000,2017,12,3,7,190,143,333,147
3405-000,2017,12,3,8,304,238,542,333
3405-000,2017,12,3,9,407,346,753,542
3405-000,2017,12,3,10,501,400,901,753
3405-000,2017,12,3,11,622,441,1063,901
3405-000,2017,12,3,12,505,519,1024,1063
3405-000,2017,12,3,13,595,566,1161,1024
3405-000,2017,12,3,14,666,555,1221,1161
3405-000,2017,12,3,15,692,612,1304,1221
3405-000,2017,12,3,16,844,677,1521,1304
3405-000,2017,12,3,17,802,631,1433,1521
3405-000,2017,12,3,18,719,711,1430,1433
3405-000,2017,12,3,19,557,597,1154,1430
3405-000,2017,12,3,20,406,450,856,1154
3405-000,2017,12,3,21,369,417,786,856
3405-000,2017,12,3,22,282,311,593,786
3405-000,2017,12,3,23,199,248,447,593
3405-000,2017,12,3,24,117,163,280,447
3405-000,2017,12,4,1,50,85,135,280
3405-000,2017,12,4,2,34,72,106,135
3405-000,2017,12,4,3,42,57,99,106
3405-000,2017,12,4,4,55,59,114,99
3405-000,2017,12,4,5,111,99,210,114
3405-000,2017,12,4,6,276,241,517,210
3405-000,2017,12,4,7,690,618,1308,517
3405-000,2017,12,4,8,1314,1609,2923,1308
3405-000,2017,12,4,9,1370,1465,2835,2923
3405-000,2017,12,4,10,1185,1032,2217,2835
3405-000,2017,12,4,11,1167,1009,2176,2217
3405-000,2017,12,4,12,1080,955,2035,2176
3405-000,2017,12,4,13,917,856,1773,2035
3405-000,2017,12,4,14,1086,946,2032,1773
3405-000,2017,12,4,15,1187,1107,2294,2032
3405-000,2017,12,4,16,1174,1081,2255,2294
3405-000,2017,12,4,17,1168,977,2145,2255
3405-000,2017,12,4,18,1359,989,2348,2145
3405-000,2017,12,4,19,1125,1008,2133,2348
3405-000,2017,12,4,20,717,664,1381,2133
3405-000,2017,12,4,21,558,581,1139,1381
3405-000,2017,12,4,22,373,388,761,1139
3405-000,2017,12,4,23,208,234,442,761
3405-000,2017,12,4,24,113,140,253,442
3405-000,2017,12,5,1,79,76,155,253
3405-000,2017,12,5,2,66,60,126,155
3405-000,2017,12,5,3,51,65,116,126
3405-000,2017,12,5,4,69,73,142,116
3405-000,2017,12,5,5,122,96,218,142
3405-000,2017,12,5,6,226,183,409,218
3405-000,2017,12,5,7,570,496,1066,409
3405-000,2017,12,5,8,1124,1315,2439,1066
3405-000,2017,12,5,9,1414,1266,2680,2439
3405-000,2017,12,5,10,1140,1058,2198,2680
3405-000,2017,12,5,11,1136,1051,2187,2198
3405-000,2017,12,5,12,1093,951,2044,2187
3405-000,2017,12,5,13,931,827,1758,2044
3405-000,2017,12,5,14,1094,1022,2116,1758
3405-000,2017,12,5,15,1234,991,2225,2116
3405-000,2017,12,5,16,1179,1062,2241,2225
3405-000,2017,12,5,17,1247,1011,2258,2241
3405-000,2017,12,5,18,1298,1049,2347,2258
3405-000,2017,12,5,19,1084,976,2060,2347
3405-000,2017,12,5,20,739,602,1341,2060
3405-000,2017,12,5,21,537,572,1109,1341
3405-000,2017,12,5,22,365,383,748,1109
3405-000,2017,12,5,23,240,231,471,748
3405-000,2017,12,5,24,134,155,289,471
3405-000,2017,12,6,1,92,102,194,289
3405-000,2017,12,6,2,64,67,131,194
3405-000,2017,12,6,3,57,46,103,131
3405-000,2017,12,6,4,60,83,143,103
3405-000,2017,12,6,5,98,65,163,143
3405-000,2017,12,6,6,204,140,344,163
3405-000,2017,12,6,7,427,378,805,344
3405-000,2017,12,6,8,837,1113,1950,805
3405-000,2017,12,6,9,1079,1228,2307,1950
3405-000,2017,12,6,10,986,969,1955,2307
3405-000,2017,12,6,11,1042,940,1982,1955
3405-000,2017,12,6,12,1090,890,1980,1982
3405-000,2017,12,6,13,905,769,1674,1980
3405-000,2017,12,6,14,1015,975,1990,1674
3405-000,2017,12,6,15,1146,1065,2211,1990
3405-000,2017,12,6,16,1203,945,2148,2211
3405-000,2017,12,6,17,1085,924,2009,2148
3405-000,2017,12,6,18,1206,1083,2289,2009
3405-000,2017,12,6,19,1175,1006,2181,2289
3405-000,2017,12,6,20,663,557,1220,2181
3405-000,2017,12,6,21,442,468,910,1220
3405-000,2017,12,6,22,340,329,669,910
3405-000,2017,12,6,23,216,209,425,669
3405-000,2017,12,6,24,131,141,272,425
3405-000,2017,12,7,1,64,95,159,272
3405-000,2017,12,7,2,74,64,138,159
3405-000,2017,12,7,3,46,61,107,138
3405-000,2017,12,7,4,70,66,136,107
3405-000,2017,12,7,5,115,77,192,136
3405-000,2017,12,7,6,232,163,395,192
3405-000,2017,12,7,7,525,416,941,395
3405-000,2017,12,7,8,1048,1238,2286,941
3405-000,2017,12,7,9,1276,1382,2658,2286
3405-000,2017,12,7,10,1173,871,2044,2658
3405-000,2017,12,7,11,1159,1007,2166,2044
3405-000,2017,12,7,12,1174,991,2165,2166
3405-000,2017,12,7,13,941,825,1766,2165
3405-000,2017,12,7,14,1094,952,2046,1766
3405-000,2017,12,7,15,1217,1064,2281,2046
3405-000,2017,12,7,16,1279,1020,2299,2281
3405-000,2017,12,7,17,1428,1044,2472,2299
3405-000,2017,12,7,18,1466,1076,2542,2472
3405-000,2017,12,7,19,1262,980,2242,2542
3405-000,2017,12,7,20,647,602,1249,2242
3405-000,2017,12,7,21,553,503,1056,1249
3405-000,2017,12,7,22,295,387,682,1056
3405-000,2017,12,7,23,247,206,453,682
3405-000,2017,12,7,24,150,145,295,453
3405-000,2017,12,8,1,94,100,194,295
3405-000,2017,12,8,2,66,71,137,194
3405-000,2017,12,8,3,53,63,116,137
3405-000,2017,12,8,4,69,61,130,116
3405-000,2017,12,8,5,120,69,189,130
3405-000,2017,12,8,6,188,183,371,189
3405-000,2017,12,8,7,531,451,982,371
3405-000,2017,12,8,8,1087,1281,2368,982
3405-000,2017,12,8,9,1254,1342,2596,2368
3405-000,2017,12,8,10,1165,990,2155,2596
3405-000,2017,12,8,11,1183,1025,2208,2155
3405-000,2017,12,8,12,1193,904,2097,2208
3405-000,2017,12,8,13,908,855,1763,2097
3405-000,2017,12,8,14,1088,1041,2129,1763
3405-000,2017,12,8,15,1221,1029,2250,2129
3405-000,2017,12,8,16,1250,1019,2269,2250
3405-000,2017,12,8,17,1229,1064,2293,2269
3405-000,2017,12,8,18,1474,1179,2653,2293
3405-000,2017,12,8,19,1578,1126,2704,2653
3405-000,2017,12,8,20,799,657,1456,2704
3405-000,2017,12,8,21,582,533,1115,1456
3405-000,2017,12,8,22,417,381,798,1115
3405-000,2017,12,8,23,251,240,491,798
3405-000,2017,12,8,24,161,146,307,491
3405-000,2017,12,9,1,89,103,192,307
3405-000,2017,12,9,2,61,65,126,192
3405-000,2017,12,9,3,57,63,120,126
3405-000,2017,12,9,4,55,68,123,120
3405-000,2017,12,9,5,103,66,169,123
3405-000,2017,12,9,6,207,124,331,169
3405-000,2017,12,9,7,410,333,743,331
3405-000,2017,12,9,8,678,604,1282,743
3405-000,2017,12,9,9,866,768,1634,1282
3405-000,2017,12,9,10,924,699,1623,1634
3405-000,2017,12,9,11,1057,801,1858,1623
3405-000,2017,12,9,12,970,823,1793,1858
3405-000,2017,12,9,13,846,700,1546,1793
3405-000,2017,12,9,14,804,720,1524,1546
3405-000,2017,12,9,15,908,728,1636,1524
3405-000,2017,12,9,16,866,725,1591,1636
3405-000,2017,12,9,17,880,678,1558,1591
3405-000,2017,12,9,18,1039,931,1970,1558
3405-000,2017,12,9,19,757,621,1378,1970
3405-000,2017,12,9,20,411,427,838,1378
3405-000,2017,12,9,21,279,306,585,838
3405-000,2017,12,9,22,242,250,492,585
3405-000,2017,12,9,23,167,204,371,492
3405-000,2017,12,9,24,128,145,273,371
3405-000,2017,12,10,1,93,90,183,273
3405-000,2017,12,10,2,60,55,115,183
3405-000,2017,12,10,3,49,51,100,115
3405-000,2017,12,10,4,47,41,88,100
3405-000,2017,12,10,5,43,39,82,88
3405-000,2017,12,10,6,75,61,136,82
3405-000,2017,12,10,7,173,96,269,136
3405-000,2017,12,10,8,247,192,439,269
3405-000,2017,12,10,9,367,299,666,439
3405-000,2017,12,10,10,423,276,699,666
3405-000,2017,12,10,11,488,433,921,699
3405-000,2017,12,10,12,520,470,990,921
3405-000,2017,12,10,13,488,524,1012,990
3405-000,2017,12,10,14,507,531,1038,1012
3405-000,2017,12,10,15,540,548,1088,1038
3405-000,2017,12,10,16,627,584,1211,1088
3405-000,2017,12,10,17,552,598,1150,1211
3405-000,2017,12,10,18,478,582,1060,1150
3405-000,2017,12,10,19,387,479,866,1060
3405-000,2017,12,10,20,323,419,742,866
3405-000,2017,12,10,21,262,326,588,742
3405-000,2017,12,10,22,215,265,480,588
3405-000,2017,12,10,23,166,215,381,480
3405-000,2017,12,10,24,98,122,220,381
3405-000,2017,12,11,1,53,104,157,220
3405-000,2017,12,11,2,34,61,95,157
3405-000,2017,12,11,3,36,60,96,95
3405-000,2017,12,11,4,54,40,94,96
3405-000,2017,12,11,5,96,91,187,94
3405-000,2017,12,11,6,252,201,453,187
3405-000,2017,12,11,7,580,614,1194,453
3405-000,2017,12,11,8,1095,1373,2468,1194
3405-000,2017,12,11,9,1226,1413,2639,2468
3405-000,2017,12,11,10,1086,1021,2107,2639
3405-000,2017,12,11,11,1133,968,2101,2107
3405-000,2017,12,11,12,1086,864,1950,2101
3405-000,2017,12,11,13,958,811,1769,1950
3405-000,2017,12,11,14,1034,960,1994,1769
3405-000,2017,12,11,15,1152,1026,2178,1994
3405-000,2017,12,11,16,1109,1017,2126,2178
3405-000,2017,12,11,17,1067,959,2026,2126
3405-000,2017,12,11,18,1167,964,2131,2026
3405-000,2017,12,11,19,999,925,1924,2131
3405-000,2017,12,11,20,650,570,1220,1924
3405-000,2017,12,11,21,466,491,957,1220
3405-000,2017,12,11,22,272,330,602,957
3405-000,2017,12,11,23,204,205,409,602
3405-000,2017,12,11,24,121,150,271,409
3405-000,2017,12,12,1,74,79,153,271
3405-000,2017,12,12,2,59,85,144,153
3405-000,2017,12,12,3,49,59,108,144
3405-000,2017,12,12,4,54,63,117,108
3405-000,2017,12,12,5,92,80,172,117
3405-000,2017,12,12,6,210,149,359,172
3405-000,2017,12,12,7,499,444,943,359
3405-000,2017,12,12,8,1054,1147,2201,943
3405-000,2017,12,12,9,1279,1290,2569,2201
3405-000,2017,12,12,10,1115,921,2036,2569
3405-000,2017,12,12,11,1154,984,2138,2036
3405-000,2017,12,12,12,1111,925,2036,2138
3405-000,2017,12,12,13,952,860,1812,2036
3405-000,2017,12,12,14,977,979,1956,1812
3405-000,2017,12,12,15,1308,975,2283,1956
3405-000,2017,12,12,16,1151,999,2150,2283
3405-000,2017,12,12,17,1087,992,2079,2150
3405-000,2017,12,12,18,1191,1067,2258,2079
3405-000,2017,12,12,19,1069,901,1970,2258
3405-000,2017,12,12,20,648,569,1217,1970
3405-000,2017,12,12,21,489,524,1013,1217
3405-000,2017,12,12,22,325,386,711,1013
3405-000,2017,12,12,23,235,198,433,711
3405-000,2017,12,12,24,141,118,259,433
3405-000,2017,12,13,1,71,95,166,259
3405-000,2017,12,13,2,43,58,101,166
3405-000,2017,12,13,3,46,49,95,101
3405-000,2017,12,13,4,65,49,114,95
3405-000,2017,12,13,5,95,84,179,114
3405-000,2017,12,13,6,237,147,384,179
3405-000,2017,12,13,7,496,435,931,384
3405-000,2017,12,13,8,1021,1209,2230,931
3405-000,2017,12,13,9,1244,1287,2531,2230
3405-000,2017,12,13,10,1129,964,2093,2531
3405-000,2017,12,13,11,1131,1000,2131,2093
3405-000,2017,12,13,12,1106,919,2025,2131
3405-000,2017,12,13,13,892,861,1753,2025
3405-000,2017,12,13,14,993,995,1988,1753
3405-000,2017,12,13,15,1161,1017,2178,1988
3405-000,2017,12,13,16,1045,1000,2045,2178
3405-000,2017,12,13,17,1163,966,2129,2045
3405-000,2017,12,13,18,1327,1095,2422,2129
3405-000,2017,12,13,19,1231,976,2207,2422
3405-000,2017,12,13,20,612,543,1155,2207
3405-000,2017,12,13,21,460,500,960,1155
3405-000,2017,12,13,22,307,335,642,960
3405-000,2017,12,13,23,225,212,437,642
3405-000,2017,12,13,24,161,135,296,437
3405-000,2017,12,14,1,70,74,144,296
3405-000,2017,12,14,2,63,73,136,144
3405-000,2017,12,14,3,56,51,107,136
3405-000,2017,12,14,4,49,59,108,107
3405-000,2017,12,14,5,96,88,184,108
3405-000,2017,12,14,6,185,149,334,184
3405-000,2017,12,14,7,547,451,998,334
3405-000,2017,12,14,8,1034,1240,2274,998
3405-000,2017,12,14,9,1260,1347,2607,2274
3405-000,2017,12,14,10,1144,1017,2161,2607
3405-000,2017,12,14,11,1176,996,2172,2161
3405-000,2017,12,14,12,1167,925,2092,2172
3405-000,2017,12,14,13,922,831,1753,2092
3405-000,2017,12,14,14,1107,915,2022,1753
3405-000,2017,12,14,15,1233,1054,2287,2022
3405-000,2017,12,14,16,1245,1011,2256,2287
3405-000,2017,12,14,17,1158,983,2141,2256
3405-000,2017,12,14,18,1296,1044,2340,2141
3405-000,2017,12,14,19,1102,941,2043,2340
3405-000,2017,12,14,20,653,596,1249,2043
3405-000,2017,12,14,21,500,523,1023,1249
3405-000,2017,12,14,22,352,349,701,1023
3405-000,2017,12,14,23,231,233,464,701
3405-000,2017,12,14,24,132,142,274,464
3405-000,2017,12,15,1,78,108,186,274
3405-000,2017,12,15,2,61,65,126,186
3405-000,2017,12,15,3,50,67,117,126
3405-000,2017,12,15,4,57,67,124,117
3405-000,2017,12,15,5,121,93,214,124
3405-000,2017,12,15,6,209,172,381,214
3405-000,2017,12,15,7,549,481,1030,381
3405-000,2017,12,15,8,1101,1241,2342,1030
3405-000,2017,12,15,9,1285,1343,2628,2342
3405-000,2017,12,15,10,1198,1013,2211,2628
3405-000,2017,12,15,11,1272,1076,2348,2211
3405-000,2017,12,15,12,1170,970,2140,2348
3405-000,2017,12,15,13,981,889,1870,2140
3405-000,2017,12,15,14,1137,1004,2141,1870
3405-000,2017,12,15,15,1250,1014,2264,2141
3405-000,2017,12,15,16,1304,1078,2382,2264
3405-000,2017,12,15,17,1292,1047,2339,2382
3405-000,2017,12,15,18,1497,1108,2605,2339
3405-000,2017,12,15,19,1492,1068,2560,2605
3405-000,2017,12,15,20,839,687,1526,2560
3405-000,2017,12,15,21,605,475,1080,1526
3405-000,2017,12,15,22,384,391,775,1080
3405-000,2017,12,15,23,296,244,540,775
3405-000,2017,12,15,24,171,151,322,540
3405-000,2017,12,16,1,106,112,218,322
3405-000,2017,12,16,2,82,79,161,218
3405-000,2017,12,16,3,69,59,128,161
3405-000,2017,12,16,4,57,68,125,128
3405-000,2017,12,16,5,88,71,159,125
3405-000,2017,12,16,6,159,120,279,159
3405-000,2017,12,16,7,329,271,600,279
3405-000,2017,12,16,8,610,523,1133,600
3405-000,2017,12,16,9,846,710,1556,1133
3405-000,2017,12,16,10,867,655,1522,1556
3405-000,2017,12,16,11,874,705,1579,1522
3405-000,2017,12,16,12,916,714,1630,1579
3405-000,2017,12,16,13,801,606,1407,1630
3405-000,2017,12,16,14,762,645,1407,1407
3405-000,2017,12,16,15,880,668,1548,1407
3405-000,2017,12,16,16,879,709,1588,1548
3405-000,2017,12,16,17,842,768,1610,1588
3405-000,2017,12,16,18,920,838,1758,1610
3405-000,2017,12,16,19,636,581,1217,1758
3405-000,2017,12,16,20,386,364,750,1217
3405-000,2017,12,16,21,300,305,605,750
3405-000,2017,12,16,22,256,215,471,605
3405-000,2017,12,16,23,145,170,315,471
3405-000,2017,12,16,24,119,113,232,315
3405-000,2017,12,17,1,71,78,149,232
3405-000,2017,12,17,2,56,58,114,149
3405-000,2017,12,17,3,31,40,71,114
3405-000,2017,12,17,4,37,36,73,71
3405-000,2017,12,17,5,45,40,85,73
3405-000,2017,12,17,6,77,61,138,85
3405-000,2017,12,17,7,151,115,266,138
3405-000,2017,12,17,8,217,224,441,266
3405-000,2017,12,17,9,358,280,638,441
3405-000,2017,12,17,10,407,325,732,638
3405-000,2017,12,17,11,474,446,920,732
3405-000,2017,12,17,12,628,497,1125,920
3405-000,2017,12,17,13,530,500,1030,1125
3405-000,2017,12,17,14,554,595,1149,1030
3405-000,2017,12,17,15,589,590,1179,1149
3405-000,2017,12,17,16,611,685,1296,1179
3405-000,2017,12,17,17,575,600,1175,1296
3405-000,2017,12,17,18,556,674,1230,1175
3405-000,2017,12,17,19,424,512,936,1230
3405-000,2017,12,17,20,367,438,805,936
3405-000,2017,12,17,21,286,359,645,805
3405-000,2017,12,17,22,221,299,520,645
3405-000,2017,12,17,23,163,255,418,520
3405-000,2017,12,17,24,94,159,253,418
3405-000,2017,12,18,1,43,91,134,253
3405-000,2017,12,18,2,29,75,104,134
3405-000,2017,12,18,3,49,51,100,104
3405-000,2017,12,18,4,53,49,102,100
3405-000,2017,12,18,5,99,86,185,102
3405-000,2017,12,18,6,225,190,415,185
3405-000,2017,12,18,7,578,600,1178,415
3405-000,2017,12,18,8,1049,1413,2462,1178
3405-000,2017,12,18,9,1227,1310,2537,2462
3405-000,2017,12,18,10,1040,922,1962,2537
3405-000,2017,12,18,11,1042,911,1953,1962
3405-000,2017,12,18,12,1079,893,1972,1953
3405-000,2017,12,18,13,820,800,1620,1972
3405-000,2017,12,18,14,965,911,1876,1620
3405-000,2017,12,18,15,1145,1027,2172,1876
3405-000,2017,12,18,16,1080,986,2066,2172
3405-000,2017,12,18,17,1110,951,2061,2066
3405-000,2017,12,18,18,1156,1007,2163,2061
3405-000,2017,12,18,19,1029,925,1954,2163
3405-000,2017,12,18,20,583,562,1145,1954
3405-000,2017,12,18,21,523,475,998,1145
3405-000,2017,12,18,22,332,343,675,998
3405-000,2017,12,18,23,232,202,434,675
3405-000,2017,12,18,24,120,144,264,434
3405-000,2017,12,19,1,94,78,172,264
3405-000,2017,12,19,2,53,67,120,172
3405-000,2017,12,19,3,48,62,110,120
3405-000,2017,12,19,4,66,63,129,110
3405-000,2017,12,19,5,114,99,213,129
3405-000,2017,12,19,6,221,154,375,213
3405-000,2017,12,19,7,513,440,953,375
3405-000,2017,12,19,8,1032,1193,2225,953
3405-000,2017,12,19,9,1223,1331,2554,2225
3405-000,2017,12,19,10,1091,894,1985,2554
3405-000,2017,12,19,11,1140,947,2087,1985
3405-000,2017,12,19,12,1067,942,2009,2087
3405-000,2017,12,19,13,880,855,1735,2009
3405-000,2017,12,19,14,1061,1001,2062,1735
3405-000,2017,12,19,15,1208,1039,2247,2062
3405-000,2017,12,19,16,1176,1009,2185,2247
3405-000,2017,12,19,17,1180,1013,2193,2185
3405-000,2017,12,19,18,1173,1029,2202,2193
3405-000,2017,12,19,19,1054,950,2004,2202
3405-000,2017,12,19,20,657,565,1222,2004
3405-000,2017,12,19,21,493,497,990,1222
3405-000,2017,12,19,22,342,379,721,990
3405-000,2017,12,19,23,224,207,431,721
3405-000,2017,12,19,24,110,150,260,431
3405-000,2017,12,20,1,87,97,184,260
3405-000,2017,12,20,2,60,77,137,184
3405-000,2017,12,20,3,50,66,116,137
3405-000,2017,12,20,4,68,55,123,116
3405-000,2017,12,20,5,108,94,202,123
3405-000,2017,12,20,6,208,183,391,202
3405-000,2017,12,20,7,545,423,968,391
3405-000,2017,12,20,8,1023,1313,2336,968
3405-000,2017,12,20,9,1231,1312,2543,2336
3405-000,2017,12,20,10,1144,995,2139,2543
3405-000,2017,12,20,11,1144,1086,2230,2139
3405-000,2017,12,20,12,1094,962,2056,2230
3405-000,2017,12,20,13,1014,794,1808,2056
3405-000,2017,12,20,14,966,966,1932,1808
3405-000,2017,12,20,15,1209,1081,2290,1932
3405-000,2017,12,20,16,1115,1019,2134,2290
3405-000,2017,12,20,17,1114,1005,2119,2134
3405-000,2017,12,20,18,1304,1021,2325,2119
3405-000,2017,12,20,19,1092,935,2027,2325
3405-000,2017,12,20,20,611,530,1141,2027
3405-000,2017,12,20,21,450,417,867,1141
3405-000,2017,12,20,22,310,296,606,867
3405-000,2017,12,20,23,212,184,396,606
3405-000,2017,12,20,24,87,102,189,396
3405-000,2017,12,21,1,107,88,195,189
3405-000,2017,12,21,2,55,65,120,195
3405-000,2017,12,21,3,51,62,113,120
3405-000,2017,12,21,4,65,58,123,113
3405-000,2017,12,21,5,104,88,192,123
3405-000,2017,12,21,6,229,157,386,192
3405-000,2017,12,21,7,494,406,900,386
3405-000,2017,12,21,8,911,1209,2120,900
3405-000,2017,12,21,9,1206,1175,2381,2120
3405-000,2017,12,21,10,1057,900,1957,2381
3405-000,2017,12,21,11,1105,965,2070,1957
3405-000,2017,12,21,12,1079,954,2033,2070
3405-000,2017,12,21,13,913,756,1669,2033
3405-000,2017,12,21,14,999,929,1928,1669
3405-000,2017,12,21,15,1167,1049,2216,1928
3405-000,2017,12,21,16,1209,953,2162,2216
3405-000,2017,12,21,17,1186,1003,2189,2162
3405-000,2017,12,21,18,1283,1030,2313,2189
3405-000,2017,12,21,19,1098,891,1989,2313
3405-000,2017,12,21,20,627,591,1218,1989
3405-000,2017,12,21,21,515,508,1023,1218
3405-000,2017,12,21,22,352,371,723,1023
3405-000,2017,12,21,23,231,217,448,723
3405-000,2017,12,21,24,140,116,256,448
3405-000,2017,12,22,1,85,91,176,256
3405-000,2017,12,22,2,51,55,106,176
3405-000,2017,12,22,3,55,68,123,106
3405-000,2017,12,22,4,83,64,147,123
3405-000,2017,12,22,5,125,90,215,147
3405-000,2017,12,22,6,225,160,385,215
3405-000,2017,12,22,7,520,437,957,385
3405-000,2017,12,22,8,1051,1270,2321,957
3405-000,2017,12,22,9,1275,1327,2602,2321
3405-000,2017,12,22,10,1226,1003,2229,2602
3405-000,2017,12,22,11,1222,1027,2249,2229
3405-000,2017,12,22,12,1201,922,2123,2249
3405-000,2017,12,22,13,980,926,1906,2123
3405-000,2017,12,22,14,1156,1038,2194,1906
3405-000,2017,12,22,15,1261,1154,2415,2194
3405-000,2017,12,22,16,1236,1063,2299,2415
3405-000,2017,12,22,17,1296,1120,2416,2299
3405-000,2017,12,22,18,1515,1196,2711,2416
3405-000,2017,12,22,19,1461,1066,2527,2711
3405-000,2017,12,22,20,824,735,1559,2527
3405-000,2017,12,22,21,614,498,1112,1559
3405-000,2017,12,22,22,385,349,734,1112
3405-000,2017,12,22,23,283,230,513,734
3405-000,2017,12,22,24,179,164,343,513
3405-000,2017,12,23,1,122,109,231,343
3405-000,2017,12,23,2,76,76,152,231
3405-000,2017,12,23,3,77,76,153,152
3405-000,2017,12,23,4,76,80,156,153
3405-000,2017,12,23,5,113,81,194,156
3405-000,2017,12,23,6,198,143,341,194
3405-000,2017,12,23,7,408,286,694,341
3405-000,2017,12,23,8,651,560,1211,694
3405-000,2017,12,23,9,818,709,1527,1211
3405-000,2017,12,23,10,921,684,1605,1527
3405-000,2017,12,23,11,905,772,1677,1605
3405-000,2017,12,23,12,866,746,1612,1677
3405-000,2017,12,23,13,791,703,1494,1612
3405-000,2017,12,23,14,839,761,1600,1494
3405-000,2017,12,23,15,890,743,1633,1600
3405-000,2017,12,23,16,934,712,1646,1633
3405-000,2017,12,23,17,877,686,1563,1646
3405-000,2017,12,23,18,973,848,1821,1563
3405-000,2017,12,23,19,671,648,1319,1821
3405-000,2017,12,23,20,423,400,823,1319
3405-000,2017,12,23,21,342,301,643,823
3405-000,2017,12,23,22,237,282,519,643
3405-000,2017,12,23,23,184,168,352,519
3405-000,2017,12,23,24,130,134,264,352
3405-000,2017,12,24,1,94,74,168,264
3405-000,2017,12,24,2,53,59,112,168
3405-000,2017,12,24,3,34,37,71,112
3405-000,2017,12,24,4,43,39,82,71
3405-000,2017,12,24,5,35,36,71,82
3405-000,2017,12,24,6,71,50,121,71
3405-000,2017,12,24,7,163,91,254,121
3405-000,2017,12,24,8,214,190,404,254
3405-000,2017,12,24,9,294,257,551,404
3405-000,2017,12,24,10,396,278,674,551
3405-000,2017,12,24,11,456,350,806,674
3405-000,2017,12,24,12,445,368,813,806
3405-000,2017,12,24,13,439,458,897,813
3405-000,2017,12,24,14,475,465,940,897
3405-000,2017,12,24,15,480,520,1000,940
3405-000,2017,12,24,16,538,522,1060,1000
3405-000,2017,12,24,17,488,494,982,1060
3405-000,2017,12,24,18,438,460,898,982
3405-000,2017,12,24,19,340,387,727,898
3405-000,2017,12,24,20,266,332,598,727
3405-000,2017,12,24,21,208,248,456,598
3405-000,2017,12,24,22,161,218,379,456
3405-000,2017,12,24,23,139,186,325,379
3405-000,2017,12,24,24,96,121,217,325
3405-000,2017,12,25,1,54,67,121,217
3405-000,2017,12,25,2,33,60,93,121
3405-000,2017,12,25,3,33,42,75,93
3405-000,2017,12,25,4,38,47,85,75
3405-000,2017,12,25,5,70,56,126,85
3405-000,2017,12,25,6,143,93,236,126
3405-000,2017,12,25,7,211,199,410,236
3405-000,2017,12,25,8,372,300,672,410
3405-000,2017,12,25,9,369,317,686,672
3405-000,2017,12,25,10,403,340,743,686
3405-000,2017,12,25,11,542,456,998,743
3405-000,2017,12,25,12,512,485,997,998
3405-000,2017,12,25,13,595,567,1162,997
3405-000,2017,12,25,14,616,647,1263,1162
3405-000,2017,12,25,15,705,690,1395,1263
3405-000,2017,12,25,16,624,620,1244,1395
3405-000,2017,12,25,17,600,622,1222,1244
3405-000,2017,12,25,18,660,659,1319,1222
3405-000,2017,12,25,19,439,550,989,1319
3405-000,2017,12,25,20,333,429,762,989
3405-000,2017,12,25,21,317,426,743,762
3405-000,2017,12,25,22,235,351,586,743
3405-000,2017,12,25,23,161,229,390,586
3405-000,2017,12,25,24,101,166,267,390
3405-000,2017,12,26,1,71,109,180,267
3405-000,2017,12,26,2,30,68,98,180
3405-000,2017,12,26,3,46,44,90,98
3405-000,2017,12,26,4,54,71,125,90
3405-000,2017,12,26,5,108,107,215,125
3405-000,2017,12,26,6,232,180,412,215
3405-000,2017,12,26,7,515,546,1061,412
3405-000,2017,12,26,8,1019,1365,2384,1061
3405-000,2017,12,26,9,1264,1320,2584,2384
3405-000,2017,12,26,10,1068,899,1967,2584
3405-000,2017,12,26,11,1159,987,2146,1967
3405-000,2017,12,26,12,1092,842,1934,2146
3405-000,2017,12,26,13,934,789,1723,1934
3405-000,2017,12,26,14,1076,980,2056,1723
3405-000,2017,12,26,15,1158,1021,2179,2056
3405-000,2017,12,26,16,1176,965,2141,2179
3405-000,2017,12,26,17,989,995,1984,2141
3405-000,2017,12,26,18,1167,977,2144,1984
3405-000,2017,12,26,19,1089,1008,2097,2144
3405-000,2017,12,26,20,628,603,1231,2097
3405-000,2017,12,26,21,506,496,1002,1231
3405-000,2017,12,26,22,316,346,662,1002
3405-000,2017,12,26,23,254,205,459,662
3405-000,2017,12,26,24,125,125,250,459
3405-000,2017,12,27,1,100,101,201,250
3405-000,2017,12,27,2,71,62,133,201
3405-000,2017,12,27,3,46,59,105,133
3405-000,2017,12,27,4,75,68,143,105
3405-000,2017,12,27,5,119,85,204,143
3405-000,2017,12,27,6,259,150,409,204
3405-000,2017,12,27,7,444,442,886,409
3405-000,2017,12,27,8,1021,1240,2261,886
3405-000,2017,12,27,9,1252,1255,2507,2261
3405-000,2017,12,27,10,1087,963,2050,2507
3405-000,2017,12,27,11,1141,960,2101,2050
3405-000,2017,12,27,12,1169,893,2062,2101
3405-000,2017,12,27,13,891,789,1680,2062
3405-000,2017,12,27,14,1091,968,2059,1680
3405-000,2017,12,27,15,1138,1014,2152,2059
3405-000,2017,12,27,16,1199,1073,2272,2152
3405-000,2017,12,27,17,1087,942,2029,2272
3405-000,2017,12,27,18,1246,1033,2279,2029
3405-000,2017,12,27,19,1118,970,2088,2279
3405-000,2017,12,27,20,612,536,1148,2088
3405-000,2017,12,27,21,467,453,920,1148
3405-000,2017,12,27,22,298,324,622,920
3405-000,2017,12,27,23,253,184,437,622
3405-000,2017,12,27,24,0,0,0,437
3405-000,2017,12,28,1,78,83,161,0
3405-000,2017,12,28,2,56,67,123,161
3405-000,2017,12,28,3,66,62,128,123
3405-000,2017,12,28,4,95,64,159,128
3405-000,2017,12,28,5,121,112,233,159
3405-000,2017,12,28,6,260,160,420,233
3405-000,2017,12,28,7,507,465,972,420
3405-000,2017,12,28,8,1026,1274,2300,972
3405-000,2017,12,28,9,1281,1267,2548,2300
3405-000,2017,12,28,10,1058,987,2045,2548
3405-000,2017,12,28,11,1112,975,2087,2045
3405-000,2017,12,28,12,1048,945,1993,2087
3405-000,2017,12,28,13,937,802,1739,1993
3405-000,2017,12,28,14,1066,942,2008,1739
3405-000,2017,12,28,15,1215,1024,2239,2008
3405-000,2017,12,28,16,1160,1060,2220,2239
3405-000,2017,12,28,17,1111,1027,2138,2220
3405-000,2017,12,28,18,1319,1008,2327,2138
3405-000,2017,12,28,19,1000,928,1928,2327
3405-000,2017,12,28,20,631,618,1249,1928
3405-000,2017,12,28,21,549,483,1032,1249
3405-000,2017,12,28,22,357,334,691,1032
3405-000,2017,12,28,23,285,230,515,691
3405-000,2017,12,28,24,128,147,275,515
3405-000,2017,12,29,1,95,130,225,275
3405-000,2017,12,29,2,63,60,123,225
3405-000,2017,12,29,3,66,81,147,123
3405-000,2017,12,29,4,64,64,128,147
3405-000,2017,12,29,5,130,86,216,128
3405-000,2017,12,29,6,222,155,377,216
3405-000,2017,12,29,7,453,431,884,377
3405-000,2017,12,29,8,1039,1159,2198,884
3405-000,2017,12,29,9,1204,1205,2409,2198
3405-000,2017,12,29,10,1126,949,2075,2409
3405-000,2017,12,29,11,1114,987,2101,2075
3405-000,2017,12,29,12,1073,935,2008,2101
3405-000,2017,12,29,13,884,822,1706,2008
3405-000,2017,12,29,14,1002,888,1890,1706
3405-000,2017,12,29,15,1123,996,2119,1890
3405-000,2017,12,29,16,1179,1033,2212,2119
3405-000,2017,12,29,17,1169,968,2137,2212
3405-000,2017,12,29,18,1398,1081,2479,2137
3405-000,2017,12,29,19,1169,887,2056,2479
3405-000,2017,12,29,20,697,549,1246,2056
3405-000,2017,12,29,21,449,423,872,1246
3405-000,2017,12,29,22,343,278,621,872
3405-000,2017,12,29,23,246,222,468,621
3405-000,2017,12,29,24,136,127,263,468
3405-000,2017,12,30,1,93,104,197,263
3405-000,2017,12,30,2,64,68,132,197
3405-000,2017,12,30,3,58,64,122,132
3405-000,2017,12,30,4,56,71,127,122
3405-000,2017,12,30,5,119,69,188,127
3405-000,2017,12,30,6,186,120,306,188
3405-000,2017,12,30,7,356,233,589,306
3405-000,2017,12,30,8,547,447,994,589
3405-000,2017,12,30,9,664,577,1241,994
3405-000,2017,12,30,10,759,557,1316,1241
3405-000,2017,12,30,11,766,613,1379,1316
3405-000,2017,12,30,12,836,598,1434,1379
3405-000,2017,12,30,13,724,655,1379,1434
3405-000,2017,12,30,14,776,675,1451,1379
3405-000,2017,12,30,15,756,694,1450,1451
3405-000,2017,12,30,16,828,661,1489,1450
3405-000,2017,12,30,17,866,860,1726,1489
3405-000,2017,12,30,18,777,810,1587,1726
3405-000,2017,12,30,19,539,583,1122,1587
3405-000,2017,12,30,20,343,336,679,1122
3405-000,2017,12,30,21,285,242,527,679
3405-000,2017,12,30,22,232,215,447,527
3405-000,2017,12,30,23,141,145,286,447
3405-000,2017,12,30,24,92,91,183,286
3405-000,2017,12,31,1,66,79,145,183
3405-000,2017,12,31,2,47,40,87,145
3405-000,2017,12,31,3,35,40,75,87
3405-000,2017,12,31,4,36,36,72,75
3405-000,2017,12,31,5,62,40,102,72
3405-000,2017,12,31,6,82,34,116,102
3405-000,2017,12,31,7,112,97,209,116
3405-000,2017,12,31,8,199,160,359,209
3405-000,2017,12,31,9,318,191,509,359
3405-000,2017,12,31,10,376,289,665,509
3405-000,2017,12,31,11,521,385,906,665
3405-000,2017,12,31,12,527,466,993,906
3405-000,2017,12,31,13,539,539,1078,993
3405-000,2017,12,31,14,529,563,1092,1078
3405-000,2017,12,31,15,609,588,1197,1092
3405-000,2017,12,31,16,583,616,1199,1197
3405-000,2017,12,31,17,517,544,1061,1199
3405-000,2017,12,31,18,553,582,1135,1061
3405-000,2017,12,31,19,464,450,914,1135
3405-000,2017,12,31,20,270,331,601,914
3405-000,2017,12,31,21,231,217,448,601
3405-000,2017,12,31,22,184,213,397,448
3405-000,2017,12,31,23,119,179,298,397
3405-000,2017,12,31,24,95,107,202,298
3405-000,2018,1,1,1,64,81,145,202
3405-000,2018,1,1,2,84,77,161,145
3405-000,2018,1,1,3,51,65,116,161
3405-000,2018,1,1,4,47,56,103,116
3405-000,2018,1,1,5,47,50,97,103
3405-000,2018,1,1,6,88,84,172,97
3405-000,2018,1,1,7,148,115,263,172
3405-000,2018,1,1,8,194,141,335,263
3405-000,2018,1,1,9,251,198,449,335
3405-000,2018,1,1,10,347,274,621,449
3405-000,2018,1,1,11,436,370,806,621
3405-000,2018,1,1,12,603,499,1102,806
3405-000,2018,1,1,13,682,564,1246,1102
3405-000,2018,1,1,14,594,643,1237,1246
3405-000,2018,1,1,15,591,667,1258,1237
3405-000,2018,1,1,16,619,631,1250,1258
3405-000,2018,1,1,17,610,709,1319,1250
3405-000,2018,1,1,18,570,750,1320,1319
3405-000,2018,1,1,19,420,511,931,1320
3405-000,2018,1,1,20,367,455,822,931
3405-000,2018,1,1,21,313,437,750,822
3405-000,2018,1,1,22,223,375,598,750
3405-000,2018,1,1,23,139,276,415,598
3405-000,2018,1,1,24,90,188,278,415
3405-000,2018,1,2,1,61,100,161,278
3405-000,2018,1,2,2,40,58,98,161
3405-000,2018,1,2,3,43,39,82,98
3405-000,2018,1,2,4,46,62,108,82
3405-000,2018,1,2,5,84,84,168,108
3405-000,2018,1,2,6,206,182,388,168
3405-000,2018,1,2,7,535,472,1007,388
3405-000,2018,1,2,8,1020,1420,2440,1007
3405-000,2018,1,2,9,1115,1197,2312,2440
3405-000,2018,1,2,10,844,766,1610,2312
3405-000,2018,1,2,11,959,824,1783,1610
3405-000,2018,1,2,12,969,818,1787,1783
3405-000,2018,1,2,13,783,729,1512,1787
3405-000,2018,1,2,14,871,839,1710,1512
3405-000,2018,1,2,15,1019,932,1951,1710
3405-000,2018,1,2,16,998,900,1898,1951
3405-000,2018,1,2,17,947,846,1793,1898
3405-000,2018,1,2,18,1084,1001,2085,1793
3405-000,2018,1,2,19,952,907,1859,2085
3405-000,2018,1,2,20,552,566,1118,1859
3405-000,2018,1,2,21,445,479,924,1118
3405-000,2018,1,2,22,297,313,610,924
3405-000,2018,1,2,23,177,201,378,610
3405-000,2018,1,2,24,138,133,271,378
3405-000,2018,1,3,1,63,104,167,271
3405-000,2018,1,3,2,48,64,112,167
3405-000,2018,1,3,3,53,65,118,112
3405-000,2018,1,3,4,51,74,125,118
3405-000,2018,1,3,5,96,92,188,125
3405-000,2018,1,3,6,253,177,430,188
3405-000,2018,1,3,7,479,474,953,430
3405-000,2018,1,3,8,1037,1251,2288,953
3405-000,2018,1,3,9,1211,1203,2414,2288
3405-000,2018,1,3,10,1027,878,1905,2414
3405-000,2018,1,3,11,1016,949,1965,1905
3405-000,2018,1,3,12,1031,834,1865,1965
3405-000,2018,1,3,13,921,838,1759,1865
3405-000,2018,1,3,14,1000,904,1904,1759
3405-000,2018,1,3,15,1058,1040,2098,1904
3405-000,2018,1,3,16,1056,967,2023,2098
3405-000,2018,1,3,17,1062,909,1971,2023
3405-000,2018,1,3,18,1217,1059,2276,1971
3405-000,2018,1,3,19,1065,1013,2078,2276
3405-000,2018,1,3,20,643,580,1223,2078
3405-000,2018,1,3,21,444,458,902,1223
3405-000,2018,1,3,22,318,307,625,902
3405-000,2018,1,3,23,216,177,393,625
3405-000,2018,1,3,24,121,126,247,393
3405-000,2018,1,4,1,71,101,172,247
3405-000,2018,1,4,2,53,69,122,172
3405-000,2018,1,4,3,47,71,118,122
3405-000,2018,1,4,4,66,56,122,118
3405-000,2018,1,4,5,103,89,192,122
3405-000,2018,1,4,6,226,176,402,192
3405-000,2018,1,4,7,517,426,943,402
3405-000,2018,1,4,8,1043,1223,2266,943
3405-000,2018,1,4,9,1240,1269,2509,2266
3405-000,2018,1,4,10,1102,870,1972,2509
3405-000,2018,1,4,11,1053,949,2002,1972
3405-000,2018,1,4,12,1081,914,1995,2002
3405-000,2018,1,4,13,777,839,1616,1995
3405-000,2018,1,4,14,1035,935,1970,1616
3405-000,2018,1,4,15,1244,1066,2310,1970
3405-000,2018,1,4,16,1142,990,2132,2310
3405-000,2018,1,4,17,1091,963,2054,2132
3405-000,2018,1,4,18,1179,957,2136,2054
3405-000,2018,1,4,19,987,913,1900,2136
3405-000,2018,1,4,20,670,521,1191,1900
3405-000,2018,1,4,21,507,494,1001,1191
3405-000,2018,1,4,22,336,342,678,1001
3405-000,2018,1,4,23,209,201,410,678
3405-000,2018,1,4,24,124,116,240,410
3405-000,2018,1,5,1,77,103,180,240
3405-000,2018,1,5,2,51,58,109,180
3405-000,2018,1,5,3,51,54,105,109
3405-000,2018,1,5,4,57,58,115,105
3405-000,2018,1,5,5,115,88,203,115
3405-000,2018,1,5,6,189,173,362,203
3405-000,2018,1,5,7,504,436,940,362
3405-000,2018,1,5,8,1000,1210,2210,940
3405-000,2018,1,5,9,1293,1239,2532,2210
3405-000,2018,1,5,10,1085,1005,2090,2532
3405-000,2018,1,5,11,1134,962,2096,2090
3405-000,2018,1,5,12,1136,954,2090,2096
3405-000,2018,1,5,13,909,854,1763,2090
3405-000,2018,1,5,14,1119,904,2023,1763
3405-000,2018,1,5,15,1181,1077,2258,2023
3405-000,2018,1,5,16,1193,974,2167,2258
3405-000,2018,1,5,17,1095,1010,2105,2167
3405-000,2018,1,5,18,1425,1113,2538,2105
3405-000,2018,1,5,19,1488,1035,2523,2538
3405-000,2018,1,5,20,828,650,1478,2523
3405-000,2018,1,5,21,607,488,1095,1478
3405-000,2018,1,5,22,405,365,770,1095
3405-000,2018,1,5,23,259,195,454,770
3405-000,2018,1,5,24,141,137,278,454
3405-000,2018,1,6,1,97,102,199,278
3405-000,2018,1,6,2,57,84,141,199
3405-000,2018,1,6,3,47,49,96,141
3405-000,2018,1,6,4,44,72,116,96
3405-000,2018,1,6,5,74,97,171,116
3405-000,2018,1,6,6,212,130,342,171
3405-000,2018,1,6,7,338,274,612,342
3405-000,2018,1,6,8,626,511,1137,612
3405-000,2018,1,6,9,761,689,1450,1137
3405-000,2018,1,6,10,797,651,1448,1450
3405-000,2018,1,6,11,903,676,1579,1448
3405-000,2018,1,6,12,837,629,1466,1579
3405-000,2018,1,6,13,744,636,1380,1466
3405-000,2018,1,6,14,709,625,1334,1380
3405-000,2018,1,6,15,811,644,1455,1334
3405-000,2018,1,6,16,849,642,1491,1455
3405-000,2018,1,6,17,793,675,1468,1491
3405-000,2018,1,6,18,904,822,1726,1468
3405-000,2018,1,6,19,653,522,1175,1726
3405-000,2018,1,6,20,380,415,795,1175
3405-000,2018,1,6,21,278,259,537,795
3405-000,2018,1,6,22,221,224,445,537
3405-000,2018,1,6,23,173,176,349,445
3405-000,2018,1,6,24,103,100,203,349
3405-000,2018,1,7,1,63,84,147,203
3405-000,2018,1,7,2,51,54,105,147
3405-000,2018,1,7,3,38,36,74,105
3405-000,2018,1,7,4,32,50,82,74
3405-000,2018,1,7,5,43,35,78,82
3405-000,2018,1,7,6,62,66,128,78
3405-000,2018,1,7,7,135,116,251,128
3405-000,2018,1,7,8,224,208,432,251
3405-000,2018,1,7,9,365,295,660,432
3405-000,2018,1,7,10,422,303,725,660
3405-000,2018,1,7,11,502,399,901,725
3405-000,2018,1,7,12,485,440,925,901
3405-000,2018,1,7,13,517,515,1032,925
3405-000,2018,1,7,14,547,550,1097,1032
3405-000,2018,1,7,15,611,635,1246,1097
3405-000,2018,1,7,16,600,572,1172,1246
3405-000,2018,1,7,17,605,664,1269,1172
3405-000,2018,1,7,18,558,636,1194,1269
3405-000,2018,1,7,19,387,503,890,1194
3405-000,2018,1,7,20,319,406,725,890
3405-000,2018,1,7,21,261,318,579,725
3405-000,2018,1,7,22,220,314,534,579
3405-000,2018,1,7,23,145,218,363,534
3405-000,2018,1,7,24,99,137,236,363
3405-000,2018,1,8,1,64,81,145,236
3405-000,2018,1,8,2,34,57,91,145
3405-000,2018,1,8,3,33,45,78,91
3405-000,2018,1,8,4,60,55,115,78
3405-000,2018,1,8,5,87,95,182,115
3405-000,2018,1,8,6,250,205,455,182
3405-000,2018,1,8,7,571,566,1137,455
3405-000,2018,1,8,8,1082,1480,2562,1137
3405-000,2018,1,8,9,1305,1270,2575,2562
3405-000,2018,1,8,10,1084,876,1960,2575
3405-000,2018,1,8,11,1088,933,2021,1960
3405-000,2018,1,8,12,1119,907,2026,2021
3405-000,2018,1,8,13,822,851,1673,2026
3405-000,2018,1,8,14,921,877,1798,1673
3405-000,2018,1,8,15,1097,987,2084,1798
3405-000,2018,1,8,16,1050,997,2047,2084
3405-000,2018,1,8,17,992,920,1912,2047
3405-000,2018,1,8,18,1152,972,2124,1912
3405-000,2018,1,8,19,1024,916,1940,2124
3405-000,2018,1,8,20,637,595,1232,1940
3405-000,2018,1,8,21,493,464,957,1232
3405-000,2018,1,8,22,275,305,580,957
3405-000,2018,1,8,23,193,186,379,580
3405-000,2018,1,8,24,107,120,227,379
3405-000,2018,1,9,1,87,86,173,227
3405-000,2018,1,9,2,50,51,101,173
3405-000,2018,1,9,3,32,54,86,101
3405-000,2018,1,9,4,61,51,112,86
3405-000,2018,1,9,5,82,63,145,112
3405-000,2018,1,9,6,173,122,295,145
3405-000,2018,1,9,7,400,367,767,295
3405-000,2018,1,9,8,825,1006,1831,767
3405-000,2018,1,9,9,1120,1134,2254,1831
3405-000,2018,1,9,10,871,846,1717,2254
3405-000,2018,1,9,11,977,873,1850,1717
3405-000,2018,1,9,12,991,864,1855,1850
3405-000,2018,1,9,13,837,708,1545,1855
3405-000,2018,1,9,14,926,869,1795,1545
3405-000,2018,1,9,15,1099,904,2003,1795
3405-000,2018,1,9,16,915,889,1804,2003
3405-000,2018,1,9,17,984,770,1754,1804
3405-000,2018,1,9,18,817,861,1678,1754
3405-000,2018,1,9,19,1002,854,1856,1678
3405-000,2018,1,9,20,842,554,1396,1856
3405-000,2018,1,9,21,450,446,896,1396
3405-000,2018,1,9,22,277,291,568,896
3405-000,2018,1,9,23,149,142,291,568
3405-000,2018,1,9,24,96,109,205,291
3405-000,2018,1,10,1,57,73,130,205
3405-000,2018,1,10,2,42,57,99,130
3405-000,2018,1,10,3,33,48,81,99
3405-000,2018,1,10,4,48,49,97,81
3405-000,2018,1,10,5,78,57,135,97
3405-000,2018,1,10,6,151,110,261,135
3405-000,2018,1,10,7,343,315,658,261
3405-000,2018,1,10,8,720,915,1635,658
3405-000,2018,1,10,9,953,965,1918,1635
3405-000,2018,1,10,10,815,814,1629,1918
3405-000,2018,1,10,11,905,845,1750,1629
3405-000,2018,1,10,12,922,872,1794,1750
3405-000,2018,1,10,13,824,762,1586,1794
3405-000,2018,1,10,14,943,838,1781,1586
3405-000,2018,1,10,15,1040,935,1975,1781
3405-000,2018,1,10,16,946,900,1846,1975
3405-000,2018,1,10,17,934,815,1749,1846
3405-000,2018,1,10,18,1157,915,2072,1749
3405-000,2018,1,10,19,1075,870,1945,2072
3405-000,2018,1,10,20,569,517,1086,1945
3405-000,2018,1,10,21,401,350,751,1086
3405-000,2018,1,10,22,247,256,503,751
3405-000,2018,1,10,23,181,173,354,503
3405-000,2018,1,10,24,101,111,212,354
3405-000,2018,1,11,1,65,77,142,212
3405-000,2018,1,11,2,34,64,98,142
3405-000,2018,1,11,3,38,53,91,98
3405-000,2018,1,11,4,54,40,94,91
3405-000,2018,1,11,5,92,62,154,94
3405-000,2018,1,11,6,174,130,304,154
3405-000,2018,1,11,7,407,354,761,304
3405-000,2018,1,11,8,913,1146,2059,761
3405-000,2018,1,11,9,1158,1164,2322,2059
3405-000,2018,1,11,10,930,829,1759,2322
3405-000,2018,1,11,11,999,923,1922,1759
3405-000,2018,1,11,12,1048,847,1895,1922
3405-000,2018,1,11,13,807,753,1560,1895
3405-000,2018,1,11,14,901,872,1773,1560
3405-000,2018,1,11,15,1026,908,1934,1773
3405-000,2018,1,11,16,1060,848,1908,1934
3405-000,2018,1,11,17,985,888,1873,1908
3405-000,2018,1,11,18,1098,1021,2119,1873
3405-000,2018,1,11,19,1119,797,1916,2119
3405-000,2018,1,11,20,665,525,1190,1916
3405-000,2018,1,11,21,466,430,896,1190
3405-000,2018,1,11,22,304,370,674,896
3405-000,2018,1,11,23,170,172,342,674
3405-000,2018,1,11,24,109,125,234,342
3405-000,2018,1,12,1,79,96,175,234
3405-000,2018,1,12,2,61,55,116,175
3405-000,2018,1,12,3,49,43,92,116
3405-000,2018,1,12,4,47,52,99,92
3405-000,2018,1,12,5,73,79,152,99
3405-000,2018,1,12,6,144,129,273,152
3405-000,2018,1,12,7,417,343,760,273
3405-000,2018,1,12,8,873,1088,1961,760
3405-000,2018,1,12,9,1099,1058,2157,1961
3405-000,2018,1,12,10,914,875,1789,2157
3405-000,2018,1,12,11,981,904,1885,1789
3405-000,2018,1,12,12,1017,943,1960,1885
3405-000,2018,1,12,13,888,837,1725,1960
3405-000,2018,1,12,14,973,796,1769,1725
3405-000,2018,1,12,15,1074,943,2017,1769
3405-000,2018,1,12,16,1150,982,2132,2017
3405-000,2018,1,12,17,1152,954,2106,2132
3405-000,2018,1,12,18,1406,1005,2411,2106
3405-000,2018,1,12,19,1427,1041,2468,2411
3405-000,2018,1,12,20,856,616,1472,2468
3405-000,2018,1,12,21,567,482,1049,1472
3405-000,2018,1,12,22,322,357,679,1049
3405-000,2018,1,12,23,235,190,425,679
3405-000,2018,1,12,24,160,148,308,425
3405-000,2018,1,13,1,92,93,185,308
3405-000,2018,1,13,2,57,68,125,185
3405-000,2018,1,13,3,38,42,80,125
3405-000,2018,1,13,4,51,63,114,80
3405-000,2018,1,13,5,89,59,148,114
3405-000,2018,1,13,6,154,102,256,148
3405-000,2018,1,13,7,275,214,489,256
3405-000,2018,1,13,8,558,435,993,489
3405-000,2018,1,13,9,656,558,1214,993
3405-000,2018,1,13,10,658,525,1183,1214
3405-000,2018,1,13,11,786,563,1349,1183
3405-000,2018,1,13,12,765,545,1310,1349
3405-000,2018,1,13,13,656,534,1190,1310
3405-000,2018,1,13,14,663,596,1259,1190
3405-000,2018,1,13,15,707,619,1326,1259
3405-000,2018,1,13,16,705,616,1321,1326
3405-000,2018,1,13,17,652,728,1380,1321
3405-000,2018,1,13,18,750,655,1405,1380
3405-000,2018,1,13,19,590,513,1103,1405
3405-000,2018,1,13,20,355,355,710,1103
3405-000,2018,1,13,21,242,249,491,710
3405-000,2018,1,13,22,196,201,397,491
3405-000,2018,1,13,23,140,155,295,397
3405-000,2018,1,13,24,92,102,194,295
3405-000,2018,1,14,1,55,70,125,194
3405-000,2018,1,14,2,39,43,82,125
3405-000,2018,1,14,3,32,45,77,82
3405-000,2018,1,14,4,22,37,59,77
3405-000,2018,1,14,5,45,46,91,59
3405-000,2018,1,14,6,66,64,130,91
3405-000,2018,1,14,7,124,86,210,130
3405-000,2018,1,14,8,218,163,381,210
3405-000,2018,1,14,9,290,232,522,381
3405-000,2018,1,14,10,379,273,652,522
3405-000,2018,1,14,11,469,327,796,652
3405-000,2018,1,14,12,469,406,875,796
3405-000,2018,1,14,13,471,473,944,875
3405-000,2018,1,14,14,474,483,957,944
3405-000,2018,1,14,15,540,575,1115,957
3405-000,2018,1,14,16,546,590,1136,1115
3405-000,2018,1,14,17,542,627,1169,1136
3405-000,2018,1,14,18,489,668,1157,1169
3405-000,2018,1,14,19,383,500,883,1157
3405-000,2018,1,14,20,274,411,685,883
3405-000,2018,1,14,21,259,328,587,685
3405-000,2018,1,14,22,231,336,567,587
3405-000,2018,1,14,23,165,241,406,567
3405-000,2018,1,14,24,85,130,215,406
3405-000,2018,1,15,1,42,86,128,215
3405-000,2018,1,15,2,42,55,97,128
3405-000,2018,1,15,3,40,48,88,97
3405-000,2018,1,15,4,51,47,98,88
3405-000,2018,1,15,5,99,99,198,98
3405-000,2018,1,15,6,237,218,455,198
3405-000,2018,1,15,7,621,536,1157,455
3405-000,2018,1,15,8,1131,1421,2552,1157
3405-000,2018,1,15,9,1256,1289,2545,2552
3405-000,2018,1,15,10,1054,902,1956,2545
3405-000,2018,1,15,11,1137,928,2065,1956
3405-000,2018,1,15,12,1062,992,2054,2065
3405-000,2018,1,15,13,918,838,1756,2054
3405-000,2018,1,15,14,1019,980,1999,1756
3405-000,2018,1,15,15,1179,1038,2217,1999
3405-000,2018,1,15,16,1218,962,2180,2217
3405-000,2018,1,15,17,1120,941,2061,2180
3405-000,2018,1,15,18,1177,1034,2211,2061
3405-000,2018,1,15,19,1128,936,2064,2211
3405-000,2018,1,15,20,665,620,1285,2064
3405-000,2018,1,15,21,510,505,1015,1285
3405-000,2018,1,15,22,351,349,700,1015
3405-000,2018,1,15,23,198,211,409,700
3405-000,2018,1,15,24,136,125,261,409
3405-000,2018,1,16,1,84,91,175,261
3405-000,2018,1,16,2,74,61,135,175
3405-000,2018,1,16,3,46,70,116,135
3405-000,2018,1,16,4,63,60,123,116
3405-000,2018,1,16,5,93,96,189,123
3405-000,2018,1,16,6,213,179,392,189
3405-000,2018,1,16,7,516,457,973,392
3405-000,2018,1,16,8,1107,1229,2336,973
3405-000,2018,1,16,9,1199,1231,2430,2336
3405-000,2018,1,16,10,1051,965,2016,2430
3405-000,2018,1,16,11,1117,960,2077,2016
3405-000,2018,1,16,12,1001,958,1959,2077
3405-000,2018,1,16,13,882,812,1694,1959
3405-000,2018,1,16,14,1022,926,1948,1694
3405-000,2018,1,16,15,1108,968,2076,1948
3405-000,2018,1,16,16,1032,983,2015,2076
3405-000,2018,1,16,17,1095,926,2021,2015
3405-000,2018,1,16,18,1187,931,2118,2021
3405-000,2018,1,16,19,1015,905,1920,2118
3405-000,2018,1,16,20,677,562,1239,1920
3405-000,2018,1,16,21,538,517,1055,1239
3405-000,2018,1,16,22,305,369,674,1055
3405-000,2018,1,16,23,244,197,441,674
3405-000,2018,1,16,24,145,132,277,441
3405-000,2018,1,17,1,71,88,159,277
3405-000,2018,1,17,2,61,61,122,159
3405-000,2018,1,17,3,68,53,121,122
3405-000,2018,1,17,4,54,53,107,121
3405-000,2018,1,17,5,89,105,194,107
3405-000,2018,1,17,6,211,173,384,194
3405-000,2018,1,17,7,507,433,940,384
3405-000,2018,1,17,8,1058,1173,2231,940
3405-000,2018,1,17,9,1260,1282,2542,2231
3405-000,2018,1,17,10,1035,933,1968,2542
3405-000,2018,1,17,11,1091,992,2083,1968
3405-000,2018,1,17,12,1053,949,2002,2083
3405-000,2018,1,17,13,959,862,1821,2002
3405-000,2018,1,17,14,990,1024,2014,1821
3405-000,2018,1,17,15,1191,1051,2242,2014
3405-000,2018,1,17,16,1145,956,2101,2242
3405-000,2018,1,17,17,1036,888,1924,2101
3405-000,2018,1,17,18,1214,1051,2265,1924
3405-000,2018,1,17,19,1148,950,2098,2265
3405-000,2018,1,17,20,655,583,1238,2098
3405-000,2018,1,17,21,467,445,912,1238
3405-000,2018,1,17,22,334,356,690,912
3405-000,2018,1,17,23,205,180,385,690
3405-000,2018,1,17,24,135,137,272,385
3405-000,2018,1,18,1,83,100,183,272
3405-000,2018,1,18,2,63,54,117,183
3405-000,2018,1,18,3,58,63,121,117
3405-000,2018,1,18,4,63,55,118,121
3405-000,2018,1,18,5,99,93,192,118
3405-000,2018,1,18,6,196,186,382,192
3405-000,2018,1,18,7,518,430,948,382
3405-000,2018,1,18,8,1077,1207,2284,948
3405-000,2018,1,18,9,1329,1295,2624,2284
3405-000,2018,1,18,10,1135,888,2023,2624
3405-000,2018,1,18,11,1103,1059,2162,2023
3405-000,2018,1,18,12,1045,900,1945,2162
3405-000,2018,1,18,13,949,753,1702,1945
3405-000,2018,1,18,14,982,944,1926,1702
3405-000,2018,1,18,15,1143,1049,2192,1926
3405-000,2018,1,18,16,928,879,1807,2192
3405-000,2018,1,18,17,1113,998,2111,1807
3405-000,2018,1,18,18,1242,1034,2276,2111
3405-000,2018,1,18,19,1114,984,2098,2276
3405-000,2018,1,18,20,644,543,1187,2098
3405-000,2018,1,18,21,509,507,1016,1187
3405-000,2018,1,18,22,299,344,643,1016
3405-000,2018,1,18,23,208,204,412,643
3405-000,2018,1,18,24,141,145,286,412
3405-000,2018,1,19,1,86,105,191,286
3405-000,2018,1,19,2,62,53,115,191
3405-000,2018,1,19,3,59,66,125,115
3405-000,2018,1,19,4,57,58,115,125
3405-000,2018,1,19,5,110,72,182,115
3405-000,2018,1,19,6,217,179,396,182
3405-000,2018,1,19,7,513,410,923,396
3405-000,2018,1,19,8,1105,1235,2340,923
3405-000,2018,1,19,9,1312,1303,2615,2340
3405-000,2018,1,19,10,1118,905,2023,2615
3405-000,2018,1,19,11,1234,959,2193,2023
3405-000,2018,1,19,12,1084,943,2027,2193
3405-000,2018,1,19,13,1000,850,1850,2027
3405-000,2018,1,19,14,1051,943,1994,1850
3405-000,2018,1,19,15,1199,1046,2245,1994
3405-000,2018,1,19,16,1281,1002,2283,2245
3405-000,2018,1,19,17,1219,1027,2246,2283
3405-000,2018,1,19,18,1459,1121,2580,2246
3405-000,2018,1,19,19,1612,1106,2718,2580
3405-000,2018,1,19,20,879,678,1557,2718
3405-000,2018,1,19,21,547,538,1085,1557
3405-000,2018,1,19,22,377,416,793,1085
3405-000,2018,1,19,23,266,219,485,793
3405-000,2018,1,19,24,140,146,286,485
3405-000,2018,1,20,1,107,93,200,286
3405-000,2018,1,20,2,84,82,166,200
3405-000,2018,1,20,3,64,55,119,166
3405-000,2018,1,20,4,56,82,138,119
3405-000,2018,1,20,5,76,72,148,138
3405-000,2018,1,20,6,159,143,302,148
3405-000,2018,1,20,7,348,252,600,302
3405-000,2018,1,20,8,623,572,1195,600
3405-000,2018,1,20,9,856,705,1561,1195
3405-000,2018,1,20,10,883,716,1599,1561
3405-000,2018,1,20,11,902,696,1598,1599
3405-000,2018,1,20,12,852,696,1548,1598
3405-000,2018,1,20,13,792,625,1417,1548
3405-000,2018,1,20,14,780,622,1402,1417
3405-000,2018,1,20,15,816,650,1466,1402
3405-000,2018,1,20,16,821,699,1520,1466
3405-000,2018,1,20,17,880,771,1651,1520
3405-000,2018,1,20,18,863,856,1719,1651
3405-000,2018,1,20,19,678,557,1235,1719
3405-000,2018,1,20,20,412,402,814,1235
3405-000,2018,1,20,21,297,358,655,814
3405-000,2018,1,20,22,226,230,456,655
3405-000,2018,1,20,23,165,184,349,456
3405-000,2018,1,20,24,131,117,248,349
3405-000,2018,1,21,1,71,89,160,248
3405-000,2018,1,21,2,53,37,90,160
3405-000,2018,1,21,3,39,31,70,90
3405-000,2018,1,21,4,25,40,65,70
3405-000,2018,1,21,5,38,31,69,65
3405-000,2018,1,21,6,64,59,123,69
3405-000,2018,1,21,7,134,110,244,123
3405-000,2018,1,21,8,268,184,452,244
3405-000,2018,1,21,9,322,230,552,452
3405-000,2018,1,21,10,391,298,689,552
3405-000,2018,1,21,11,487,406,893,689
3405-000,2018,1,21,12,468,430,898,893
3405-000,2018,1,21,13,482,446,928,898
3405-000,2018,1,21,14,540,555,1095,928
3405-000,2018,1,21,15,575,602,1177,1095
3405-000,2018,1,21,16,619,560,1179,1177
3405-000,2018,1,21,17,600,678,1278,1179
3405-000,2018,1,21,18,574,677,1251,1278
3405-000,2018,1,21,19,432,511,943,1251
3405-000,2018,1,21,20,321,442,763,943
3405-000,2018,1,21,21,290,363,653,763
3405-000,2018,1,21,22,202,358,560,653
3405-000,2018,1,21,23,181,270,451,560
3405-000,2018,1,21,24,100,151,251,451
3405-000,2018,1,22,1,71,102,173,251
3405-000,2018,1,22,2,36,64,100,173
3405-000,2018,1,22,3,42,58,100,100
3405-000,2018,1,22,4,62,65,127,100
3405-000,2018,1,22,5,111,89,200,127
3405-000,2018,1,22,6,271,192,463,200
3405-000,2018,1,22,7,630,598,1228,463
3405-000,2018,1,22,8,1180,1497,2677,1228
3405-000,2018,1,22,9,1257,1350,2607,2677
3405-000,2018,1,22,10,1102,911,2013,2607
3405-000,2018,1,22,11,1091,963,2054,2013
3405-000,2018,1,22,12,1077,892,1969,2054
3405-000,2018,1,22,13,924,843,1767,1969
3405-000,2018,1,22,14,1047,1000,2047,1767
3405-000,2018,1,22,15,1177,1065,2242,2047
3405-000,2018,1,22,16,1196,1036,2232,2242
3405-000,2018,1,22,17,1106,949,2055,2232
3405-000,2018,1,22,18,1163,917,2080,2055
3405-000,2018,1,22,19,1055,915,1970,2080
3405-000,2018,1,22,20,632,612,1244,1970
3405-000,2018,1,22,21,483,537,1020,1244
3405-000,2018,1,22,22,300,324,624,1020
3405-000,2018,1,22,23,180,195,375,624
3405-000,2018,1,22,24,112,122,234,375
3405-000,2018,1,23,1,78,97,175,234
3405-000,2018,1,23,2,69,69,138,175
3405-000,2018,1,23,3,39,52,91,138
3405-000,2018,1,23,4,56,50,106,91
3405-000,2018,1,23,5,74,72,146,106
3405-000,2018,1,23,6,197,141,338,146
3405-000,2018,1,23,7,449,402,851,338
3405-000,2018,1,23,8,1044,1156,2200,851
3405-000,2018,1,23,9,1152,1196,2348,2200
3405-000,2018,1,23,10,1102,921,2023,2348
3405-000,2018,1,23,11,1057,945,2002,2023
3405-000,2018,1,23,12,978,900,1878,2002
3405-000,2018,1,23,13,848,776,1624,1878
3405-000,2018,1,23,14,963,903,1866,1624
3405-000,2018,1,23,15,1085,979,2064,1866
3405-000,2018,1,23,16,1120,932,2052,2064
3405-000,2018,1,23,17,1070,870,1940,2052
3405-000,2018,1,23,18,1215,1022,2237,1940
3405-000,2018,1,23,19,1017,940,1957,2237
3405-000,2018,1,23,20,583,572,1155,1957
3405-000,2018,1,23,21,498,532,1030,1155
3405-000,2018,1,23,22,340,338,678,1030
3405-000,2018,1,23,23,240,187,427,678
3405-000,2018,1,23,24,114,134,248,427
3405-000,2018,1,24,1,90,87,177,248
3405-000,2018,1,24,2,56,66,122,177
3405-000,2018,1,24,3,54,61,115,122
3405-000,2018,1,24,4,63,53,116,115
3405-000,2018,1,24,5,73,80,153,116
3405-000,2018,1,24,6,209,136,345,153
3405-000,2018,1,24,7,476,360,836,345
3405-000,2018,1,24,8,1033,1207,2240,836
3405-000,2018,1,24,9,1226,1208,2434,2240
3405-000,2018,1,24,10,985,854,1839,2434
3405-000,2018,1,24,11,1044,942,1986,1839
3405-000,2018,1,24,12,990,917,1907,1986
3405-000,2018,1,24,13,848,825,1673,1907
3405-000,2018,1,24,14,890,935,1825,1673
3405-000,2018,1,24,15,1133,950,2083,1825
3405-000,2018,1,24,16,1052,894,1946,2083
3405-000,2018,1,24,17,971,837,1808,1946
3405-000,2018,1,24,18,1190,982,2172,1808
3405-000,2018,1,24,19,1116,939,2055,2172
3405-000,2018,1,24,20,612,568,1180,2055
3405-000,2018,1,24,21,474,441,915,1180
3405-000,2018,1,24,22,283,298,581,915
3405-000,2018,1,24,23,203,179,382,581
3405-000,2018,1,24,24,107,117,224,382
3405-000,2018,1,25,1,64,93,157,224
3405-000,2018,1,25,2,49,61,110,157
3405-000,2018,1,25,3,61,47,108,110
3405-000,2018,1,25,4,57,52,109,108
3405-000,2018,1,25,5,94,84,178,109
3405-000,2018,1,25,6,184,157,341,178
3405-000,2018,1,25,7,442,388,830,341
3405-000,2018,1,25,8,984,1245,2229,830
3405-000,2018,1,25,9,1272,1168,2440,2229
3405-000,2018,1,25,10,954,896,1850,2440
3405-000,2018,1,25,11,1031,952,1983,1850
3405-000,2018,1,25,12,952,928,1880,1983
3405-000,2018,1,25,13,863,800,1663,1880
3405-000,2018,1,25,14,1005,983,1988,1663
3405-000,2018,1,25,15,1193,929,2122,1988
3405-000,2018,1,25,16,1146,922,2068,2122
3405-000,2018,1,25,17,1040,947,1987,2068
3405-000,2018,1,25,18,1137,963,2100,1987
3405-000,2018,1,25,19,1001,865,1866,2100
3405-000,2018,1,25,20,624,569,1193,1866
3405-000,2018,1,25,21,464,470,934,1193
3405-000,2018,1,25,22,325,357,682,934
3405-000,2018,1,25,23,217,203,420,682
3405-000,2018,1,25,24,121,127,248,420
3405-000,2018,1,26,1,82,97,179,248
3405-000,2018,1,26,2,51,81,132,179
3405-000,2018,1,26,3,41,37,78,132
3405-000,2018,1,26,4,62,57,119,78
3405-000,2018,1,26,5,87,84,171,119
3405-000,2018,1,26,6,208,155,363,171
3405-000,2018,1,26,7,401,364,765,363
3405-000,2018,1,26,8,953,1162,2115,765
3405-000,2018,1,26,9,1186,1189,2375,2115
3405-000,2018,1,26,10,995,880,1875,2375
3405-000,2018,1,26,11,1013,875,1888,1875
3405-000,2018,1,26,12,1026,850,1876,1888
3405-000,2018,1,26,13,835,790,1625,1876
3405-000,2018,1,26,14,1046,937,1983,1625
3405-000,2018,1,26,15,1277,1006,2283,1983
3405-000,2018,1,26,16,1111,984,2095,2283
3405-000,2018,1,26,17,1155,1008,2163,2095
3405-000,2018,1,26,18,1349,1060,2409,2163
3405-000,2018,1,26,19,1456,1021,2477,2409
3405-000,2018,1,26,20,797,698,1495,2477
3405-000,2018,1,26,21,570,487,1057,1495
3405-000,2018,1,26,22,354,354,708,1057
3405-000,2018,1,26,23,227,205,432,708
3405-000,2018,1,26,24,138,126,264,432
3405-000,2018,1,27,1,67,94,161,264
3405-000,2018,1,27,2,63,67,130,161
3405-000,2018,1,27,3,49,61,110,130
3405-000,2018,1,27,4,35,67,102,110
3405-000,2018,1,27,5,65,52,117,102
3405-000,2018,1,27,6,137,98,235,117
3405-000,2018,1,27,7,268,205,473,235
3405-000,2018,1,27,8,585,451,1036,473
3405-000,2018,1,27,9,682,585,1267,1036
3405-000,2018,1,27,10,757,598,1355,1267
3405-000,2018,1,27,11,812,668,1480,1355
3405-000,2018,1,27,12,962,626,1588,1480
3405-000,2018,1,27,13,804,623,1427,1588
3405-000,2018,1,27,14,744,620,1364,1427
3405-000,2018,1,27,15,778,596,1374,1364
3405-000,2018,1,27,16,814,674,1488,1374
3405-000,2018,1,27,17,726,668,1394,1488
3405-000,2018,1,27,18,784,773,1557,1394
3405-000,2018,1,27,19,612,532,1144,1557
3405-000,2018,1,27,20,366,358,724,1144
3405-000,2018,1,27,21,273,281,554,724
3405-000,2018,1,27,22,207,211,418,554
3405-000,2018,1,27,23,132,166,298,418
3405-000,2018,1,27,24,95,103,198,298
3405-000,2018,1,28,1,65,73,138,198
3405-000,2018,1,28,2,39,38,77,138
3405-000,2018,1,28,3,27,47,74,77
3405-000,2018,1,28,4,38,39,77,74
3405-000,2018,1,28,5,39,40,79,77
3405-000,2018,1,28,6,85,43,128,79
3405-000,2018,1,28,7,122,97,219,128
3405-000,2018,1,28,8,249,168,417,219
3405-000,2018,1,28,9,313,250,563,417
3405-000,2018,1,28,10,396,343,739,563
3405-000,2018,1,28,11,504,351,855,739
3405-000,2018,1,28,12,457,432,889,855
3405-000,2018,1,28,13,460,433,893,889
3405-000,2018,1,28,14,471,508,979,893
3405-000,2018,1,28,15,580,562,1142,979
3405-000,2018,1,28,16,559,638,1197,1142
3405-000,2018,1,28,17,567,621,1188,1197
3405-000,2018,1,28,18,471,655,1126,1188
3405-000,2018,1,28,19,343,485,828,1126
3405-000,2018,1,28,20,309,377,686,828
3405-000,2018,1,28,21,267,347,614,686
3405-000,2018,1,28,22,207,330,537,614
3405-000,2018,1,28,23,163,238,401,537
3405-000,2018,1,28,24,88,155,243,401
3405-000,2018,1,29,1,33,77,110,243
3405-000,2018,1,29,2,34,59,93,110
3405-000,2018,1,29,3,38,56,94,93
3405-000,2018,1,29,4,55,51,106,94
3405-000,2018,1,29,5,75,72,147,106
3405-000,2018,1,29,6,218,192,410,147
3405-000,2018,1,29,7,563,551,1114,410
3405-000,2018,1,29,8,1124,1470,2594,1114
3405-000,2018,1,29,9,1183,1315,2498,2594
3405-000,2018,1,29,10,989,933,1922,2498
3405-000,2018,1,29,11,1054,923,1977,1922
3405-000,2018,1,29,12,1015,946,1961,1977
3405-000,2018,1,29,13,873,837,1710,1961
3405-000,2018,1,29,14,946,942,1888,1710
3405-000,2018,1,29,15,1163,987,2150,1888
3405-000,2018,1,29,16,1495,948,2443,2150
3405-000,2018,1,29,17,1248,937,2185,2443
3405-000,2018,1,29,18,1132,964,2096,2185
3405-000,2018,1,29,19,1089,977,2066,2096
3405-000,2018,1,29,20,621,612,1233,2066
3405-000,2018,1,29,21,527,510,1037,1233
3405-000,2018,1,29,22,316,389,705,1037
3405-000,2018,1,29,23,222,224,446,705
3405-000,2018,1,29,24,125,143,268,446
3405-000,2018,1,30,1,95,87,182,268
3405-000,2018,1,30,2,59,66,125,182
3405-000,2018,1,30,3,40,60,100,125
3405-000,2018,1,30,4,60,53,113,100
3405-000,2018,1,30,5,112,87,199,113
3405-000,2018,1,30,6,216,164,380,199
3405-000,2018,1,30,7,527,410,937,380
3405-000,2018,1,30,8,1058,1228,2286,937
3405-000,2018,1,30,9,1054,1216,2270,2286
3405-000,2018,1,30,10,1110,946,2056,2270
3405-000,2018,1,30,11,1051,1020,2071,2056
3405-000,2018,1,30,12,981,896,1877,2071
3405-000,2018,1,30,13,879,791,1670,1877
3405-000,2018,1,30,14,1064,976,2040,1670
3405-000,2018,1,30,15,1205,1038,2243,2040
3405-000,2018,1,30,16,1156,941,2097,2243
3405-000,2018,1,30,17,1053,931,1984,2097
3405-000,2018,1,30,18,1155,995,2150,1984
3405-000,2018,1,30,19,1017,942,1959,2150
3405-000,2018,1,30,20,659,594,1253,1959
3405-000,2018,1,30,21,489,483,972,1253
3405-000,2018,1,30,22,353,332,685,972
3405-000,2018,1,30,23,231,197,428,685
3405-000,2018,1,30,24,122,116,238,428
3405-000,2018,1,31,1,82,118,200,238
3405-000,2018,1,31,2,75,76,151,200
3405-000,2018,1,31,3,67,42,109,151
3405-000,2018,1,31,4,58,58,116,109
3405-000,2018,1,31,5,97,83,180,116
3405-000,2018,1,31,6,220,154,374,180
3405-000,2018,1,31,7,517,390,907,374
3405-000,2018,1,31,8,1052,1248,2300,907
3405-000,2018,1,31,9,1264,1232,2496,2300
3405-000,2018,1,31,10,1073,933,2006,2496
3405-000,2018,1,31,11,1136,943,2079,2006
3405-000,2018,1,31,12,1020,991,2011,2079
3405-000,2018,1,31,13,889,816,1705,2011
3405-000,2018,1,31,14,1048,946,1994,1705
3405-000,2018,1,31,15,1198,966,2164,1994
3405-000,2018,1,31,16,1134,972,2106,2164
3405-000,2018,1,31,17,1021,961,1982,2106
3405-000,2018,1,31,18,1286,1082,2368,1982
3405-000,2018,1,31,19,1202,994,2196,2368
3405-000,2018,1,31,20,647,555,1202,2196
3405-000,2018,1,31,21,490,463,953,1202
3405-000,2018,1,31,22,353,295,648,953
3405-000,2018,1,31,23,200,216,416,648
3405-000,2018,1,31,24,140,130,270,416
3405-000,2018,2,1,1,87,106,193,270
3405-000,2018,2,1,2,59,67,126,193
3405-000,2018,2,1,3,51,63,114,126
3405-000,2018,2,1,4,63,63,126,114
3405-000,2018,2,1,5,101,85,186,126
3405-000,2018,2,1,6,205,168,373,186
3405-000,2018,2,1,7,506,411,917,373
3405-000,2018,2,1,8,1047,1254,2301,917
3405-000,2018,2,1,9,1292,1267,2559,2301
3405-000,2018,2,1,10,1059,885,1944,2559
3405-000,2018,2,1,11,1144,934,2078,1944
3405-000,2018,2,1,12,1006,899,1905,2078
3405-000,2018,2,1,13,887,804,1691,1905
3405-000,2018,2,1,14,991,965,1956,1691
3405-000,2018,2,1,15,1167,976,2143,1956
3405-000,2018,2,1,16,1125,1036,2161,2143
3405-000,2018,2,1,17,1063,983,2046,2161
3405-000,2018,2,1,18,1222,1067,2289,2046
3405-000,2018,2,1,19,1102,1012,2114,2289
3405-000,2018,2,1,20,710,591,1301,2114
3405-000,2018,2,1,21,512,513,1025,1301
3405-000,2018,2,1,22,342,372,714,1025
3405-000,2018,2,1,23,196,203,399,714
3405-000,2018,2,1,24,152,135,287,399
3405-000,2018,2,2,1,105,107,212,287
3405-000,2018,2,2,2,52,53,105,212
3405-000,2018,2,2,3,41,61,102,105
3405-000,2018,2,2,4,52,57,109,102
3405-000,2018,2,2,5,87,89,176,109
3405-000,2018,2,2,6,203,180,383,176
3405-000,2018,2,2,7,518,441,959,383
3405-000,2018,2,2,8,1094,1215,2309,959
3405-000,2018,2,2,9,1267,1283,2550,2309
3405-000,2018,2,2,10,992,906,1898,2550
3405-000,2018,2,2,11,1095,981,2076,1898
3405-000,2018,2,2,12,1107,895,2002,2076
3405-000,2018,2,2,13,872,864,1736,2002
3405-000,2018,2,2,14,1029,1007,2036,1736
3405-000,2018,2,2,15,1182,1000,2182,2036
3405-000,2018,2,2,16,1190,934,2124,2182
3405-000,2018,2,2,17,1165,967,2132,2124
3405-000,2018,2,2,18,1486,1161,2647,2132
3405-000,2018,2,2,19,1478,987,2465,2647
3405-000,2018,2,2,20,894,732,1626,2465
3405-000,2018,2,2,21,587,587,1174,1626
3405-000,2018,2,2,22,400,375,775,1174
3405-000,2018,2,2,23,257,198,455,775
3405-000,2018,2,2,24,145,125,270,455
3405-000,2018,2,3,1,85,110,195,270
3405-000,2018,2,3,2,63,70,133,195
3405-000,2018,2,3,3,58,63,121,133
3405-000,2018,2,3,4,56,68,124,121
3405-000,2018,2,3,5,78,71,149,124
3405-000,2018,2,3,6,171,121,292,149
3405-000,2018,2,3,7,327,247,574,292
3405-000,2018,2,3,8,588,549,1137,574
3405-000,2018,2,3,9,767,620,1387,1137
3405-000,2018,2,3,10,796,663,1459,1387
3405-000,2018,2,3,11,837,687,1524,1459
3405-000,2018,2,3,12,800,672,1472,1524
3405-000,2018,2,3,13,810,577,1387,1472
3405-000,2018,2,3,14,735,589,1324,1387
3405-000,2018,2,3,15,826,654,1480,1324
3405-000,2018,2,3,16,804,638,1442,1480
3405-000,2018,2,3,17,724,693,1417,1442
3405-000,2018,2,3,18,792,801,1593,1417
3405-000,2018,2,3,19,625,578,1203,1593
3405-000,2018,2,3,20,394,393,787,1203
3405-000,2018,2,3,21,300,281,581,787
3405-000,2018,2,3,22,209,222,431,581
3405-000,2018,2,3,23,163,143,306,431
3405-000,2018,2,3,24,106,109,215,306
3405-000,2018,2,4,1,66,79,145,215
3405-000,2018,2,4,2,53,38,91,145
3405-000,2018,2,4,3,23,33,56,91
3405-000,2018,2,4,4,26,33,59,56
3405-000,2018,2,4,5,38,41,79,59
3405-000,2018,2,4,6,78,46,124,79
3405-000,2018,2,4,7,143,127,270,124
3405-000,2018,2,4,8,214,184,398,270
3405-000,2018,2,4,9,347,267,614,398
3405-000,2018,2,4,10,344,285,629,614
3405-000,2018,2,4,11,475,397,872,629
3405-000,2018,2,4,12,417,468,885,872
3405-000,2018,2,4,13,441,462,903,885
3405-000,2018,2,4,14,472,494,966,903
3405-000,2018,2,4,15,553,644,1197,966
3405-000,2018,2,4,16,558,601,1159,1197
3405-000,2018,2,4,17,576,605,1181,1159
3405-000,2018,2,4,18,521,647,1168,1181
3405-000,2018,2,4,19,435,472,907,1168
3405-000,2018,2,4,20,332,419,751,907
3405-000,2018,2,4,21,277,312,589,751
3405-000,2018,2,4,22,220,279,499,589
3405-000,2018,2,4,23,162,245,407,499
3405-000,2018,2,4,24,103,142,245,407
3405-000,2018,2,5,1,55,85,140,245
3405-000,2018,2,5,2,27,63,90,140
3405-000,2018,2,5,3,43,40,83,90
3405-000,2018,2,5,4,42,48,90,83
3405-000,2018,2,5,5,91,88,179,90
3405-000,2018,2,5,6,223,183,406,179
3405-000,2018,2,5,7,590,543,1133,406
3405-000,2018,2,5,8,1066,1454,2520,1133
3405-000,2018,2,5,9,1240,1355,2595,2520
3405-000,2018,2,5,10,999,855,1854,2595
3405-000,2018,2,5,11,1087,943,2030,1854
3405-000,2018,2,5,12,1058,943,2001,2030
3405-000,2018,2,5,13,856,795,1651,2001
3405-000,2018,2,5,14,930,925,1855,1651
3405-000,2018,2,5,15,1140,984,2124,1855
3405-000,2018,2,5,16,1154,968,2122,2124
3405-000,2018,2,5,17,1074,872,1946,2122
3405-000,2018,2,5,18,1146,1028,2174,1946
3405-000,2018,2,5,19,1007,911,1918,2174
3405-000,2018,2,5,20,697,627,1324,1918
3405-000,2018,2,5,21,467,512,979,1324
3405-000,2018,2,5,22,387,397,784,979
3405-000,2018,2,5,23,206,217,423,784
3405-000,2018,2,5,24,133,132,265,423
3405-000,2018,2,6,1,87,83,170,265
3405-000,2018,2,6,2,64,68,132,170
3405-000,2018,2,6,3,55,55,110,132
3405-000,2018,2,6,4,59,79,138,110
3405-000,2018,2,6,5,104,86,190,138
3405-000,2018,2,6,6,208,171,379,190
3405-000,2018,2,6,7,499,415,914,379
3405-000,2018,2,6,8,1020,1207,2227,914
3405-000,2018,2,6,9,1213,1261,2474,2227
3405-000,2018,2,6,10,1078,893,1971,2474
3405-000,2018,2,6,11,1123,962,2085,1971
3405-000,2018,2,6,12,1019,914,1933,2085
3405-000,2018,2,6,13,875,784,1659,1933
3405-000,2018,2,6,14,1021,944,1965,1659
3405-000,2018,2,6,15,1156,1032,2188,1965
3405-000,2018,2,6,16,1107,982,2089,2188
3405-000,2018,2,6,17,1082,929,2011,2089
3405-000,2018,2,6,18,1197,1027,2224,2011
3405-000,2018,2,6,19,1013,965,1978,2224
3405-000,2018,2,6,20,698,630,1328,1978
3405-000,2018,2,6,21,502,536,1038,1328
3405-000,2018,2,6,22,391,387,778,1038
3405-000,2018,2,6,23,238,254,492,778
3405-000,2018,2,6,24,125,139,264,492
3405-000,2018,2,7,1,83,104,187,264
3405-000,2018,2,7,2,65,60,125,187
3405-000,2018,2,7,3,70,58,128,125
3405-000,2018,2,7,4,76,51,127,128
3405-000,2018,2,7,5,93,99,192,127
3405-000,2018,2,7,6,209,145,354,192
3405-000,2018,2,7,7,432,384,816,354
3405-000,2018,2,7,8,1033,1190,2223,816
3405-000,2018,2,7,9,1236,1265,2501,2223
3405-000,2018,2,7,10,1028,927,1955,2501
3405-000,2018,2,7,11,1091,976,2067,1955
3405-000,2018,2,7,12,1058,926,1984,2067
3405-000,2018,2,7,13,958,847,1805,1984
3405-000,2018,2,7,14,1081,969,2050,1805
3405-000,2018,2,7,15,1137,1070,2207,2050
3405-000,2018,2,7,16,1276,1057,2333,2207
3405-000,2018,2,7,17,1115,1040,2155,2333
3405-000,2018,2,7,18,1322,1020,2342,2155
3405-000,2018,2,7,19,1176,1010,2186,2342
3405-000,2018,2,7,20,686,607,1293,2186
3405-000,2018,2,7,21,475,465,940,1293
3405-000,2018,2,7,22,373,359,732,940
3405-000,2018,2,7,23,257,244,501,732
3405-000,2018,2,7,24,123,150,273,501
3405-000,2018,2,8,1,84,104,188,273
3405-000,2018,2,8,2,63,82,145,188
3405-000,2018,2,8,3,56,59,115,145
3405-000,2018,2,8,4,65,63,128,115
3405-000,2018,2,8,5,117,90,207,128
3405-000,2018,2,8,6,242,148,390,207
3405-000,2018,2,8,7,486,415,901,390
3405-000,2018,2,8,8,1044,1193,2237,901
3405-000,2018,2,8,9,1240,1329,2569,2237
3405-000,2018,2,8,10,1041,939,1980,2569
3405-000,2018,2,8,11,1163,1033,2196,1980
3405-000,2018,2,8,12,1076,935,2011,2196
3405-000,2018,2,8,13,916,821,1737,2011
3405-000,2018,2,8,14,1083,921,2004,1737
3405-000,2018,2,8,15,1176,1089,2265,2004
3405-000,2018,2,8,16,1218,1018,2236,2265
3405-000,2018,2,8,17,1124,962,2086,2236
3405-000,2018,2,8,18,1205,1066,2271,2086
3405-000,2018,2,8,19,1150,963,2113,2271
3405-000,2018,2,8,20,740,586,1326,2113
3405-000,2018,2,8,21,567,535,1102,1326
3405-000,2018,2,8,22,374,377,751,1102
3405-000,2018,2,8,23,231,226,457,751
3405-000,2018,2,8,24,118,163,281,457
3405-000,2018,2,9,1,78,105,183,281
3405-000,2018,2,9,2,46,64,110,183
3405-000,2018,2,9,3,41,57,98,110
3405-000,2018,2,9,4,70,80,150,98
3405-000,2018,2,9,5,86,90,176,150
3405-000,2018,2,9,6,231,189,420,176
3405-000,2018,2,9,7,493,420,913,420
3405-000,2018,2,9,8,1068,1223,2291,913
3405-000,2018,2,9,9,1328,1213,2541,2291
3405-000,2018,2,9,10,1069,918,1987,2541
3405-000,2018,2,9,11,1140,1055,2195,1987
3405-000,2018,2,9,12,1113,991,2104,2195
3405-000,2018,2,9,13,1006,845,1851,2104
3405-000,2018,2,9,14,1065,995,2060,1851
3405-000,2018,2,9,15,1213,1116,2329,2060
3405-000,2018,2,9,16,1283,1046,2329,2329
3405-000,2018,2,9,17,1190,1057,2247,2329
3405-000,2018,2,9,18,1444,1149,2593,2247
3405-000,2018,2,9,19,1446,1057,2503,2593
3405-000,2018,2,9,20,1005,683,1688,2503
3405-000,2018,2,9,21,640,557,1197,1688
3405-000,2018,2,9,22,393,409,802,1197
3405-000,2018,2,9,23,280,210,490,802
3405-000,2018,2,9,24,182,178,360,490
3405-000,2018,2,10,1,113,98,211,360
3405-000,2018,2,10,2,75,71,146,211
3405-000,2018,2,10,3,57,62,119,146
3405-000,2018,2,10,4,80,95,175,119
3405-000,2018,2,10,5,92,88,180,175
3405-000,2018,2,10,6,188,146,334,180
3405-000,2018,2,10,7,397,263,660,334
3405-000,2018,2,10,8,692,597,1289,660
3405-000,2018,2,10,9,880,763,1643,1289
3405-000,2018,2,10,10,944,693,1637,1643
3405-000,2018,2,10,11,893,728,1621,1637
3405-000,2018,2,10,12,919,668,1587,1621
3405-000,2018,2,10,13,879,648,1527,1587
3405-000,2018,2,10,14,789,692,1481,1527
3405-000,2018,2,10,15,884,687,1571,1481
3405-000,2018,2,10,16,879,731,1610,1571
3405-000,2018,2,10,17,867,664,1531,1610
3405-000,2018,2,10,18,1020,864,1884,1531
3405-000,2018,2,10,19,660,637,1297,1884
3405-000,2018,2,10,20,438,400,838,1297
3405-000,2018,2,10,21,289,297,586,838
3405-000,2018,2,10,22,231,220,451,586
3405-000,2018,2,10,23,167,176,343,451
3405-000,2018,2,10,24,102,105,207,343
3405-000,2018,2,11,1,70,97,167,207
3405-000,2018,2,11,2,29,27,56,167
3405-000,2018,2,11,3,33,40,73,56
3405-000,2018,2,11,4,33,51,84,73
3405-000,2018,2,11,5,50,37,87,84
3405-000,2018,2,11,6,86,63,149,87
3405-000,2018,2,11,7,147,125,272,149
3405-000,2018,2,11,8,293,256,549,272
3405-000,2018,2,11,9,414,312,726,549
3405-000,2018,2,11,10,457,349,806,726
3405-000,2018,2,11,11,555,426,981,806
3405-000,2018,2,11,12,548,459,1007,981
3405-000,2018,2,11,13,475,498,973,1007
3405-000,2018,2,11,14,491,500,991,973
3405-000,2018,2,11,15,559,543,1102,991
3405-000,2018,2,11,16,580,568,1148,1102
3405-000,2018,2,11,17,572,590,1162,1148
3405-000,2018,2,11,18,510,588,1098,1162
3405-000,2018,2,11,19,391,443,834,1098
3405-000,2018,2,11,20,286,347,633,834
3405-000,2018,2,11,21,209,314,523,633
3405-000,2018,2,11,22,202,225,427,523
3405-000,2018,2,11,23,103,191,294,427
3405-000,2018,2,11,24,76,153,229,294
3405-000,2018,2,12,1,58,101,159,229
3405-000,2018,2,12,2,39,48,87,159
3405-000,2018,2,12,3,31,44,75,87
3405-000,2018,2,12,4,31,53,84,75
3405-000,2018,2,12,5,76,82,158,84
3405-000,2018,2,12,6,213,156,369,158
3405-000,2018,2,12,7,443,515,958,369
3405-000,2018,2,12,8,945,1271,2216,958
3405-000,2018,2,12,9,1166,1223,2389,2216
3405-000,2018,2,12,10,969,908,1877,2389
3405-000,2018,2,12,11,1085,896,1981,1877
3405-000,2018,2,12,12,1148,954,2102,1981
3405-000,2018,2,12,13,987,828,1815,2102
3405-000,2018,2,12,14,1037,1013,2050,1815
3405-000,2018,2,12,15,1215,1073,2288,2050
3405-000,2018,2,12,16,1228,1062,2290,2288
3405-000,2018,2,12,17,1156,965,2121,2290
3405-000,2018,2,12,18,1181,990,2171,2121
3405-000,2018,2,12,19,1121,992,2113,2171
3405-000,2018,2,12,20,725,625,1350,2113
3405-000,2018,2,12,21,555,501,1056,1350
3405-000,2018,2,12,22,344,366,710,1056
3405-000,2018,2,12,23,244,179,423,710
3405-000,2018,2,12,24,147,158,305,423
3405-000,2018,2,13,1,82,76,158,305
3405-000,2018,2,13,2,47,77,124,158
3405-000,2018,2,13,3,45,51,96,124
3405-000,2018,2,13,4,66,66,132,96
3405-000,2018,2,13,5,97,89,186,132
3405-000,2018,2,13,6,195,162,357,186
3405-000,2018,2,13,7,404,376,780,357
3405-000,2018,2,13,8,929,1106,2035,780
3405-000,2018,2,13,9,1255,1238,2493,2035
3405-000,2018,2,13,10,1046,936,1982,2493
3405-000,2018,2,13,11,1136,1095,2231,1982
3405-000,2018,2,13,12,1180,922,2102,2231
3405-000,2018,2,13,13,1137,839,1976,2102
3405-000,2018,2,13,14,1173,1016,2189,1976
3405-000,2018,2,13,15,1328,1112,2440,2189
3405-000,2018,2,13,16,1329,1157,2486,2440
3405-000,2018,2,13,17,1188,1191,2379,2486
3405-000,2018,2,13,18,1325,1300,2625,2379
3405-000,2018,2,13,19,1403,1026,2429,2625
3405-000,2018,2,13,20,840,657,1497,2429
3405-000,2018,2,13,21,588,538,1126,1497
3405-000,2018,2,13,22,391,399,790,1126
3405-000,2018,2,13,23,286,238,524,790
3405-000,2018,2,13,24,162,173,335,524
3405-000,2018,2,14,1,120,121,241,335
3405-000,2018,2,14,2,66,72,138,241
3405-000,2018,2,14,3,56,69,125,138
3405-000,2018,2,14,4,73,67,140,125
3405-000,2018,2,14,5,90,96,186,140
3405-000,2018,2,14,6,203,148,351,186
3405-000,2018,2,14,7,448,335,783,351
3405-000,2018,2,14,8,1016,1095,2111,783
3405-000,2018,2,14,9,1212,1157,2369,2111
3405-000,2018,2,14,10,1092,903,1995,2369
3405-000,2018,2,14,11,1033,924,1957,1995
3405-000,2018,2,14,12,1095,929,2024,1957
3405-000,2018,2,14,13,995,955,1950,2024
3405-000,2018,2,14,14,1057,1112,2169,1950
3405-000,2018,2,14,15,1179,1127,2306,2169
3405-000,2018,2,14,16,1163,1203,2366,2306
3405-000,2018,2,14,17,1217,1380,2597,2366
3405-000,2018,2,14,18,1292,1388,2680,2597
3405-000,2018,2,14,19,1152,1039,2191,2680
3405-000,2018,2,14,20,674,619,1293,2191
3405-000,2018,2,14,21,442,514,956,1293
3405-000,2018,2,14,22,297,314,611,956
3405-000,2018,2,14,23,219,237,456,611
3405-000,2018,2,14,24,161,148,309,456
3405-000,2018,2,15,1,98,124,222,309
3405-000,2018,2,15,2,87,85,172,222
3405-000,2018,2,15,3,82,91,173,172
3405-000,2018,2,15,4,82,76,158,173
3405-000,2018,2,15,5,113,73,186,158
3405-000,2018,2,15,6,176,224,400,186
3405-000,2018,2,15,7,287,617,904,400
3405-000,2018,2,15,8,445,346,791,904
3405-000,2018,2,15,9,528,579,1107,791
3405-000,2018,2,15,10,645,539,1184,1107
3405-000,2018,2,15,11,846,591,1437,1184
3405-000,2018,2,15,12,801,659,1460,1437
3405-000,2018,2,15,13,696,598,1294,1460
3405-000,2018,2,15,14,619,487,1106,1294
3405-000,2018,2,15,15,602,541,1143,1106
3405-000,2018,2,15,16,565,440,1005,1143
3405-000,2018,2,15,17,491,459,950,1005
3405-000,2018,2,15,18,452,427,879,950
3405-000,2018,2,15,19,398,307,705,879
3405-000,2018,2,15,20,260,232,492,705
3405-000,2018,2,15,21,189,201,390,492
3405-000,2018,2,15,22,146,173,319,390
3405-000,2018,2,15,23,113,119,232,319
3405-000,2018,2,15,24,91,74,165,232
3405-000,2018,2,16,1,58,57,115,165
3405-000,2018,2,16,2,32,32,64,115
3405-000,2018,2,16,3,25,28,53,64
3405-000,2018,2,16,4,21,9,30,53
3405-000,2018,2,16,5,42,22,64,30
3405-000,2018,2,16,6,103,57,160,64
3405-000,2018,2,16,7,222,130,352,160
3405-000,2018,2,16,8,406,291,697,352
3405-000,2018,2,16,9,344,265,609,697
3405-000,2018,2,16,10,474,258,732,609
3405-000,2018,2,16,11,767,558,1325,732
3405-000,2018,2,16,12,990,690,1680,1325
3405-000,2018,2,16,13,946,822,1768,1680
3405-000,2018,2,16,14,927,1060,1987,1768
3405-000,2018,2,16,15,1053,895,1948,1987
3405-000,2018,2,16,16,982,899,1881,1948
3405-000,2018,2,16,17,730,991,1721,1881
3405-000,2018,2,16,18,753,727,1480,1721
3405-000,2018,2,16,19,436,875,1311,1480
3405-000,2018,2,16,20,454,558,1012,1311
3405-000,2018,2,16,21,315,570,885,1012
3405-000,2018,2,16,22,266,321,587,885
3405-000,2018,2,16,23,145,235,380,587
3405-000,2018,2,16,24,110,143,253,380
3405-000,2018,2,17,1,75,83,158,253
3405-000,2018,2,17,2,40,76,116,158
3405-000,2018,2,17,3,25,39,64,116
3405-000,2018,2,17,4,26,26,52,64
3405-000,2018,2,17,5,35,43,78,52
3405-000,2018,2,17,6,56,51,107,78
3405-000,2018,2,17,7,98,69,167,107
3405-000,2018,2,17,8,172,150,322,167
3405-000,2018,2,17,9,277,172,449,322
3405-000,2018,2,17,10,372,241,613,449
3405-000,2018,2,17,11,527,436,963,613
3405-000,2018,2,17,12,667,506,1173,963
3405-000,2018,2,17,13,594,528,1122,1173
3405-000,2018,2,17,14,647,555,1202,1122
3405-000,2018,2,17,15,856,623,1479,1202
3405-000,2018,2,17,16,801,662,1463,1479
3405-000,2018,2,17,17,614,623,1237,1463
3405-000,2018,2,17,18,545,551,1096,1237
3405-000,2018,2,17,19,485,567,1052,1096
3405-000,2018,2,17,20,351,442,793,1052
3405-000,2018,2,17,21,299,457,756,793
3405-000,2018,2,17,22,185,294,479,756
3405-000,2018,2,17,23,169,224,393,479
3405-000,2018,2,17,24,94,159,253,393
3405-000,2018,2,18,1,61,99,160,253
3405-000,2018,2,18,2,31,76,107,160
3405-000,2018,2,18,3,30,71,101,107
3405-000,2018,2,18,4,23,45,68,101
3405-000,2018,2,18,5,39,48,87,68
3405-000,2018,2,18,6,62,49,111,87
3405-000,2018,2,18,7,90,89,179,111
3405-000,2018,2,18,8,203,161,364,179
3405-000,2018,2,18,9,318,227,545,364
3405-000,2018,2,18,10,372,283,655,545
3405-000,2018,2,18,11,497,394,891,655
3405-000,2018,2,18,12,469,462,931,891
3405-000,2018,2,18,13,487,518,1005,931
3405-000,2018,2,18,14,497,621,1118,1005
3405-000,2018,2,18,15,553,595,1148,1118
3405-000,2018,2,18,16,540,625,1165,1148
3405-000,2018,2,18,17,532,594,1126,1165
3405-000,2018,2,18,18,441,571,1012,1126
3405-000,2018,2,18,19,364,452,816,1012
3405-000,2018,2,18,20,282,365,647,816
3405-000,2018,2,18,21,260,342,602,647
3405-000,2018,2,18,22,204,304,508,602
3405-000,2018,2,18,23,166,249,415,508
3405-000,2018,2,18,24,102,198,300,415
3405-000,2018,2,19,1,45,127,172,300
3405-000,2018,2,19,2,35,85,120,172
3405-000,2018,2,19,3,45,55,100,120
3405-000,2018,2,19,4,47,52,99,100
3405-000,2018,2,19,5,74,83,157,99
3405-000,2018,2,19,6,199,173,372,157
3405-000,2018,2,19,7,512,505,1017,372
3405-000,2018,2,19,8,1123,1403,2526,1017
3405-000,2018,2,19,9,1178,1196,2374,2526
3405-000,2018,2,19,10,959,746,1705,2374
3405-000,2018,2,19,11,1039,889,1928,1705
3405-000,2018,2,19,12,958,789,1747,1928
3405-000,2018,2,19,13,769,779,1548,1747
3405-000,2018,2,19,14,930,835,1765,1548
3405-000,2018,2,19,15,1042,920,1962,1765
3405-000,2018,2,19,16,1030,794,1824,1962
3405-000,2018,2,19,17,922,864,1786,1824
3405-000,2018,2,19,18,1055,931,1986,1786
3405-000,2018,2,19,19,974,904,1878,1986
3405-000,2018,2,19,20,626,607,1233,1878
3405-000,2018,2,19,21,441,488,929,1233
3405-000,2018,2,19,22,299,372,671,929
3405-000,2018,2,19,23,184,187,371,671
3405-000,2018,2,19,24,107,133,240,371
3405-000,2018,2,20,1,67,96,163,240
3405-000,2018,2,20,2,58,86,144,163
3405-000,2018,2,20,3,59,60,119,144
3405-000,2018,2,20,4,70,67,137,119
3405-000,2018,2,20,5,121,98,219,137
3405-000,2018,2,20,6,233,152,385,219
3405-000,2018,2,20,7,553,453,1006,385
3405-000,2018,2,20,8,1143,1287,2430,1006
3405-000,2018,2,20,9,1288,1310,2598,2430
3405-000,2018,2,20,10,1162,950,2112,2598
3405-000,2018,2,20,11,1223,1018,2241,2112
3405-000,2018,2,20,12,1189,947,2136,2241
3405-000,2018,2,20,13,935,827,1762,2136
3405-000,2018,2,20,14,1050,1016,2066,1762
3405-000,2018,2,20,15,1218,1004,2222,2066
3405-000,2018,2,20,16,1160,1027,2187,2222
3405-000,2018,2,20,17,1083,970,2053,2187
3405-000,2018,2,20,18,1118,979,2097,2053
3405-000,2018,2,20,19,1107,969,2076,2097
3405-000,2018,2,20,20,672,607,1279,2076
3405-000,2018,2,20,21,540,538,1078,1279
3405-000,2018,2,20,22,378,350,728,1078
3405-000,2018,2,20,23,240,193,433,728
3405-000,2018,2,20,24,133,140,273,433
3405-000,2018,2,21,1,89,102,191,273
3405-000,2018,2,21,2,55,77,132,191
3405-000,2018,2,21,3,42,65,107,132
3405-000,2018,2,21,4,75,75,150,107
3405-000,2018,2,21,5,133,86,219,150
3405-000,2018,2,21,6,230,133,363,219
3405-000,2018,2,21,7,547,464,1011,363
3405-000,2018,2,21,8,1195,1291,2486,1011
3405-000,2018,2,21,9,1410,1311,2721,2486
3405-000,2018,2,21,10,1175,974,2149,2721
3405-000,2018,2,21,11,1224,1019,2243,2149
3405-000,2018,2,21,12,1121,980,2101,2243
3405-000,2018,2,21,13,930,835,1765,2101
3405-000,2018,2,21,14,1072,1002,2074,1765
3405-000,2018,2,21,15,1202,1049,2251,2074
3405-000,2018,2,21,16,1122,976,2098,2251
3405-000,2018,2,21,17,1101,1020,2121,2098
3405-000,2018,2,21,18,1322,1051,2373,2121
3405-000,2018,2,21,19,1260,1015,2275,2373
3405-000,2018,2,21,20,673,626,1299,2275
3405-000,2018,2,21,21,498,508,1006,1299
3405-000,2018,2,21,22,375,331,706,1006
3405-000,2018,2,21,23,235,196,431,706
3405-000,2018,2,21,24,150,139,289,431
3405-000,2018,2,22,1,70,90,160,289
3405-000,2018,2,22,2,58,72,130,160
3405-000,2018,2,22,3,64,51,115,130
3405-000,2018,2,22,4,66,56,122,115
3405-000,2018,2,22,5,114,97,211,122
3405-000,2018,2,22,6,204,186,390,211
3405-000,2018,2,22,7,548,452,1000,390
3405-000,2018,2,22,8,1139,1319,2458,1000
3405-000,2018,2,22,9,1397,1313,2710,2458
3405-000,2018,2,22,10,1152,974,2126,2710
3405-000,2018,2,22,11,1121,1010,2131,2126
3405-000,2018,2,22,12,1047,909,1956,2131
3405-000,2018,2,22,13,944,826,1770,1956
3405-000,2018,2,22,14,1016,924,1940,1770
3405-000,2018,2,22,15,1127,988,2115,1940
3405-000,2018,2,22,16,1131,931,2062,2115
3405-000,2018,2,22,17,1083,1008,2091,2062
3405-000,2018,2,22,18,1176,1041,2217,2091
3405-000,2018,2,22,19,1077,967,2044,2217
3405-000,2018,2,22,20,646,634,1280,2044
3405-000,2018,2,22,21,548,505,1053,1280
3405-000,2018,2,22,22,343,370,713,1053
3405-000,2018,2,22,23,223,220,443,713
3405-000,2018,2,22,24,151,148,299,443
3405-000,2018,2,23,1,79,110,189,299
3405-000,2018,2,23,2,69,78,147,189
3405-000,2018,2,23,3,58,64,122,147
3405-000,2018,2,23,4,63,44,107,122
3405-000,2018,2,23,5,109,86,195,107
3405-000,2018,2,23,6,234,139,373,195
3405-000,2018,2,23,7,524,408,932,373
3405-000,2018,2,23,8,1078,1201,2279,932
3405-000,2018,2,23,9,1342,1243,2585,2279
3405-000,2018,2,23,10,1102,910,2012,2585
3405-000,2018,2,23,11,1093,915,2008,2012
3405-000,2018,2,23,12,998,916,1914,2008
3405-000,2018,2,23,13,958,868,1826,1914
3405-000,2018,2,23,14,1109,1022,2131,1826
3405-000,2018,2,23,15,1278,1069,2347,2131
3405-000,2018,2,23,16,1245,1017,2262,2347
3405-000,2018,2,23,17,1153,1059,2212,2262
3405-000,2018,2,23,18,1447,1125,2572,2212
3405-000,2018,2,23,19,1473,1102,2575,2572
3405-000,2018,2,23,20,817,678,1495,2575
3405-000,2018,2,23,21,596,537,1133,1495
3405-000,2018,2,23,22,415,377,792,1133
3405-000,2018,2,23,23,247,201,448,792
3405-000,2018,2,23,24,162,158,320,448
3405-000,2018,2,24,1,103,106,209,320
3405-000,2018,2,24,2,78,81,159,209
3405-000,2018,2,24,3,65,53,118,159
3405-000,2018,2,24,4,59,64,123,118
3405-000,2018,2,24,5,98,66,164,123
3405-000,2018,2,24,6,223,128,351,164
3405-000,2018,2,24,7,390,282,672,351
3405-000,2018,2,24,8,708,543,1251,672
3405-000,2018,2,24,9,884,737,1621,1251
3405-000,2018,2,24,10,897,648,1545,1621
3405-000,2018,2,24,11,930,714,1644,1545
3405-000,2018,2,24,12,903,682,1585,1644
3405-000,2018,2,24,13,810,605,1415,1585
3405-000,2018,2,24,14,780,707,1487,1415
3405-000,2018,2,24,15,799,669,1468,1487
3405-000,2018,2,24,16,794,653,1447,1468
3405-000,2018,2,24,17,816,731,1547,1447
3405-000,2018,2,24,18,903,877,1780,1547
3405-000,2018,2,24,19,703,610,1313,1780
3405-000,2018,2,24,20,412,444,856,1313
3405-000,2018,2,24,21,265,320,585,856
3405-000,2018,2,24,22,197,276,473,585
3405-000,2018,2,24,23,168,218,386,473
3405-000,2018,2,24,24,103,141,244,386
3405-000,2018,2,25,1,67,92,159,244
3405-000,2018,2,25,2,37,58,95,159
3405-000,2018,2,25,3,29,36,65,95
3405-000,2018,2,25,4,26,46,72,65
3405-000,2018,2,25,5,31,35,66,72
3405-000,2018,2,25,6,92,56,148,66
3405-000,2018,2,25,7,201,113,314,148
3405-000,2018,2,25,8,321,224,545,314
3405-000,2018,2,25,9,427,310,737,545
3405-000,2018,2,25,10,465,327,792,737
3405-000,2018,2,25,11,522,404,926,792
3405-000,2018,2,25,12,525,464,989,926
3405-000,2018,2,25,13,465,461,926,989
3405-000,2018,2,25,14,563,556,1119,926
3405-000,2018,2,25,15,575,555,1130,1119
3405-000,2018,2,25,16,530,577,1107,1130
3405-000,2018,2,25,17,589,658,1247,1107
3405-000,2018,2,25,18,583,645,1228,1247
3405-000,2018,2,25,19,469,561,1030,1228
3405-000,2018,2,25,20,354,452,806,1030
3405-000,2018,2,25,21,287,317,604,806
3405-000,2018,2,25,22,263,328,591,604
3405-000,2018,2,25,23,171,269,440,591
3405-000,2018,2,25,24,97,157,254,440
3405-000,2018,2,26,1,61,102,163,254
3405-000,2018,2,26,2,40,74,114,163
3405-000,2018,2,26,3,39,43,82,114
3405-000,2018,2,26,4,54,61,115,82
3405-000,2018,2,26,5,113,87,200,115
3405-000,2018,2,26,6,279,190,469,200
3405-000,2018,2,26,7,665,554,1219,469
3405-000,2018,2,26,8,1185,1507,2692,1219
3405-000,2018,2,26,9,1347,1404,2751,2692
3405-000,2018,2,26,10,1105,950,2055,2751
3405-000,2018,2,26,11,1214,1036,2250,2055
3405-000,2018,2,26,12,1054,955,2009,2250
3405-000,2018,2,26,13,995,849,1844,2009
3405-000,2018,2,26,14,999,1050,2049,1844
3405-000,2018,2,26,15,1240,1073,2313,2049
3405-000,2018,2,26,16,1169,1037,2206,2313
3405-000,2018,2,26,17,1123,962,2085,2206
3405-000,2018,2,26,18,1299,1013,2312,2085
3405-000,2018,2,26,19,1157,1013,2170,2312
3405-000,2018,2,26,20,702,657,1359,2170
3405-000,2018,2,26,21,552,564,1116,1359
3405-000,2018,2,26,22,374,412,786,1116
3405-000,2018,2,26,23,230,225,455,786
3405-000,2018,2,26,24,137,121,258,455
3405-000,2018,2,27,1,92,93,185,258
3405-000,2018,2,27,2,74,67,141,185
3405-000,2018,2,27,3,71,50,121,141
3405-000,2018,2,27,4,86,70,156,121
3405-000,2018,2,27,5,115,93,208,156
3405-000,2018,2,27,6,257,182,439,208
3405-000,2018,2,27,7,588,482,1070,439
3405-000,2018,2,27,8,1193,1307,2500,1070
3405-000,2018,2,27,9,1433,1275,2708,2500
3405-000,2018,2,27,10,1142,984,2126,2708
3405-000,2018,2,27,11,1303,1031,2334,2126
3405-000,2018,2,27,12,1066,1013,2079,2334
3405-000,2018,2,27,13,991,843,1834,2079
3405-000,2018,2,27,14,1139,988,2127,1834
3405-000,2018,2,27,15,1273,1003,2276,2127
3405-000,2018,2,27,16,1255,1088,2343,2276
3405-000,2018,2,27,17,1108,1062,2170,2343
3405-000,2018,2,27,18,1259,1054,2313,2170
3405-000,2018,2,27,19,1114,1014,2128,2313
3405-000,2018,2,27,20,697,687,1384,2128
3405-000,2018,2,27,21,527,600,1127,1384
3405-000,2018,2,27,22,372,391,763,1127
3405-000,2018,2,27,23,264,208,472,763
3405-000,2018,2,27,24,171,166,337,472
3405-000,2018,2,28,1,87,107,194,337
3405-000,2018,2,28,2,59,62,121,194
3405-000,2018,2,28,3,56,63,119,121
3405-000,2018,2,28,4,74,71,145,119
3405-000,2018,2,28,5,136,74,210,145
3405-000,2018,2,28,6,237,165,402,210
3405-000,2018,2,28,7,601,388,989,402
3405-000,2018,2,28,8,1157,1304,2461,989
3405-000,2018,2,28,9,1385,1308,2693,2461
3405-000,2018,2,28,10,1153,983,2136,2693
3405-000,2018,2,28,11,1294,960,2254,2136
3405-000,2018,2,28,12,1060,1023,2083,2254
3405-000,2018,2,28,13,992,804,1796,2083
3405-000,2018,2,28,14,1033,964,1997,1796
3405-000,2018,2,28,15,1196,1088,2284,1997
3405-000,2018,2,28,16,1076,900,1976,2284
3405-000,2018,2,28,17,1095,906,2001,1976
3405-000,2018,2,28,18,1386,1021,2407,2001
3405-000,2018,2,28,19,1226,989,2215,2407
3405-000,2018,2,28,20,778,694,1472,2215
3405-000,2018,2,28,21,540,476,1016,1472
3405-000,2018,2,28,22,404,329,733,1016
3405-000,2018,2,28,23,270,220,490,733
3405-000,2018,2,28,24,133,160,293,490
3405-000,2018,3,1,1,93,95,188,293
3405-000,2018,3,1,2,68,86,154,188
3405-000,2018,3,1,3,54,68,122,154
3405-000,2018,3,1,4,53,46,99,122
3405-000,2018,3,1,5,79,75,154,99
3405-000,2018,3,1,6,155,101,256,154
3405-000,2018,3,1,7,352,227,579,256
3405-000,2018,3,1,8,689,503,1192,579
3405-000,2018,3,1,9,750,568,1318,1192
3405-000,2018,3,1,10,711,572,1283,1318
3405-000,2018,3,1,11,864,622,1486,1283
3405-000,2018,3,1,12,732,636,1368,1486
3405-000,2018,3,1,13,641,628,1269,1368
3405-000,2018,3,1,14,667,634,1301,1269
3405-000,2018,3,1,15,727,606,1333,1301
3405-000,2018,3,1,16,723,680,1403,1333
3405-000,2018,3,1,17,692,692,1384,1403
3405-000,2018,3,1,18,740,841,1581,1384
3405-000,2018,3,1,19,566,589,1155,1581
3405-000,2018,3,1,20,415,413,828,1155
3405-000,2018,3,1,21,318,368,686,828
3405-000,2018,3,1,22,251,265,516,686
3405-000,2018,3,1,23,172,169,341,516
3405-000,2018,3,1,24,83,123,206,341
3405-000,2018,3,2,1,58,68,126,206
3405-000,2018,3,2,2,31,53,84,126
3405-000,2018,3,2,3,48,50,98,84
3405-000,2018,3,2,4,64,52,116,98
3405-000,2018,3,2,5,93,85,178,116
3405-000,2018,3,2,6,177,158,335,178
3405-000,2018,3,2,7,541,441,982,335
3405-000,2018,3,2,8,1119,1232,2351,982
3405-000,2018,3,2,9,1149,1152,2301,2351
3405-000,2018,3,2,10,1014,894,1908,2301
3405-000,2018,3,2,11,1060,967,2027,1908
3405-000,2018,3,2,12,1015,938,1953,2027
3405-000,2018,3,2,13,856,876,1732,1953
3405-000,2018,3,2,14,961,865,1826,1732
3405-000,2018,3,2,15,1037,913,1950,1826
3405-000,2018,3,2,16,1121,990,2111,1950
3405-000,2018,3,2,17,1063,943,2006,2111
3405-000,2018,3,2,18,1304,1050,2354,2006
3405-000,2018,3,2,19,1286,1081,2367,2354
3405-000,2018,3,2,20,808,694,1502,2367
3405-000,2018,3,2,21,544,553,1097,1502
3405-000,2018,3,2,22,415,400,815,1097
3405-000,2018,3,2,23,245,243,488,815
3405-000,2018,3,2,24,130,154,284,488
3405-000,2018,3,3,1,101,93,194,284
3405-000,2018,3,3,2,76,67,143,194
3405-000,2018,3,3,3,56,56,112,143
3405-000,2018,3,3,4,60,62,122,112
3405-000,2018,3,3,5,75,72,147,122
3405-000,2018,3,3,6,187,113,300,147
3405-000,2018,3,3,7,429,265,694,300
3405-000,2018,3,3,8,716,589,1305,694
3405-000,2018,3,3,9,856,699,1555,1305
3405-000,2018,3,3,10,870,666,1536,1555
3405-000,2018,3,3,11,918,714,1632,1536
3405-000,2018,3,3,12,901,705,1606,1632
3405-000,2018,3,3,13,791,655,1446,1606
3405-000,2018,3,3,14,763,693,1456,1446
3405-000,2018,3,3,15,837,732,1569,1456
3405-000,2018,3,3,16,809,707,1516,1569
3405-000,2018,3,3,17,832,761,1593,1516
3405-000,2018,3,3,18,859,938,1797,1593
3405-000,2018,3,3,19,675,627,1302,1797
3405-000,2018,3,3,20,404,439,843,1302
3405-000,2018,3,3,21,306,316,622,843
3405-000,2018,3,3,22,241,249,490,622
3405-000,2018,3,3,23,156,207,363,490
3405-000,2018,3,3,24,108,138,246,363
3405-000,2018,3,4,1,63,80,143,246
3405-000,2018,3,4,2,37,48,85,143
3405-000,2018,3,4,3,30,19,49,85
3405-000,2018,3,4,4,27,36,63,49
3405-000,2018,3,4,5,50,47,97,63
3405-000,2018,3,4,6,81,54,135,97
3405-000,2018,3,4,7,184,132,316,135
3405-000,2018,3,4,8,317,275,592,316
3405-000,2018,3,4,9,421,324,745,592
3405-000,2018,3,4,10,498,340,838,745
3405-000,2018,3,4,11,563,461,1024,838
3405-000,2018,3,4,12,522,507,1029,1024
3405-000,2018,3,4,13,514,528,1042,1029
3405-000,2018,3,4,14,505,626,1131,1042
3405-000,2018,3,4,15,629,665,1294,1131
3405-000,2018,3,4,16,688,646,1334,1294
3405-000,2018,3,4,17,690,699,1389,1334
3405-000,2018,3,4,18,589,697,1286,1389
3405-000,2018,3,4,19,530,565,1095,1286
3405-000,2018,3,4,20,388,505,893,1095
3405-000,2018,3,4,21,327,373,700,893
3405-000,2018,3,4,22,199,300,499,700
3405-000,2018,3,4,23,205,270,475,499
3405-000,2018,3,4,24,88,134,222,475
3405-000,2018,3,5,1,55,105,160,222
3405-000,2018,3,5,2,49,48,97,160
3405-000,2018,3,5,3,46,45,91,97
3405-000,2018,3,5,4,38,49,87,91
3405-000,2018,3,5,5,101,90,191,87
3405-000,2018,3,5,6,247,183,430,191
3405-000,2018,3,5,7,563,548,1111,430
3405-000,2018,3,5,8,1133,1421,2554,1111
3405-000,2018,3,5,9,1222,1366,2588,2554
3405-000,2018,3,5,10,1000,875,1875,2588
3405-000,2018,3,5,11,1027,945,1972,1875
3405-000,2018,3,5,12,1010,907,1917,1972
3405-000,2018,3,5,13,816,795,1611,1917
3405-000,2018,3,5,14,938,918,1856,1611
3405-000,2018,3,5,15,1076,943,2019,1856
3405-000,2018,3,5,16,1084,954,2038,2019
3405-000,2018,3,5,17,1029,964,1993,2038
3405-000,2018,3,5,18,1135,994,2129,1993
3405-000,2018,3,5,19,962,974,1936,2129
3405-000,2018,3,5,20,649,643,1292,1936
3405-000,2018,3,5,21,583,555,1138,1292
3405-000,2018,3,5,22,365,391,756,1138
3405-000,2018,3,5,23,258,218,476,756
3405-000,2018,3,5,24,126,129,255,476
3405-000,2018,3,6,1,83,93,176,255
3405-000,2018,3,6,2,47,69,116,176
3405-000,2018,3,6,3,67,65,132,116
3405-000,2018,3,6,4,81,62,143,132
3405-000,2018,3,6,5,103,97,200,143
3405-000,2018,3,6,6,224,180,404,200
3405-000,2018,3,6,7,566,475,1041,404
3405-000,2018,3,6,8,1182,1363,2545,1041
3405-000,2018,3,6,9,1320,1343,2663,2545
3405-000,2018,3,6,10,1187,1006,2193,2663
3405-000,2018,3,6,11,1194,975,2169,2193
3405-000,2018,3,6,12,1043,944,1987,2169
3405-000,2018,3,6,13,851,846,1697,1987
3405-000,2018,3,6,14,1079,917,1996,1697
3405-000,2018,3,6,15,1139,1038,2177,1996
3405-000,2018,3,6,16,1169,1023,2192,2177
3405-000,2018,3,6,17,1089,1045,2134,2192
3405-000,2018,3,6,18,1264,1053,2317,2134
3405-000,2018,3,6,19,1166,1037,2203,2317
3405-000,2018,3,6,20,665,676,1341,2203
3405-000,2018,3,6,21,537,574,1111,1341
3405-000,2018,3,6,22,377,375,752,1111
3405-000,2018,3,6,23,267,194,461,752
3405-000,2018,3,6,24,123,149,272,461
3405-000,2018,3,7,1,86,109,195,272
3405-000,2018,3,7,2,71,54,125,195
3405-000,2018,3,7,3,64,68,132,125
3405-000,2018,3,7,4,66,62,128,132
3405-000,2018,3,7,5,91,83,174,128
3405-000,2018,3,7,6,269,167,436,174
3405-000,2018,3,7,7,540,492,1032,436
3405-000,2018,3,7,8,1215,1361,2576,1032
3405-000,2018,3,7,9,1414,1352,2766,2576
3405-000,2018,3,7,10,1201,1047,2248,2766
3405-000,2018,3,7,11,1188,1090,2278,2248
3405-000,2018,3,7,12,1093,937,2030,2278
3405-000,2018,3,7,13,1004,871,1875,2030
3405-000,2018,3,7,14,1089,1008,2097,1875
3405-000,2018,3,7,15,1189,1128,2317,2097
3405-000,2018,3,7,16,1195,1059,2254,2317
3405-000,2018,3,7,17,1169,1020,2189,2254
3405-000,2018,3,7,18,1323,1121,2444,2189
3405-000,2018,3,7,19,1191,963,2154,2444
3405-000,2018,3,7,20,668,636,1304,2154
3405-000,2018,3,7,21,489,458,947,1304
3405-000,2018,3,7,22,336,348,684,947
3405-000,2018,3,7,23,214,184,398,684
3405-000,2018,3,7,24,128,133,261,398
3405-000,2018,3,8,1,94,79,173,261
3405-000,2018,3,8,2,55,50,105,173
3405-000,2018,3,8,3,49,52,101,105
3405-000,2018,3,8,4,72,52,124,101
3405-000,2018,3,8,5,90,87,177,124
3405-000,2018,3,8,6,214,148,362,177
3405-000,2018,3,8,7,449,393,842,362
3405-000,2018,3,8,8,1034,1180,2214,842
3405-000,2018,3,8,9,1234,1267,2501,2214
3405-000,2018,3,8,10,991,913,1904,2501
3405-000,2018,3,8,11,1026,966,1992,1904
3405-000,2018,3,8,12,971,870,1841,1992
3405-000,2018,3,8,13,843,780,1623,1841
3405-000,2018,3,8,14,989,904,1893,1623
3405-000,2018,3,8,15,1043,926,1969,1893
3405-000,2018,3,8,16,1100,919,2019,1969
3405-000,2018,3,8,17,929,965,1894,2019
3405-000,2018,3,8,18,1062,970,2032,1894
3405-000,2018,3,8,19,963,934,1897,2032
3405-000,2018,3,8,20,655,574,1229,1897
3405-000,2018,3,8,21,526,534,1060,1229
3405-000,2018,3,8,22,314,358,672,1060
3405-000,2018,3,8,23,246,214,460,672
3405-000,2018,3,8,24,129,136,265,460
3405-000,2018,3,9,1,71,103,174,265
3405-000,2018,3,9,2,41,76,117,174
3405-000,2018,3,9,3,48,57,105,117
3405-000,2018,3,9,4,58,64,122,105
3405-000,2018,3,9,5,109,93,202,122
3405-000,2018,3,9,6,250,159,409,202
3405-000,2018,3,9,7,564,480,1044,409
3405-000,2018,3,9,8,1182,1306,2488,1044
3405-000,2018,3,9,9,1335,1323,2658,2488
3405-000,2018,3,9,10,1117,1060,2177,2658
3405-000,2018,3,9,11,1166,1001,2167,2177
3405-000,2018,3,9,12,1124,939,2063,2167
3405-000,2018,3,9,13,993,859,1852,2063
3405-000,2018,3,9,14,1049,936,1985,1852
3405-000,2018,3,9,15,1208,1055,2263,1985
3405-000,2018,3,9,16,1160,1064,2224,2263
3405-000,2018,3,9,17,1066,998,2064,2224
3405-000,2018,3,9,18,1434,1198,2632,2064
3405-000,2018,3,9,19,1530,1162,2692,2632
3405-000,2018,3,9,20,903,704,1607,2692
3405-000,2018,3,9,21,548,546,1094,1607
3405-000,2018,3,9,22,387,356,743,1094
3405-000,2018,3,9,23,246,216,462,743
3405-000,2018,3,9,24,144,138,282,462
3405-000,2018,3,10,1,126,94,220,282
3405-000,2018,3,10,2,63,68,131,220
3405-000,2018,3,10,3,59,58,117,131
3405-000,2018,3,10,4,52,50,102,117
3405-000,2018,3,10,5,108,71,179,102
3405-000,2018,3,10,6,231,132,363,179
3405-000,2018,3,10,7,431,274,705,363
3405-000,2018,3,10,8,702,560,1262,705
3405-000,2018,3,10,9,883,746,1629,1262
3405-000,2018,3,10,10,817,709,1526,1629
3405-000,2018,3,10,11,918,703,1621,1526
3405-000,2018,3,10,12,915,729,1644,1621
3405-000,2018,3,10,13,756,706,1462,1644
3405-000,2018,3,10,14,772,704,1476,1462
3405-000,2018,3,10,15,851,696,1547,1476
3405-000,2018,3,10,16,837,797,1634,1547
3405-000,2018,3,10,17,811,754,1565,1634
3405-000,2018,3,10,18,941,874,1815,1565
3405-000,2018,3,10,19,735,685,1420,1815
3405-000,2018,3,10,20,449,489,938,1420
3405-000,2018,3,10,21,295,323,618,938
3405-000,2018,3,10,22,283,268,551,618
3405-000,2018,3,10,23,176,182,358,551
3405-000,2018,3,10,24,124,132,256,358
3405-000,2018,3,11,1,71,106,177,256
3405-000,2018,3,11,2,55,37,92,177
3405-000,2018,3,11,3,41,34,75,92
3405-000,2018,3,11,4,31,33,64,75
3405-000,2018,3,11,5,51,43,94,64
3405-000,2018,3,11,6,98,60,158,94
3405-000,2018,3,11,7,184,142,326,158
3405-000,2018,3,11,8,314,245,559,326
3405-000,2018,3,11,9,379,303,682,559
3405-000,2018,3,11,10,454,332,786,682
3405-000,2018,3,11,11,523,422,945,786
3405-000,2018,3,11,12,517,518,1035,945
3405-000,2018,3,11,13,464,477,941,1035
3405-000,2018,3,11,14,484,527,1011,941
3405-000,2018,3,11,15,612,588,1200,1011
3405-000,2018,3,11,16,583,619,1202,1200
3405-000,2018,3,11,17,594,682,1276,1202
3405-000,2018,3,11,18,662,738,1400,1276
3405-000,2018,3,11,19,514,672,1186,1400
3405-000,2018,3,11,20,375,516,891,1186
3405-000,2018,3,11,21,314,407,721,891
3405-000,2018,3,11,22,221,355,576,721
3405-000,2018,3,11,23,178,301,479,576
3405-000,2018,3,11,24,98,162,260,479
3405-000,2018,3,12,1,57,114,171,260
3405-000,2018,3,12,2,38,60,98,171
3405-000,2018,3,12,3,34,45,79,98
3405-000,2018,3,12,4,61,66,127,79
3405-000,2018,3,12,5,102,98,200,127
3405-000,2018,3,12,6,261,200,461,200
3405-000,2018,3,12,7,655,597,1252,461
3405-000,2018,3,12,8,1249,1533,2782,1252
3405-000,2018,3,12,9,1350,1441,2791,2782
3405-000,2018,3,12,10,1087,969,2056,2791
3405-000,2018,3,12,11,1218,982,2200,2056
3405-000,2018,3,12,12,1068,930,1998,2200
3405-000,2018,3,12,13,879,845,1724,1998
3405-000,2018,3,12,14,958,1055,2013,1724
3405-000,2018,3,12,15,1148,1071,2219,2013
3405-000,2018,3,12,16,1153,1018,2171,2219
3405-000,2018,3,12,17,1083,957,2040,2171
3405-000,2018,3,12,18,1264,1101,2365,2040
3405-000,2018,3,12,19,1127,1015,2142,2365
3405-000,2018,3,12,20,680,671,1351,2142
3405-000,2018,3,12,21,573,586,1159,1351
3405-000,2018,3,12,22,342,378,720,1159
3405-000,2018,3,12,23,229,219,448,720
3405-000,2018,3,12,24,112,118,230,448
3405-000,2018,3,13,1,87,90,177,230
3405-000,2018,3,13,2,67,63,130,177
3405-000,2018,3,13,3,53,71,124,130
3405-000,2018,3,13,4,58,71,129,124
3405-000,2018,3,13,5,141,102,243,129
3405-000,2018,3,13,6,270,197,467,243
3405-000,2018,3,13,7,631,502,1133,467
3405-000,2018,3,13,8,1244,1401,2645,1133
3405-000,2018,3,13,9,1344,1355,2699,2645
3405-000,2018,3,13,10,1239,1011,2250,2699
3405-000,2018,3,13,11,1198,1068,2266,2250
3405-000,2018,3,13,12,1066,961,2027,2266
3405-000,2018,3,13,13,942,838,1780,2027
3405-000,2018,3,13,14,1092,1045,2137,1780
3405-000,2018,3,13,15,1196,1057,2253,2137
3405-000,2018,3,13,16,1225,1063,2288,2253
3405-000,2018,3,13,17,1151,1056,2207,2288
3405-000,2018,3,13,18,1244,1152,2396,2207
3405-000,2018,3,13,19,1183,1010,2193,2396
3405-000,2018,3,13,20,665,638,1303,2193
3405-000,2018,3,13,21,484,577,1061,1303
3405-000,2018,3,13,22,344,382,726,1061
3405-000,2018,3,13,23,214,222,436,726
3405-000,2018,3,13,24,134,112,246,436
3405-000,2018,3,14,1,104,94,198,246
3405-000,2018,3,14,2,66,71,137,198
3405-000,2018,3,14,3,57,59,116,137
3405-000,2018,3,14,4,82,33,115,116
3405-000,2018,3,14,5,141,107,248,115
3405-000,2018,3,14,6,290,181,471,248
3405-000,2018,3,14,7,605,471,1076,471
3405-000,2018,3,14,8,1272,1381,2653,1076
3405-000,2018,3,14,9,1412,1378,2790,2653
3405-000,2018,3,14,10,1271,1063,2334,2790
3405-000,2018,3,14,11,1165,1102,2267,2334
3405-000,2018,3,14,12,1159,963,2122,2267
3405-000,2018,3,14,13,942,841,1783,2122
3405-000,2018,3,14,14,1048,997,2045,1783
3405-000,2018,3,14,15,1090,1116,2206,2045
3405-000,2018,3,14,16,1100,1037,2137,2206
3405-000,2018,3,14,17,1123,1012,2135,2137
3405-000,2018,3,14,18,1371,1169,2540,2135
3405-000,2018,3,14,19,1367,1103,2470,2540
3405-000,2018,3,14,20,770,679,1449,2470
3405-000,2018,3,14,21,499,494,993,1449
3405-000,2018,3,14,22,330,349,679,993
3405-000,2018,3,14,23,248,264,512,679
3405-000,2018,3,14,24,163,151,314,512
3405-000,2018,3,15,1,90,105,195,314
3405-000,2018,3,15,2,72,66,138,195
3405-000,2018,3,15,3,56,67,123,138
3405-000,2018,3,15,4,63,52,115,123
3405-000,2018,3,15,5,97,85,182,115
3405-000,2018,3,15,6,220,163,383,182
3405-000,2018,3,15,7,556,404,960,383
3405-000,2018,3,15,8,1122,1235,2357,960
3405-000,2018,3,15,9,1285,1331,2616,2357
3405-000,2018,3,15,10,1067,908,1975,2616
3405-000,2018,3,15,11,1017,967,1984,1975
3405-000,2018,3,15,12,975,875,1850,1984
3405-000,2018,3,15,13,834,776,1610,1850
3405-000,2018,3,15,14,954,902,1856,1610
3405-000,2018,3,15,15,1072,940,2012,1856
3405-000,2018,3,15,16,1123,923,2046,2012
3405-000,2018,3,15,17,1052,913,1965,2046
3405-000,2018,3,15,18,1086,1009,2095,1965
3405-000,2018,3,15,19,1023,955,1978,2095
3405-000,2018,3,15,20,635,516,1151,1978
3405-000,2018,3,15,21,478,505,983,1151
3405-000,2018,3,15,22,325,347,672,983
3405-000,2018,3,15,23,223,246,469,672
3405-000,2018,3,15,24,155,130,285,469
3405-000,2018,3,16,1,73,106,179,285
3405-000,2018,3,16,2,68,64,132,179
3405-000,2018,3,16,3,60,44,104,132
3405-000,2018,3,16,4,72,64,136,104
3405-000,2018,3,16,5,145,97,242,136
3405-000,2018,3,16,6,273,161,434,242
3405-000,2018,3,16,7,570,467,1037,434
3405-000,2018,3,16,8,1158,1286,2444,1037
3405-000,2018,3,16,9,1314,1329,2643,2444
3405-000,2018,3,16,10,1163,959,2122,2643
3405-000,2018,3,16,11,1112,1057,2169,2122
3405-000,2018,3,16,12,1115,968,2083,2169
3405-000,2018,3,16,13,921,880,1801,2083
3405-000,2018,3,16,14,1057,900,1957,1801
3405-000,2018,3,16,15,1192,1115,2307,1957
3405-000,2018,3,16,16,1228,1031,2259,2307
3405-000,2018,3,16,17,1181,1046,2227,2259
3405-000,2018,3,16,18,1389,1192,2581,2227
3405-000,2018,3,16,19,1595,1160,2755,2581
3405-000,2018,3,16,20,857,768,1625,2755
3405-000,2018,3,16,21,586,645,1231,1625
3405-000,2018,3,16,22,422,398,820,1231
3405-000,2018,3,16,23,286,230,516,820
3405-000,2018,3,16,24,156,164,320,516
3405-000,2018,3,17,1,109,120,229,320
3405-000,2018,3,17,2,63,85,148,229
3405-000,2018,3,17,3,66,48,114,148
3405-000,2018,3,17,4,59,72,131,114
3405-000,2018,3,17,5,95,77,172,131
3405-000,2018,3,17,6,229,141,370,172
3405-000,2018,3,17,7,481,326,807,370
3405-000,2018,3,17,8,771,654,1425,807
3405-000,2018,3,17,9,933,801,1734,1425
3405-000,2018,3,17,10,915,845,1760,1734
3405-000,2018,3,17,11,999,744,1743,1760
3405-000,2018,3,17,12,965,833,1798,1743
3405-000,2018,3,17,13,919,757,1676,1798
3405-000,2018,3,17,14,811,747,1558,1676
3405-000,2018,3,17,15,836,737,1573,1558
3405-000,2018,3,17,16,808,757,1565,1573
3405-000,2018,3,17,17,819,803,1622,1565
3405-000,2018,3,17,18,1050,957,2007,1622
3405-000,2018,3,17,19,775,661,1436,2007
3405-000,2018,3,17,20,503,476,979,1436
3405-000,2018,3,17,21,314,361,675,979
3405-000,2018,3,17,22,207,289,496,675
3405-000,2018,3,17,23,198,229,427,496
3405-000,2018,3,17,24,106,147,253,427
3405-000,2018,3,18,1,85,72,157,253
3405-000,2018,3,18,2,41,47,88,157
3405-000,2018,3,18,3,35,48,83,88
3405-000,2018,3,18,4,46,33,79,83
3405-000,2018,3,18,5,50,46,96,79
3405-000,2018,3,18,6,114,70,184,96
3405-000,2018,3,18,7,220,166,386,184
3405-000,2018,3,18,8,321,276,597,386
3405-000,2018,3,18,9,443,319,762,597
3405-000,2018,3,18,10,518,419,937,762
3405-000,2018,3,18,11,572,455,1027,937
3405-000,2018,3,18,12,556,530,1086,1027
3405-000,2018,3,18,13,569,514,1083,1086
3405-000,2018,3,18,14,550,563,1113,1083
3405-000,2018,3,18,15,580,654,1234,1113
3405-000,2018,3,18,16,627,627,1254,1234
3405-000,2018,3,18,17,649,647,1296,1254
3405-000,2018,3,18,18,618,721,1339,1296
3405-000,2018,3,18,19,503,614,1117,1339
3405-000,2018,3,18,20,393,477,870,1117
3405-000,2018,3,18,21,300,432,732,870
3405-000,2018,3,18,22,263,332,595,732
3405-000,2018,3,18,23,155,280,435,595
3405-000,2018,3,18,24,102,165,267,435
3405-000,2018,3,19,1,57,120,177,267
3405-000,2018,3,19,2,38,67,105,177
3405-000,2018,3,19,3,50,59,109,105
3405-000,2018,3,19,4,56,52,108,109
3405-000,2018,3,19,5,114,98,212,108
3405-000,2018,3,19,6,257,213,470,212
3405-000,2018,3,19,7,611,539,1150,470
3405-000,2018,3,19,8,1126,1466,2592,1150
3405-000,2018,3,19,9,1271,1410,2681,2592
3405-000,2018,3,19,10,1054,952,2006,2681
3405-000,2018,3,19,11,1058,877,1935,2006
3405-000,2018,3,19,12,949,925,1874,1935
3405-000,2018,3,19,13,898,840,1738,1874
3405-000,2018,3,19,14,948,914,1862,1738
3405-000,2018,3,19,15,1061,1047,2108,1862
3405-000,2018,3,19,16,1030,982,2012,2108
3405-000,2018,3,19,17,998,894,1892,2012
3405-000,2018,3,19,18,1158,950,2108,1892
3405-000,2018,3,19,19,1078,970,2048,2108
3405-000,2018,3,19,20,648,586,1234,2048
3405-000,2018,3,19,21,517,558,1075,1234
3405-000,2018,3,19,22,345,355,700,1075
3405-000,2018,3,19,23,237,216,453,700
3405-000,2018,3,19,24,108,126,234,453
3405-000,2018,3,20,1,73,94,167,234
3405-000,2018,3,20,2,39,79,118,167
3405-000,2018,3,20,3,43,55,98,118
3405-000,2018,3,20,4,71,71,142,98
3405-000,2018,3,20,5,127,99,226,142
3405-000,2018,3,20,6,286,182,468,226
3405-000,2018,3,20,7,610,491,1101,468
3405-000,2018,3,20,8,1231,1305,2536,1101
3405-000,2018,3,20,9,1324,1337,2661,2536
3405-000,2018,3,20,10,1170,953,2123,2661
3405-000,2018,3,20,11,1204,1033,2237,2123
3405-000,2018,3,20,12,1033,946,1979,2237
3405-000,2018,3,20,13,950,870,1820,1979
3405-000,2018,3,20,14,1024,952,1976,1820
3405-000,2018,3,20,15,1236,1074,2310,1976
3405-000,2018,3,20,16,1193,1052,2245,2310
3405-000,2018,3,20,17,1098,992,2090,2245
3405-000,2018,3,20,18,1221,1067,2288,2090
3405-000,2018,3,20,19,1118,994,2112,2288
3405-000,2018,3,20,20,613,628,1241,2112
3405-000,2018,3,20,21,526,548,1074,1241
3405-000,2018,3,20,22,355,381,736,1074
3405-000,2018,3,20,23,218,201,419,736
3405-000,2018,3,20,24,133,144,277,419
3405-000,2018,3,21,1,90,103,193,277
3405-000,2018,3,21,2,59,60,119,193
3405-000,2018,3,21,3,53,56,109,119
3405-000,2018,3,21,4,64,64,128,109
3405-000,2018,3,21,5,122,88,210,128
3405-000,2018,3,21,6,275,167,442,210
3405-000,2018,3,21,7,539,461,1000,442
3405-000,2018,3,21,8,1159,1277,2436,1000
3405-000,2018,3,21,9,1406,1282,2688,2436
3405-000,2018,3,21,10,1080,958,2038,2688
3405-000,2018,3,21,11,1034,985,2019,2038
3405-000,2018,3,21,12,1049,920,1969,2019
3405-000,2018,3,21,13,849,762,1611,1969
3405-000,2018,3,21,14,1002,911,1913,1611
3405-000,2018,3,21,15,1079,961,2040,1913
3405-000,2018,3,21,16,1081,975,2056,2040
3405-000,2018,3,21,17,1003,895,1898,2056
3405-000,2018,3,21,18,1113,1030,2143,1898
3405-000,2018,3,21,19,1209,964,2173,2143
3405-000,2018,3,21,20,593,592,1185,2173
3405-000,2018,3,21,21,456,440,896,1185
3405-000,2018,3,21,22,314,310,624,896
3405-000,2018,3,21,23,164,203,367,624
3405-000,2018,3,21,24,128,125,253,367
3405-000,2018,3,22,1,69,95,164,253
3405-000,2018,3,22,2,55,70,125,164
3405-000,2018,3,22,3,37,42,79,125
3405-000,2018,3,22,4,58,65,123,79
3405-000,2018,3,22,5,109,100,209,123
3405-000,2018,3,22,6,265,177,442,209
3405-000,2018,3,22,7,566,458,1024,442
3405-000,2018,3,22,8,1151,1320,2471,1024
3405-000,2018,3,22,9,1369,1365,2734,2471
3405-000,2018,3,22,10,1140,996,2136,2734
3405-000,2018,3,22,11,1175,1054,2229,2136
3405-000,2018,3,22,12,1131,970,2101,2229
3405-000,2018,3,22,13,954,813,1767,2101
3405-000,2018,3,22,14,1047,957,2004,1767
3405-000,2018,3,22,15,1146,1014,2160,2004
3405-000,2018,3,22,16,1244,1016,2260,2160
3405-000,2018,3,22,17,1134,1015,2149,2260
3405-000,2018,3,22,18,1300,1052,2352,2149
3405-000,2018,3,22,19,1188,1050,2238,2352
3405-000,2018,3,22,20,659,666,1325,2238
3405-000,2018,3,22,21,577,566,1143,1325
3405-000,2018,3,22,22,369,378,747,1143
3405-000,2018,3,22,23,247,218,465,747
3405-000,2018,3,22,24,139,155,294,465
3405-000,2018,3,23,1,79,105,184,294
3405-000,2018,3,23,2,62,63,125,184
3405-000,2018,3,23,3,51,53,104,125
3405-000,2018,3,23,4,73,74,147,104
3405-000,2018,3,23,5,116,86,202,147
3405-000,2018,3,23,6,272,161,433,202
3405-000,2018,3,23,7,581,458,1039,433
3405-000,2018,3,23,8,1217,1375,2592,1039
3405-000,2018,3,23,9,1365,1396,2761,2592
3405-000,2018,3,23,10,1152,1061,2213,2761
3405-000,2018,3,23,11,1207,1063,2270,2213
3405-000,2018,3,23,12,1181,977,2158,2270
3405-000,2018,3,23,13,974,886,1860,2158
3405-000,2018,3,23,14,1054,993,2047,1860
3405-000,2018,3,23,15,1191,1073,2264,2047
3405-000,2018,3,23,16,1198,1035,2233,2264
3405-000,2018,3,23,17,1156,1064,2220,2233
3405-000,2018,3,23,18,1581,1180,2761,2220
3405-000,2018,3,23,19,1634,1219,2853,2761
3405-000,2018,3,23,20,902,794,1696,2853
3405-000,2018,3,23,21,610,524,1134,1696
3405-000,2018,3,23,22,429,359,788,1134
3405-000,2018,3,23,23,268,211,479,788
3405-000,2018,3,23,24,149,159,308,479
3405-000,2018,3,24,1,101,123,224,308
3405-000,2018,3,24,2,77,69,146,224
3405-000,2018,3,24,3,57,49,106,146
3405-000,2018,3,24,4,61,64,125,106
3405-000,2018,3,24,5,109,84,193,125
3405-000,2018,3,24,6,217,135,352,193
3405-000,2018,3,24,7,494,334,828,352
3405-000,2018,3,24,8,773,659,1432,828
3405-000,2018,3,24,9,855,743,1598,1432
3405-000,2018,3,24,10,882,738,1620,1598
3405-000,2018,3,24,11,889,755,1644,1620
3405-000,2018,3,24,12,887,848,1735,1644
3405-000,2018,3,24,13,816,618,1434,1735
3405-000,2018,3,24,14,776,738,1514,1434
3405-000,2018,3,24,15,819,700,1519,1514
3405-000,2018,3,24,16,848,699,1547,1519
3405-000,2018,3,24,17,868,672,1540,1547
3405-000,2018,3,24,18,953,875,1828,1540
3405-000,2018,3,24,19,685,669,1354,1828
3405-000,2018,3,24,20,449,476,925,1354
3405-000,2018,3,24,21,320,324,644,925
3405-000,2018,3,24,22,247,251,498,644
3405-000,2018,3,24,23,197,204,401,498
3405-000,2018,3,24,24,133,123,256,401
3405-000,2018,3,25,1,67,66,133,256
3405-000,2018,3,25,2,52,33,85,133
3405-000,2018,3,25,3,46,41,87,85
3405-000,2018,3,25,4,31,25,56,87
3405-000,2018,3,25,5,58,36,94,56
3405-000,2018,3,25,6,137,69,206,94
3405-000,2018,3,25,7,249,124,373,206
3405-000,2018,3,25,8,339,282,621,373
3405-000,2018,3,25,9,375,328,703,621
3405-000,2018,3,25,10,481,358,839,703
3405-000,2018,3,25,11,602,457,1059,839
3405-000,2018,3,25,12,607,523,1130,1059
3405-000,2018,3,25,13,506,501,1007,1130
3405-000,2018,3,25,14,525,626,1151,1007
3405-000,2018,3,25,15,645,687,1332,1151
3405-000,2018,3,25,16,639,624,1263,1332
3405-000,2018,3,25,17,605,606,1211,1263
3405-000,2018,3,25,18,701,666,1367,1211
3405-000,2018,3,25,19,540,605,1145,1367
3405-000,2018,3,25,20,419,482,901,1145
3405-000,2018,3,25,21,325,462,787,901
3405-000,2018,3,25,22,278,350,628,787
3405-000,2018,3,25,23,183,265,448,628
3405-000,2018,3,25,24,111,148,259,448
3405-000,2018,3,26,1,57,112,169,259
3405-000,2018,3,26,2,58,58,116,169
3405-000,2018,3,26,3,34,41,75,116
3405-000,2018,3,26,4,58,60,118,75
3405-000,2018,3,26,5,128,97,225,118
3405-000,2018,3,26,6,306,195,501,225
3405-000,2018,3,26,7,674,666,1340,501
3405-000,2018,3,26,8,1203,1548,2751,1340
3405-000,2018,3,26,9,1284,1479,2763,2751
3405-000,2018,3,26,10,1132,977,2109,2763
3405-000,2018,3,26,11,1110,982,2092,2109
3405-000,2018,3,26,12,1188,963,2151,2092
3405-000,2018,3,26,13,947,858,1805,2151
3405-000,2018,3,26,14,1014,1014,2028,1805
3405-000,2018,3,26,15,1204,1025,2229,2028
3405-000,2018,3,26,16,1136,1022,2158,2229
3405-000,2018,3,26,17,1126,974,2100,2158
3405-000,2018,3,26,18,1284,1081,2365,2100
3405-000,2018,3,26,19,1218,1098,2316,2365
3405-000,2018,3,26,20,657,695,1352,2316
3405-000,2018,3,26,21,533,584,1117,1352
3405-000,2018,3,26,22,392,380,772,1117
3405-000,2018,3,26,23,224,225,449,772
3405-000,2018,3,26,24,140,131,271,449
3405-000,2018,3,27,1,67,86,153,271
3405-000,2018,3,27,2,61,74,135,153
3405-000,2018,3,27,3,49,54,103,135
3405-000,2018,3,27,4,60,75,135,103
3405-000,2018,3,27,5,119,106,225,135
3405-000,2018,3,27,6,282,183,465,225
3405-000,2018,3,27,7,671,539,1210,465
3405-000,2018,3,27,8,1246,1384,2630,1210
3405-000,2018,3,27,9,1365,1349,2714,2630
3405-000,2018,3,27,10,1198,1064,2262,2714
3405-000,2018,3,27,11,1143,1059,2202,2262
3405-000,2018,3,27,12,1111,945,2056,2202
3405-000,2018,3,27,13,1001,817,1818,2056
3405-000,2018,3,27,14,1064,1010,2074,1818
3405-000,2018,3,27,15,1215,1022,2237,2074
3405-000,2018,3,27,16,1208,1026,2234,2237
3405-000,2018,3,27,17,1153,1001,2154,2234
3405-000,2018,3,27,18,1306,1034,2340,2154
3405-000,2018,3,27,19,1126,991,2117,2340
3405-000,2018,3,27,20,669,665,1334,2117
3405-000,2018,3,27,21,537,558,1095,1334
3405-000,2018,3,27,22,378,379,757,1095
3405-000,2018,3,27,23,260,241,501,757
3405-000,2018,3,27,24,136,138,274,501
3405-000,2018,3,28,1,106,110,216,274
3405-000,2018,3,28,2,59,59,118,216
3405-000,2018,3,28,3,56,53,109,118
3405-000,2018,3,28,4,59,66,125,109
3405-000,2018,3,28,5,138,101,239,125
3405-000,2018,3,28,6,275,189,464,239
3405-000,2018,3,28,7,602,502,1104,464
3405-000,2018,3,28,8,1211,1375,2586,1104
3405-000,2018,3,28,9,1366,1351,2717,2586
3405-000,2018,3,28,10,1116,969,2085,2717
3405-000,2018,3,28,11,1218,1054,2272,2085
3405-000,2018,3,28,12,1123,954,2077,2272
3405-000,2018,3,28,13,902,791,1693,2077
3405-000,2018,3,28,14,1034,976,2010,1693
3405-000,2018,3,28,15,1186,1053,2239,2010
3405-000,2018,3,28,16,1215,1026,2241,2239
3405-000,2018,3,28,17,1146,1017,2163,2241
3405-000,2018,3,28,18,1393,1128,2521,2163
3405-000,2018,3,28,19,1290,1067,2357,2521
3405-000,2018,3,28,20,665,695,1360,2357
3405-000,2018,3,28,21,497,491,988,1360
3405-000,2018,3,28,22,365,362,727,988
3405-000,2018,3,28,23,234,203,437,727
3405-000,2018,3,28,24,131,164,295,437
3405-000,2018,3,29,1,89,97,186,295
3405-000,2018,3,29,2,50,66,116,186
3405-000,2018,3,29,3,63,48,111,116
3405-000,2018,3,29,4,72,66,138,111
3405-000,2018,3,29,5,144,94,238,138
3405-000,2018,3,29,6,289,166,455,238
3405-000,2018,3,29,7,643,432,1075,455
3405-000,2018,3,29,8,1225,1423,2648,1075
3405-000,2018,3,29,9,1393,1358,2751,2648
3405-000,2018,3,29,10,1185,994,2179,2751
3405-000,2018,3,29,11,1203,999,2202,2179
3405-000,2018,3,29,12,1070,986,2056,2202
3405-000,2018,3,29,13,952,800,1752,2056
3405-000,2018,3,29,14,1109,969,2078,1752
3405-000,2018,3,29,15,1217,1021,2238,2078
3405-000,2018,3,29,16,1182,1025,2207,2238
3405-000,2018,3,29,17,1110,1028,2138,2207
3405-000,2018,3,29,18,1222,1100,2322,2138
3405-000,2018,3,29,19,1172,1020,2192,2322
3405-000,2018,3,29,20,722,667,1389,2192
3405-000,2018,3,29,21,549,554,1103,1389
3405-000,2018,3,29,22,363,400,763,1103
3405-000,2018,3,29,23,267,234,501,763
3405-000,2018,3,29,24,136,146,282,501
3405-000,2018,3,30,1,108,117,225,282
3405-000,2018,3,30,2,68,86,154,225
3405-000,2018,3,30,3,59,46,105,154
3405-000,2018,3,30,4,66,65,131,105
3405-000,2018,3,30,5,134,109,243,131
3405-000,2018,3,30,6,259,172,431,243
3405-000,2018,3,30,7,689,486,1175,431
3405-000,2018,3,30,8,1194,1329,2523,1175
3405-000,2018,3,30,9,1416,1362,2778,2523
3405-000,2018,3,30,10,1225,1004,2229,2778
3405-000,2018,3,30,11,1192,1031,2223,2229
3405-000,2018,3,30,12,1262,928,2190,2223
3405-000,2018,3,30,13,961,906,1867,2190
3405-000,2018,3,30,14,1151,972,2123,1867
3405-000,2018,3,30,15,1194,1082,2276,2123
3405-000,2018,3,30,16,1198,1126,2324,2276
3405-000,2018,3,30,17,1253,1063,2316,2324
3405-000,2018,3,30,18,1698,1256,2954,2316
3405-000,2018,3,30,19,1585,1291,2876,2954
3405-000,2018,3,30,20,889,806,1695,2876
3405-000,2018,3,30,21,636,596,1232,1695
3405-000,2018,3,30,22,425,426,851,1232
3405-000,2018,3,30,23,276,220,496,851
3405-000,2018,3,30,24,145,162,307,496
3405-000,2018,3,31,1,115,122,237,307
3405-000,2018,3,31,2,75,77,152,237
3405-000,2018,3,31,3,76,65,141,152
3405-000,2018,3,31,4,61,66,127,141
3405-000,2018,3,31,5,106,87,193,127
3405-000,2018,3,31,6,249,148,397,193
3405-000,2018,3,31,7,502,362,864,397
3405-000,2018,3,31,8,820,602,1422,864
3405-000,2018,3,31,9,916,802,1718,1422
3405-000,2018,3,31,10,973,776,1749,1718
3405-000,2018,3,31,11,1034,839,1873,1749
3405-000,2018,3,31,12,1002,809,1811,1873
3405-000,2018,3,31,13,852,693,1545,1811
3405-000,2018,3,31,14,797,744,1541,1545
3405-000,2018,3,31,15,810,797,1607,1541
3405-000,2018,3,31,16,856,766,1622,1607
3405-000,2018,3,31,17,895,779,1674,1622
3405-000,2018,3,31,18,989,899,1888,1674
3405-000,2018,3,31,19,790,738,1528,1888
3405-000,2018,3,31,20,500,526,1026,1528
3405-000,2018,3,31,21,342,401,743,1026
3405-000,2018,3,31,22,246,327,573,743
3405-000,2018,3,31,23,196,232,428,573
3405-000,2018,3,31,24,108,51,159,428
3405-000,2018,4,1,1,86,69,155,159
3405-000,2018,4,1,2,55,40,95,155
3405-000,2018,4,1,3,49,44,93,95
3405-000,2018,4,1,4,48,31,79,93
3405-000,2018,4,1,5,63,41,104,79
3405-000,2018,4,1,6,119,70,189,104
3405-000,2018,4,1,7,239,158,397,189
3405-000,2018,4,1,8,321,267,588,397
3405-000,2018,4,1,9,422,347,769,588
3405-000,2018,4,1,10,524,411,935,769
3405-000,2018,4,1,11,581,499,1080,935
3405-000,2018,4,1,12,537,560,1097,1080
3405-000,2018,4,1,13,535,501,1036,1097
3405-000,2018,4,1,14,620,619,1239,1036
3405-000,2018,4,1,15,645,610,1255,1239
3405-000,2018,4,1,16,695,575,1270,1255
3405-000,2018,4,1,17,739,670,1409,1270
3405-000,2018,4,1,18,655,694,1349,1409
3405-000,2018,4,1,19,574,614,1188,1349
3405-000,2018,4,1,20,422,480,902,1188
3405-000,2018,4,1,21,378,381,759,902
3405-000,2018,4,1,22,241,346,587,759
3405-000,2018,4,1,23,195,300,495,587
3405-000,2018,4,1,24,98,173,271,495
3405-000,2018,4,2,1,68,116,184,271
3405-000,2018,4,2,2,34,24,58,184
3405-000,2018,4,2,3,41,46,87,58
3405-000,2018,4,2,4,50,62,112,87
3405-000,2018,4,2,5,125,97,222,112
3405-000,2018,4,2,6,322,199,521,222
3405-000,2018,4,2,7,700,677,1377,521
3405-000,2018,4,2,8,1250,1566,2816,1377
3405-000,2018,4,2,9,1377,1421,2798,2816
3405-000,2018,4,2,10,1111,739,1850,2798
3405-000,2018,4,2,11,1153,885,2038,1850
3405-000,2018,4,2,12,1143,1076,2219,2038
3405-000,2018,4,2,13,960,854,1814,2219
3405-000,2018,4,2,14,1043,962,2005,1814
3405-000,2018,4,2,15,1180,1036,2216,2005
3405-000,2018,4,2,16,1163,1029,2192,2216
3405-000,2018,4,2,17,1086,981,2067,2192
3405-000,2018,4,2,18,1327,1029,2356,2067
3405-000,2018,4,2,19,1200,1007,2207,2356
3405-000,2018,4,2,20,736,736,1472,2207
3405-000,2018,4,2,21,528,581,1109,1472
3405-000,2018,4,2,22,392,403,795,1109
3405-000,2018,4,2,23,232,222,454,795
3405-000,2018,4,2,24,158,157,315,454
3405-000,2018,4,3,1,92,93,185,315
3405-000,2018,4,3,2,65,63,128,185
3405-000,2018,4,3,3,56,53,109,128
3405-000,2018,4,3,4,60,82,142,109
3405-000,2018,4,3,5,124,102,226,142
3405-000,2018,4,3,6,286,197,483,226
3405-000,2018,4,3,7,619,548,1167,483
3405-000,2018,4,3,8,1213,1365,2578,1167
3405-000,2018,4,3,9,1446,1412,2858,2578
3405-000,2018,4,3,10,1306,975,2281,2858
3405-000,2018,4,3,11,1247,1073,2320,2281
3405-000,2018,4,3,12,1092,1045,2137,2320
3405-000,2018,4,3,13,870,843,1713,2137
3405-000,2018,4,3,14,1105,996,2101,1713
3405-000,2018,4,3,15,1250,1333,2583,2101
3405-000,2018,4,3,16,1190,1050,2240,2583
3405-000,2018,4,3,17,1138,992,2130,2240
3405-000,2018,4,3,18,1385,1130,2515,2130
3405-000,2018,4,3,19,1170,1055,2225,2515
3405-000,2018,4,3,20,765,742,1507,2225
3405-000,2018,4,3,21,554,589,1143,1507
3405-000,2018,4,3,22,382,384,766,1143
3405-000,2018,4,3,23,219,242,461,766
3405-000,2018,4,3,24,143,138,281,461
3405-000,2018,4,4,1,81,102,183,281
3405-000,2018,4,4,2,55,82,137,183
3405-000,2018,4,4,3,46,56,102,137
3405-000,2018,4,4,4,61,68,129,102
3405-000,2018,4,4,5,119,97,216,129
3405-000,2018,4,4,6,220,167,387,216
3405-000,2018,4,4,7,533,396,929,387
3405-000,2018,4,4,8,1178,1276,2454,929
3405-000,2018,4,4,9,1351,1323,2674,2454
3405-000,2018,4,4,10,1111,980,2091,2674
3405-000,2018,4,4,11,1105,966,2071,2091
3405-000,2018,4,4,12,1060,924,1984,2071
3405-000,2018,4,4,13,878,782,1660,1984
3405-000,2018,4,4,14,1001,987,1988,1660
3405-000,2018,4,4,15,1120,1024,2144,1988
3405-000,2018,4,4,16,1220,1020,2240,2144
3405-000,2018,4,4,17,1047,998,2045,2240
3405-000,2018,4,4,18,1269,1108,2377,2045
3405-000,2018,4,4,19,1193,1035,2228,2377
3405-000,2018,4,4,20,654,627,1281,2228
3405-000,2018,4,4,21,542,486,1028,1281
3405-000,2018,4,4,22,395,312,707,1028
3405-000,2018,4,4,23,190,220,410,707
3405-000,2018,4,4,24,133,138,271,410
3405-000,2018,4,5,1,106,97,203,271
3405-000,2018,4,5,2,59,62,121,203
3405-000,2018,4,5,3,65,55,120,121
3405-000,2018,4,5,4,68,66,134,120
3405-000,2018,4,5,5,79,87,166,134
3405-000,2018,4,5,6,233,154,387,166
3405-000,2018,4,5,7,543,406,949,387
3405-000,2018,4,5,8,1082,1211,2293,949
3405-000,2018,4,5,9,1252,1322,2574,2293
3405-000,2018,4,5,10,1034,834,1868,2574
3405-000,2018,4,5,11,1049,944,1993,1868
3405-000,2018,4,5,12,968,889,1857,1993
3405-000,2018,4,5,13,830,771,1601,1857
3405-000,2018,4,5,14,909,896,1805,1601
3405-000,2018,4,5,15,1044,946,1990,1805
3405-000,2018,4,5,16,1060,895,1955,1990
3405-000,2018,4,5,17,1016,927,1943,1955
3405-000,2018,4,5,18,1163,964,2127,1943
3405-000,2018,4,5,19,1043,928,1971,2127
3405-000,2018,4,5,20,654,615,1269,1971
3405-000,2018,4,5,21,506,512,1018,1269
3405-000,2018,4,5,22,336,354,690,1018
3405-000,2018,4,5,23,204,209,413,690
3405-000,2018,4,5,24,122,128,250,413
3405-000,2018,4,6,1,88,87,175,250
3405-000,2018,4,6,2,59,63,122,175
3405-000,2018,4,6,3,46,58,104,122
3405-000,2018,4,6,4,49,65,114,104
3405-000,2018,4,6,5,102,81,183,114
3405-000,2018,4,6,6,237,157,394,183
3405-000,2018,4,6,7,542,493,1035,394
3405-000,2018,4,6,8,1140,1252,2392,1035
3405-000,2018,4,6,9,1354,1338,2692,2392
3405-000,2018,4,6,10,1211,944,2155,2692
3405-000,2018,4,6,11,1285,1002,2287,2155
3405-000,2018,4,6,12,1121,921,2042,2287
3405-000,2018,4,6,13,973,872,1845,2042
3405-000,2018,4,6,14,1056,999,2055,1845
3405-000,2018,4,6,15,1225,1047,2272,2055
3405-000,2018,4,6,16,1238,1071,2309,2272
3405-000,2018,4,6,17,1159,1030,2189,2309
3405-000,2018,4,6,18,1562,1150,2712,2189
3405-000,2018,4,6,19,1611,1287,2898,2712
3405-000,2018,4,6,20,872,812,1684,2898
3405-000,2018,4,6,21,617,625,1242,1684
3405-000,2018,4,6,22,410,418,828,1242
3405-000,2018,4,6,23,287,236,523,828
3405-000,2018,4,6,24,154,153,307,523
3405-000,2018,4,7,1,106,106,212,307
3405-000,2018,4,7,2,81,79,160,212
3405-000,2018,4,7,3,46,54,100,160
3405-000,2018,4,7,4,68,60,128,100
3405-000,2018,4,7,5,107,64,171,128
3405-000,2018,4,7,6,211,150,361,171
3405-000,2018,4,7,7,458,322,780,361
3405-000,2018,4,7,8,781,664,1445,780
3405-000,2018,4,7,9,916,798,1714,1445
3405-000,2018,4,7,10,882,698,1580,1714
3405-000,2018,4,7,11,1042,814,1856,1580
3405-000,2018,4,7,12,1072,741,1813,1856
3405-000,2018,4,7,13,872,776,1648,1813
3405-000,2018,4,7,14,855,817,1672,1648
3405-000,2018,4,7,15,871,773,1644,1672
3405-000,2018,4,7,16,903,756,1659,1644
3405-000,2018,4,7,17,852,784,1636,1659
3405-000,2018,4,7,18,912,885,1797,1636
3405-000,2018,4,7,19,747,660,1407,1797
3405-000,2018,4,7,20,415,531,946,1407
3405-000,2018,4,7,21,387,417,804,946
3405-000,2018,4,7,22,278,291,569,804
3405-000,2018,4,7,23,182,212,394,569
3405-000,2018,4,7,24,97,138,235,394
3405-000,2018,4,8,1,68,97,165,235
3405-000,2018,4,8,2,44,50,94,165
3405-000,2018,4,8,3,32,36,68,94
3405-000,2018,4,8,4,41,34,75,68
3405-000,2018,4,8,5,59,29,88,75
3405-000,2018,4,8,6,84,70,154,88
3405-000,2018,4,8,7,219,162,381,154
3405-000,2018,4,8,8,385,276,661,381
3405-000,2018,4,8,9,436,331,767,661
3405-000,2018,4,8,10,477,367,844,767
3405-000,2018,4,8,11,611,455,1066,844
3405-000,2018,4,8,12,539,505,1044,1066
3405-000,2018,4,8,13,533,508,1041,1044
3405-000,2018,4,8,14,565,588,1153,1041
3405-000,2018,4,8,15,664,615,1279,1153
3405-000,2018,4,8,16,657,677,1334,1279
3405-000,2018,4,8,17,672,718,1390,1334
3405-000,2018,4,8,18,651,690,1341,1390
3405-000,2018,4,8,19,527,591,1118,1341
3405-000,2018,4,8,20,392,498,890,1118
3405-000,2018,4,8,21,311,398,709,890
3405-000,2018,4,8,22,253,339,592,709
3405-000,2018,4,8,23,196,268,464,592
3405-000,2018,4,8,24,101,152,253,464
3405-000,2018,4,9,1,58,103,161,253
3405-000,2018,4,9,2,43,68,111,161
3405-000,2018,4,9,3,33,54,87,111
3405-000,2018,4,9,4,59,62,121,87
3405-000,2018,4,9,5,113,98,211,121
3405-000,2018,4,9,6,249,226,475,211
3405-000,2018,4,9,7,719,705,1424,475
3405-000,2018,4,9,8,1314,1614,2928,1424
3405-000,2018,4,9,9,1388,1412,2800,2928
3405-000,2018,4,9,10,1179,993,2172,2800
3405-000,2018,4,9,11,1252,1027,2279,2172
3405-000,2018,4,9,12,1176,996,2172,2279
3405-000,2018,4,9,13,929,866,1795,2172
3405-000,2018,4,9,14,1083,1075,2158,1795
3405-000,2018,4,9,15,1222,1032,2254,2158
3405-000,2018,4,9,16,1149,1101,2250,2254
3405-000,2018,4,9,17,1113,1043,2156,2250
3405-000,2018,4,9,18,1263,1138,2401,2156
3405-000,2018,4,9,19,1194,1063,2257,2401
3405-000,2018,4,9,20,738,739,1477,2257
3405-000,2018,4,9,21,545,584,1129,1477
3405-000,2018,4,9,22,402,382,784,1129
3405-000,2018,4,9,23,235,252,487,784
3405-000,2018,4,9,24,128,141,269,487
3405-000,2018,4,10,1,85,95,180,269
3405-000,2018,4,10,2,75,54,129,180
3405-000,2018,4,10,3,66,51,117,129
3405-000,2018,4,10,4,61,78,139,117
3405-000,2018,4,10,5,121,92,213,139
3405-000,2018,4,10,6,287,212,499,213
3405-000,2018,4,10,7,685,555,1240,499
3405-000,2018,4,10,8,1292,1463,2755,1240
3405-000,2018,4,10,9,1373,1354,2727,2755
3405-000,2018,4,10,10,1219,969,2188,2727
3405-000,2018,4,10,11,1217,1048,2265,2188
3405-000,2018,4,10,12,1223,1039,2262,2265
3405-000,2018,4,10,13,967,818,1785,2262
3405-000,2018,4,10,14,1038,1002,2040,1785
3405-000,2018,4,10,15,1345,1072,2417,2040
3405-000,2018,4,10,16,1159,1017,2176,2417
3405-000,2018,4,10,17,1110,978,2088,2176
3405-000,2018,4,10,18,1345,1113,2458,2088
3405-000,2018,4,10,19,1205,1074,2279,2458
3405-000,2018,4,10,20,692,734,1426,2279
3405-000,2018,4,10,21,508,591,1099,1426
3405-000,2018,4,10,22,334,403,737,1099
3405-000,2018,4,10,23,222,246,468,737
3405-000,2018,4,10,24,119,127,246,468
3405-000,2018,4,11,1,67,100,167,246
3405-000,2018,4,11,2,67,59,126,167
3405-000,2018,4,11,3,52,56,108,126
3405-000,2018,4,11,4,57,62,119,108
3405-000,2018,4,11,5,102,98,200,119
3405-000,2018,4,11,6,276,179,455,200
3405-000,2018,4,11,7,668,520,1188,455
3405-000,2018,4,11,8,1259,1405,2664,1188
3405-000,2018,4,11,9,1315,1388,2703,2664
3405-000,2018,4,11,10,1164,998,2162,2703
3405-000,2018,4,11,11,1198,1041,2239,2162
3405-000,2018,4,11,12,1143,917,2060,2239
3405-000,2018,4,11,13,926,838,1764,2060
3405-000,2018,4,11,14,1066,975,2041,1764
3405-000,2018,4,11,15,1153,1085,2238,2041
3405-000,2018,4,11,16,1175,1059,2234,2238
3405-000,2018,4,11,17,1193,1011,2204,2234
3405-000,2018,4,11,18,1347,1088,2435,2204
3405-000,2018,4,11,19,1421,1150,2571,2435
3405-000,2018,4,11,20,714,689,1403,2571
3405-000,2018,4,11,21,516,538,1054,1403
3405-000,2018,4,11,22,352,380,732,1054
3405-000,2018,4,11,23,240,229,469,732
3405-000,2018,4,11,24,137,157,294,469
3405-000,2018,4,12,1,91,91,182,294
3405-000,2018,4,12,2,75,77,152,182
3405-000,2018,4,12,3,55,69,124,152
3405-000,2018,4,12,4,103,87,190,124
3405-000,2018,4,12,5,141,108,249,190
3405-000,2018,4,12,6,300,200,500,249
3405-000,2018,4,12,7,711,559,1270,500
3405-000,2018,4,12,8,1270,1456,2726,1270
3405-000,2018,4,12,9,1403,1385,2788,2726
3405-000,2018,4,12,10,1221,1021,2242,2788
3405-000,2018,4,12,11,1187,1077,2264,2242
3405-000,2018,4,12,12,1188,971,2159,2264
3405-000,2018,4,12,13,918,785,1703,2159
3405-000,2018,4,12,14,1108,996,2104,1703
3405-000,2018,4,12,15,1220,1063,2283,2104
3405-000,2018,4,12,16,1189,1057,2246,2283
3405-000,2018,4,12,17,1168,1066,2234,2246
3405-000,2018,4,12,18,1385,1157,2542,2234
3405-000,2018,4,12,19,1164,1074,2238,2542
3405-000,2018,4,12,20,739,687,1426,2238
3405-000,2018,4,12,21,549,624,1173,1426
3405-000,2018,4,12,22,380,408,788,1173
3405-000,2018,4,12,23,261,267,528,788
3405-000,2018,4,12,24,181,159,340,528
3405-000,2018,4,13,1,106,106,212,340
3405-000,2018,4,13,2,79,84,163,212
3405-000,2018,4,13,3,49,63,112,163
3405-000,2018,4,13,4,76,74,150,112
3405-000,2018,4,13,5,141,120,261,150
3405-000,2018,4,13,6,270,203,473,261
3405-000,2018,4,13,7,721,563,1284,473
3405-000,2018,4,13,8,1272,1394,2666,1284
3405-000,2018,4,13,9,1455,1348,2803,2666
3405-000,2018,4,13,10,1257,1024,2281,2803
3405-000,2018,4,13,11,1258,1084,2342,2281
3405-000,2018,4,13,12,1230,999,2229,2342
3405-000,2018,4,13,13,1016,905,1921,2229
3405-000,2018,4,13,14,1081,1083,2164,1921
3405-000,2018,4,13,15,1286,1070,2356,2164
3405-000,2018,4,13,16,1257,1012,2269,2356
3405-000,2018,4,13,17,1290,1108,2398,2269
3405-000,2018,4,13,18,1705,1229,2934,2398
3405-000,2018,4,13,19,1657,1281,2938,2934
3405-000,2018,4,13,20,928,815,1743,2938
3405-000,2018,4,13,21,601,626,1227,1743
3405-000,2018,4,13,22,378,417,795,1227
3405-000,2018,4,13,23,274,228,502,795
3405-000,2018,4,13,24,187,177,364,502
3405-000,2018,4,14,1,101,90,191,364
3405-000,2018,4,14,2,97,77,174,191
3405-000,2018,4,14,3,57,57,114,174
3405-000,2018,4,14,4,74,69,143,114
3405-000,2018,4,14,5,119,70,189,143
3405-000,2018,4,14,6,181,117,298,189
3405-000,2018,4,14,7,385,279,664,298
3405-000,2018,4,14,8,677,525,1202,664
3405-000,2018,4,14,9,761,647,1408,1202
3405-000,2018,4,14,10,818,664,1482,1408
3405-000,2018,4,14,11,873,736,1609,1482
3405-000,2018,4,14,12,784,702,1486,1609
3405-000,2018,4,14,13,776,679,1455,1486
3405-000,2018,4,14,14,709,674,1383,1455
3405-000,2018,4,14,15,858,746,1604,1383
3405-000,2018,4,14,16,831,684,1515,1604
3405-000,2018,4,14,17,772,673,1445,1515
3405-000,2018,4,14,18,775,829,1604,1445
3405-000,2018,4,14,19,586,623,1209,1604
3405-000,2018,4,14,20,434,418,852,1209
3405-000,2018,4,14,21,319,322,641,852
3405-000,2018,4,14,22,247,251,498,641
3405-000,2018,4,14,23,147,170,317,498
3405-000,2018,4,14,24,103,126,229,317
3405-000,2018,4,15,1,80,72,152,229
3405-000,2018,4,15,2,45,45,90,152
3405-000,2018,4,15,3,33,35,68,90
3405-000,2018,4,15,4,36,29,65,68
3405-000,2018,4,15,5,54,45,99,65
3405-000,2018,4,15,6,125,73,198,99
3405-000,2018,4,15,7,253,166,419,198
3405-000,2018,4,15,8,397,314,711,419
3405-000,2018,4,15,9,496,396,892,711
3405-000,2018,4,15,10,536,408,944,892
3405-000,2018,4,15,11,604,509,1113,944
3405-000,2018,4,15,12,592,553,1145,1113
3405-000,2018,4,15,13,602,567,1169,1145
3405-000,2018,4,15,14,588,602,1190,1169
3405-000,2018,4,15,15,612,628,1240,1190
3405-000,2018,4,15,16,672,700,1372,1240
3405-000,2018,4,15,17,623,707,1330,1372
3405-000,2018,4,15,18,720,738,1458,1330
3405-000,2018,4,15,19,559,676,1235,1458
3405-000,2018,4,15,20,454,593,1047,1235
3405-000,2018,4,15,21,342,447,789,1047
3405-000,2018,4,15,22,276,407,683,789
3405-000,2018,4,15,23,181,296,477,683
3405-000,2018,4,15,24,116,185,301,477
3405-000,2018,4,16,1,45,107,152,301
3405-000,2018,4,16,2,43,56,99,152
3405-000,2018,4,16,3,41,51,92,99
3405-000,2018,4,16,4,65,50,115,92
3405-000,2018,4,16,5,131,115,246,115
3405-000,2018,4,16,6,318,240,558,246
3405-000,2018,4,16,7,698,713,1411,558
3405-000,2018,4,16,8,1300,1631,2931,1411
3405-000,2018,4,16,9,1347,1454,2801,2931
3405-000,2018,4,16,10,1217,1008,2225,2801
3405-000,2018,4,16,11,1197,969,2166,2225
3405-000,2018,4,16,12,1096,945,2041,2166
3405-000,2018,4,16,13,889,865,1754,2041
3405-000,2018,4,16,14,1056,997,2053,1754
3405-000,2018,4,16,15,1291,1018,2309,2053
3405-000,2018,4,16,16,1188,1007,2195,2309
3405-000,2018,4,16,17,1162,1068,2230,2195
3405-000,2018,4,16,18,1314,1149,2463,2230
3405-000,2018,4,16,19,1139,1044,2183,2463
3405-000,2018,4,16,20,756,727,1483,2183
3405-000,2018,4,16,21,567,598,1165,1483
3405-000,2018,4,16,22,406,397,803,1165
3405-000,2018,4,16,23,245,244,489,803
3405-000,2018,4,16,24,140,134,274,489
3405-000,2018,4,17,1,74,102,176,274
3405-000,2018,4,17,2,73,74,147,176
3405-000,2018,4,17,3,39,57,96,147
3405-000,2018,4,17,4,60,71,131,96
3405-000,2018,4,17,5,140,96,236,131
3405-000,2018,4,17,6,302,202,504,236
3405-000,2018,4,17,7,684,562,1246,504
3405-000,2018,4,17,8,1282,1397,2679,1246
3405-000,2018,4,17,9,1337,1348,2685,2679
3405-000,2018,4,17,10,1296,995,2291,2685
3405-000,2018,4,17,11,1151,1084,2235,2291
3405-000,2018,4,17,12,1174,937,2111,2235
3405-000,2018,4,17,13,994,901,1895,2111
3405-000,2018,4,17,14,1032,1012,2044,1895
3405-000,2018,4,17,15,1295,1027,2322,2044
3405-000,2018,4,17,16,1226,1106,2332,2322
3405-000,2018,4,17,17,1141,1071,2212,2332
3405-000,2018,4,17,18,1240,1105,2345,2212
3405-000,2018,4,17,19,1169,1052,2221,2345
3405-000,2018,4,17,20,719,669,1388,2221
3405-000,2018,4,17,21,558,618,1176,1388
3405-000,2018,4,17,22,435,392,827,1176
3405-000,2018,4,17,23,236,249,485,827
3405-000,2018,4,17,24,156,154,310,485
3405-000,2018,4,18,1,105,101,206,310
3405-000,2018,4,18,2,75,78,153,206
3405-000,2018,4,18,3,70,69,139,153
3405-000,2018,4,18,4,81,73,154,139
3405-000,2018,4,18,5,122,109,231,154
3405-000,2018,4,18,6,311,179,490,231
3405-000,2018,4,18,7,673,578,1251,490
3405-000,2018,4,18,8,1249,1393,2642,1251
3405-000,2018,4,18,9,1348,1327,2675,2642
3405-000,2018,4,18,10,1211,1019,2230,2675
3405-000,2018,4,18,11,1223,1120,2343,2230
3405-000,2018,4,18,12,1150,962,2112,2343
3405-000,2018,4,18,13,895,838,1733,2112
3405-000,2018,4,18,14,1058,1024,2082,1733
3405-000,2018,4,18,15,1257,1063,2320,2082
3405-000,2018,4,18,16,1203,1047,2250,2320
3405-000,2018,4,18,17,1148,995,2143,2250
3405-000,2018,4,18,18,1466,1130,2596,2143
3405-000,2018,4,18,19,1394,1069,2463,2596
3405-000,2018,4,18,20,721,686,1407,2463
3405-000,2018,4,18,21,511,552,1063,1407
3405-000,2018,4,18,22,366,373,739,1063
3405-000,2018,4,18,23,307,250,557,739
3405-000,2018,4,18,24,276,141,417,557
3405-000,2018,4,19,1,102,115,217,417
3405-000,2018,4,19,2,82,65,147,217
3405-000,2018,4,19,3,54,54,108,147
3405-000,2018,4,19,4,70,72,142,108
3405-000,2018,4,19,5,149,89,238,142
3405-000,2018,4,19,6,325,208,533,238
3405-000,2018,4,19,7,688,572,1260,533
3405-000,2018,4,19,8,1208,1390,2598,1260
3405-000,2018,4,19,9,1322,1373,2695,2598
3405-000,2018,4,19,10,1203,1075,2278,2695
3405-000,2018,4,19,11,1256,1015,2271,2278
3405-000,2018,4,19,12,1146,929,2075,2271
3405-000,2018,4,19,13,957,877,1834,2075
3405-000,2018,4,19,14,1070,1008,2078,1834
3405-000,2018,4,19,15,1270,1041,2311,2078
3405-000,2018,4,19,16,1234,1048,2282,2311
3405-000,2018,4,19,17,1158,1115,2273,2282
3405-000,2018,4,19,18,1375,1109,2484,2273
3405-000,2018,4,19,19,1211,1007,2218,2484
3405-000,2018,4,19,20,699,744,1443,2218
3405-000,2018,4,19,21,563,598,1161,1443
3405-000,2018,4,19,22,359,415,774,1161
3405-000,2018,4,19,23,266,213,479,774
3405-000,2018,4,19,24,137,128,265,479
3405-000,2018,4,20,1,90,96,186,265
3405-000,2018,4,20,2,58,20,78,186
3405-000,2018,4,20,3,74,62,136,78
3405-000,2018,4,20,4,83,76,159,136
3405-000,2018,4,20,5,136,105,241,159
3405-000,2018,4,20,6,327,202,529,241
3405-000,2018,4,20,7,700,584,1284,529
3405-000,2018,4,20,8,1253,1359,2612,1284
3405-000,2018,4,20,9,1374,1328,2702,2612
3405-000,2018,4,20,10,1194,977,2171,2702
3405-000,2018,4,20,11,1256,1065,2321,2171
3405-000,2018,4,20,12,1141,942,2083,2321
3405-000,2018,4,20,13,933,898,1831,2083
3405-000,2018,4,20,14,1138,1030,2168,1831
3405-000,2018,4,20,15,1282,1044,2326,2168
3405-000,2018,4,20,16,1168,1049,2217,2326
3405-000,2018,4,20,17,1247,1311,2558,2217
3405-000,2018,4,20,18,1632,1204,2836,2558
3405-000,2018,4,20,19,1609,1153,2762,2836
3405-000,2018,4,20,20,903,831,1734,2762
3405-000,2018,4,20,21,618,633,1251,1734
3405-000,2018,4,20,22,425,407,832,1251
3405-000,2018,4,20,23,274,286,560,832
3405-000,2018,4,20,24,160,164,324,560
3405-000,2018,4,21,1,107,108,215,324
3405-000,2018,4,21,2,79,75,154,215
3405-000,2018,4,21,3,64,46,110,154
3405-000,2018,4,21,4,63,66,129,110
3405-000,2018,4,21,5,115,105,220,129
3405-000,2018,4,21,6,255,171,426,220
3405-000,2018,4,21,7,560,391,951,426
3405-000,2018,4,21,8,893,664,1557,951
3405-000,2018,4,21,9,987,791,1778,1557
3405-000,2018,4,21,10,987,805,1792,1778
3405-000,2018,4,21,11,964,888,1852,1792
3405-000,2018,4,21,12,927,828,1755,1852
3405-000,2018,4,21,13,844,817,1661,1755
3405-000,2018,4,21,14,814,772,1586,1661
3405-000,2018,4,21,15,893,802,1695,1586
3405-000,2018,4,21,16,889,756,1645,1695
3405-000,2018,4,21,17,904,824,1728,1645
3405-000,2018,4,21,18,1019,940,1959,1728
3405-000,2018,4,21,19,807,774,1581,1959
3405-000,2018,4,21,20,575,581,1156,1581
3405-000,2018,4,21,21,349,430,779,1156
3405-000,2018,4,21,22,264,349,613,779
3405-000,2018,4,21,23,184,258,442,613
3405-000,2018,4,21,24,119,157,276,442
3405-000,2018,4,22,1,85,94,179,276
3405-000,2018,4,22,2,48,53,101,179
3405-000,2018,4,22,3,46,35,81,101
3405-000,2018,4,22,4,42,36,78,81
3405-000,2018,4,22,5,63,45,108,78
3405-000,2018,4,22,6,128,61,189,108
3405-000,2018,4,22,7,270,168,438,189
3405-000,2018,4,22,8,379,274,653,438
3405-000,2018,4,22,9,486,359,845,653
3405-000,2018,4,22,10,531,395,926,845
3405-000,2018,4,22,11,567,495,1062,926
3405-000,2018,4,22,12,559,475,1034,1062
3405-000,2018,4,22,13,533,507,1040,1034
3405-000,2018,4,22,14,570,597,1167,1040
3405-000,2018,4,22,15,634,657,1291,1167
3405-000,2018,4,22,16,633,628,1261,1291
3405-000,2018,4,22,17,580,611,1191,1261
3405-000,2018,4,22,18,600,687,1287,1191
3405-000,2018,4,22,19,476,543,1019,1287
3405-000,2018,4,22,20,400,496,896,1019
3405-000,2018,4,22,21,309,424,733,896
3405-000,2018,4,22,22,221,378,599,733
3405-000,2018,4,22,23,156,257,413,599
3405-000,2018,4,22,24,105,163,268,413
3405-000,2018,4,23,1,52,103,155,268
3405-000,2018,4,23,2,51,52,103,155
3405-000,2018,4,23,3,31,37,68,103
3405-000,2018,4,23,4,59,52,111,68
3405-000,2018,4,23,5,102,86,188,111
3405-000,2018,4,23,6,253,195,448,188
3405-000,2018,4,23,7,612,570,1182,448
3405-000,2018,4,23,8,1089,1386,2475,1182
3405-000,2018,4,23,9,1260,1333,2593,2475
3405-000,2018,4,23,10,961,891,1852,2593
3405-000,2018,4,23,11,928,900,1828,1852
3405-000,2018,4,23,12,938,887,1825,1828
3405-000,2018,4,23,13,796,742,1538,1825
3405-000,2018,4,23,14,883,867,1750,1538
3405-000,2018,4,23,15,984,939,1923,1750
3405-000,2018,4,23,16,1014,935,1949,1923
3405-000,2018,4,23,17,915,847,1762,1949
3405-000,2018,4,23,18,1067,959,2026,1762
3405-000,2018,4,23,19,933,912,1845,2026
3405-000,2018,4,23,20,613,622,1235,1845
3405-000,2018,4,23,21,450,527,977,1235
3405-000,2018,4,23,22,318,354,672,977
3405-000,2018,4,23,23,241,190,431,672
3405-000,2018,4,23,24,124,139,263,431
3405-000,2018,4,24,1,82,82,164,263
3405-000,2018,4,24,2,74,74,148,164
3405-000,2018,4,24,3,41,60,101,148
3405-000,2018,4,24,4,58,59,117,101
3405-000,2018,4,24,5,123,92,215,117
3405-000,2018,4,24,6,250,177,427,215
3405-000,2018,4,24,7,609,462,1071,427
3405-000,2018,4,24,8,1093,1328,2421,1071
3405-000,2018,4,24,9,1368,1329,2697,2421
3405-000,2018,4,24,10,1138,999,2137,2697
3405-000,2018,4,24,11,1206,985,2191,2137
3405-000,2018,4,24,12,1130,977,2107,2191
3405-000,2018,4,24,13,909,862,1771,2107
3405-000,2018,4,24,14,1053,1035,2088,1771
3405-000,2018,4,24,15,1103,1003,2106,2088
3405-000,2018,4,24,16,1208,1037,2245,2106
3405-000,2018,4,24,17,1086,1022,2108,2245
3405-000,2018,4,24,18,1182,1089,2271,2108
3405-000,2018,4,24,19,1083,1060,2143,2271
3405-000,2018,4,24,20,642,688,1330,2143
3405-000,2018,4,24,21,533,529,1062,1330
3405-000,2018,4,24,22,379,415,794,1062
3405-000,2018,4,24,23,249,227,476,794
3405-000,2018,4,24,24,146,155,301,476
3405-000,2018,4,25,1,89,103,192,301
3405-000,2018,4,25,2,77,58,135,192
3405-000,2018,4,25,3,69,68,137,135
3405-000,2018,4,25,4,78,58,136,137
3405-000,2018,4,25,5,159,96,255,136
3405-000,2018,4,25,6,329,199,528,255
3405-000,2018,4,25,7,683,579,1262,528
3405-000,2018,4,25,8,1238,1328,2566,1262
3405-000,2018,4,25,9,1352,1344,2696,2566
3405-000,2018,4,25,10,1167,1028,2195,2696
3405-000,2018,4,25,11,1168,1068,2236,2195
3405-000,2018,4,25,12,1126,993,2119,2236
3405-000,2018,4,25,13,981,802,1783,2119
3405-000,2018,4,25,14,1008,1028,2036,1783
3405-000,2018,4,25,15,1209,1140,2349,2036
3405-000,2018,4,25,16,1197,1072,2269,2349
3405-000,2018,4,25,17,1171,1028,2199,2269
3405-000,2018,4,25,18,1391,1194,2585,2199
3405-000,2018,4,25,19,1285,1204,2489,2585
3405-000,2018,4,25,20,701,674,1375,2489
3405-000,2018,4,25,21,529,566,1095,1375
3405-000,2018,4,25,22,369,369,738,1095
3405-000,2018,4,25,23,268,234,502,738
3405-000,2018,4,25,24,123,155,278,502
3405-000,2018,4,26,1,104,103,207,278
3405-000,2018,4,26,2,91,83,174,207
3405-000,2018,4,26,3,58,63,121,174
3405-000,2018,4,26,4,122,64,186,121
3405-000,2018,4,26,5,148,114,262,186
3405-000,2018,4,26,6,301,215,516,262
3405-000,2018,4,26,7,748,583,1331,516
3405-000,2018,4,26,8,1278,1436,2714,1331
3405-000,2018,4,26,9,1387,1371,2758,2714
3405-000,2018,4,26,10,1163,989,2152,2758
3405-000,2018,4,26,11,1200,1079,2279,2152
3405-000,2018,4,26,12,1116,940,2056,2279
3405-000,2018,4,26,13,955,829,1784,2056
3405-000,2018,4,26,14,1047,1044,2091,1784
3405-000,2018,4,26,15,1232,1099,2331,2091
3405-000,2018,4,26,16,1256,1104,2360,2331
3405-000,2018,4,26,17,1237,1101,2338,2360
3405-000,2018,4,26,18,1340,1198,2538,2338
3405-000,2018,4,26,19,1204,1082,2286,2538
3405-000,2018,4,26,20,738,757,1495,2286
3405-000,2018,4,26,21,563,592,1155,1495
3405-000,2018,4,26,22,368,437,805,1155
3405-000,2018,4,26,23,267,229,496,805
3405-000,2018,4,26,24,156,159,315,496
3405-000,2018,4,27,1,103,97,200,315
3405-000,2018,4,27,2,99,78,177,200
3405-000,2018,4,27,3,75,57,132,177
3405-000,2018,4,27,4,67,73,140,132
3405-000,2018,4,27,5,140,106,246,140
3405-000,2018,4,27,6,329,202,531,246
3405-000,2018,4,27,7,753,590,1343,531
3405-000,2018,4,27,8,1254,1402,2656,1343
3405-000,2018,4,27,9,1317,1381,2698,2656
3405-000,2018,4,27,10,1274,1017,2291,2698
3405-000,2018,4,27,11,1191,1048,2239,2291
3405-000,2018,4,27,12,1199,962,2161,2239
3405-000,2018,4,27,13,956,929,1885,2161
3405-000,2018,4,27,14,1072,998,2070,1885
3405-000,2018,4,27,15,1240,1080,2320,2070
3405-000,2018,4,27,16,1257,1162,2419,2320
3405-000,2018,4,27,17,1203,1069,2272,2419
3405-000,2018,4,27,18,1623,1153,2776,2272
3405-000,2018,4,27,19,1512,1420,2932,2776
3405-000,2018,4,27,20,998,813,1811,2932
3405-000,2018,4,27,21,626,674,1300,1811
3405-000,2018,4,27,22,417,412,829,1300
3405-000,2018,4,27,23,321,257,578,829
3405-000,2018,4,27,24,204,170,374,578
3405-000,2018,4,28,1,125,77,202,374
3405-000,2018,4,28,2,85,76,161,202
3405-000,2018,4,28,3,65,52,117,161
3405-000,2018,4,28,4,84,68,152,117
3405-000,2018,4,28,5,154,88,242,152
3405-000,2018,4,28,6,316,181,497,242
3405-000,2018,4,28,7,612,415,1027,497
3405-000,2018,4,28,8,803,722,1525,1027
3405-000,2018,4,28,9,987,847,1834,1525
3405-000,2018,4,28,10,940,734,1674,1834
3405-000,2018,4,28,11,1019,812,1831,1674
3405-000,2018,4,28,12,948,765,1713,1831
3405-000,2018,4,28,13,848,781,1629,1713
3405-000,2018,4,28,14,848,768,1616,1629
3405-000,2018,4,28,15,934,796,1730,1616
3405-000,2018,4,28,16,909,845,1754,1730
3405-000,2018,4,28,17,957,793,1750,1754
3405-000,2018,4,28,18,1022,930,1952,1750
3405-000,2018,4,28,19,751,764,1515,1952
3405-000,2018,4,28,20,524,573,1097,1515
3405-000,2018,4,28,21,407,475,882,1097
3405-000,2018,4,28,22,276,302,578,882
3405-000,2018,4,28,23,207,229,436,578
3405-000,2018,4,28,24,130,149,279,436
3405-000,2018,4,29,1,82,92,174,279
3405-000,2018,4,29,2,79,55,134,174
3405-000,2018,4,29,3,44,45,89,134
3405-000,2018,4,29,4,47,35,82,89
3405-000,2018,4,29,5,73,31,104,82
3405-000,2018,4,29,6,179,95,274,104
3405-000,2018,4,29,7,359,216,575,274
3405-000,2018,4,29,8,417,307,724,575
3405-000,2018,4,29,9,485,375,860,724
3405-000,2018,4,29,10,558,446,1004,860
3405-000,2018,4,29,11,595,549,1144,1004
3405-000,2018,4,29,12,586,502,1088,1144
3405-000,2018,4,29,13,564,528,1092,1088
3405-000,2018,4,29,14,598,633,1231,1092
3405-000,2018,4,29,15,613,664,1277,1231
3405-000,2018,4,29,16,713,652,1365,1277
3405-000,2018,4,29,17,680,702,1382,1365
3405-000,2018,4,29,18,686,745,1431,1382
3405-000,2018,4,29,19,594,663,1257,1431
3405-000,2018,4,29,20,516,594,1110,1257
3405-000,2018,4,29,21,456,486,942,1110
3405-000,2018,4,29,22,331,389,720,942
3405-000,2018,4,29,23,204,285,489,720
3405-000,2018,4,29,24,119,160,279,489
3405-000,2018,4,30,1,81,103,184,279
3405-000,2018,4,30,2,54,69,123,184
3405-000,2018,4,30,3,48,45,93,123
3405-000,2018,4,30,4,65,56,121,93
3405-000,2018,4,30,5,160,96,256,121
3405-000,2018,4,30,6,348,234,582,256
3405-000,2018,4,30,7,793,666,1459,582
3405-000,2018,4,30,8,1213,1611,2824,1459
3405-000,2018,4,30,9,1317,1339,2656,2824
3405-000,2018,4,30,10,1128,991,2119,2656
3405-000,2018,4,30,11,1107,1043,2150,2119
3405-000,2018,4,30,12,1077,993,2070,2150
3405-000,2018,4,30,13,922,858,1780,2070
3405-000,2018,4,30,14,1042,983,2025,1780
3405-000,2018,4,30,15,1153,1058,2211,2025
3405-000,2018,4,30,16,1200,1136,2336,2211
3405-000,2018,4,30,17,1191,1042,2233,2336
3405-000,2018,4,30,18,1353,1142,2495,2233
3405-000,2018,4,30,19,1380,1142,2522,2495
3405-000,2018,4,30,20,851,788,1639,2522
3405-000,2018,4,30,21,616,668,1284,1639
3405-000,2018,4,30,22,398,439,837,1284
3405-000,2018,4,30,23,249,265,514,837
3405-000,2018,4,30,24,148,177,325,514
3405-000,2018,5,1,1,101,109,210,325
3405-000,2018,5,1,2,85,74,159,210
3405-000,2018,5,1,3,49,54,103,159
3405-000,2018,5,1,4,69,61,130,103
3405-000,2018,5,1,5,107,80,187,130
3405-000,2018,5,1,6,220,158,378,187
3405-000,2018,5,1,7,515,329,844,378
3405-000,2018,5,1,8,843,782,1625,844
3405-000,2018,5,1,9,947,819,1766,1625
3405-000,2018,5,1,10,860,706,1566,1766
3405-000,2018,5,1,11,869,770,1639,1566
3405-000,2018,5,1,12,813,754,1567,1639
3405-000,2018,5,1,13,760,661,1421,1567
3405-000,2018,5,1,14,735,709,1444,1421
3405-000,2018,5,1,15,756,756,1512,1444
3405-000,2018,5,1,16,799,826,1625,1512
3405-000,2018,5,1,17,745,816,1561,1625
3405-000,2018,5,1,18,823,866,1689,1561
3405-000,2018,5,1,19,667,716,1383,1689
3405-000,2018,5,1,20,680,678,1358,1383
3405-000,2018,5,1,21,546,574,1120,1358
3405-000,2018,5,1,22,407,404,811,1120
3405-000,2018,5,1,23,242,238,480,811
3405-000,2018,5,1,24,151,154,305,480
3405-000,2018,5,2,1,80,93,173,305
3405-000,2018,5,2,2,76,68,144,173
3405-000,2018,5,2,3,43,40,83,144
3405-000,2018,5,2,4,66,56,122,83
3405-000,2018,5,2,5,132,108,240,122
3405-000,2018,5,2,6,282,197,479,240
3405-000,2018,5,2,7,623,576,1199,479
3405-000,2018,5,2,8,1151,1420,2571,1199
3405-000,2018,5,2,9,1328,1337,2665,2571
3405-000,2018,5,2,10,1169,962,2131,2665
3405-000,2018,5,2,11,1127,1095,2222,2131
3405-000,2018,5,2,12,1043,1018,2061,2222
3405-000,2018,5,2,13,979,805,1784,2061
3405-000,2018,5,2,14,1013,1001,2014,1784
3405-000,2018,5,2,15,1145,1011,2156,2014
3405-000,2018,5,2,16,1165,1020,2185,2156
3405-000,2018,5,2,17,1094,1045,2139,2185
3405-000,2018,5,2,18,1131,1030,2161,2139
3405-000,2018,5,2,19,1118,1021,2139,2161
3405-000,2018,5,2,20,597,681,1278,2139
3405-000,2018,5,2,21,479,471,950,1278
3405-000,2018,5,2,22,335,359,694,950
3405-000,2018,5,2,23,225,174,399,694
3405-000,2018,5,2,24,115,131,246,399
3405-000,2018,5,3,1,69,86,155,246
3405-000,2018,5,3,2,64,75,139,155
3405-000,2018,5,3,3,58,65,123,139
3405-000,2018,5,3,4,81,67,148,123
3405-000,2018,5,3,5,141,104,245,148
3405-000,2018,5,3,6,314,218,532,245
3405-000,2018,5,3,7,694,570,1264,532
3405-000,2018,5,3,8,1206,1358,2564,1264
3405-000,2018,5,3,9,1416,1369,2785,2564
3405-000,2018,5,3,10,1244,1003,2247,2785
3405-000,2018,5,3,11,1135,1007,2142,2247
3405-000,2018,5,3,12,1172,946,2118,2142
3405-000,2018,5,3,13,940,856,1796,2118
3405-000,2018,5,3,14,1069,1014,2083,1796
3405-000,2018,5,3,15,1243,1092,2335,2083
3405-000,2018,5,3,16,1219,1121,2340,2335
3405-000,2018,5,3,17,1192,1093,2285,2340
3405-000,2018,5,3,18,1235,1108,2343,2285
3405-000,2018,5,3,19,1169,1127,2296,2343
3405-000,2018,5,3,20,747,684,1431,2296
3405-000,2018,5,3,21,550,634,1184,1431
3405-000,2018,5,3,22,421,400,821,1184
3405-000,2018,5,3,23,286,252,538,821
3405-000,2018,5,3,24,156,165,321,538
3405-000,2018,5,4,1,98,91,189,321
3405-000,2018,5,4,2,64,72,136,189
3405-000,2018,5,4,3,70,58,128,136
3405-000,2018,5,4,4,64,95,159,128
3405-000,2018,5,4,5,147,101,248,159
3405-000,2018,5,4,6,311,215,526,248
3405-000,2018,5,4,7,657,652,1309,526
3405-000,2018,5,4,8,1212,1343,2555,1309
3405-000,2018,5,4,9,1361,1343,2704,2555
3405-000,2018,5,4,10,1176,1044,2220,2704
3405-000,2018,5,4,11,1132,1041,2173,2220
3405-000,2018,5,4,12,1191,953,2144,2173
3405-000,2018,5,4,13,1061,901,1962,2144
3405-000,2018,5,4,14,1092,1015,2107,1962
3405-000,2018,5,4,15,1330,1122,2452,2107
3405-000,2018,5,4,16,1379,1165,2544,2452
3405-000,2018,5,4,17,1351,1257,2608,2544
3405-000,2018,5,4,18,1634,1286,2920,2608
3405-000,2018,5,4,19,1724,1521,3245,2920
3405-000,2018,5,4,20,1340,1035,2375,3245
3405-000,2018,5,4,21,981,771,1752,2375
3405-000,2018,5,4,22,588,691,1279,1752
3405-000,2018,5,4,23,340,517,857,1279
3405-000,2018,5,4,24,170,308,478,857
3405-000,2018,5,5,1,145,149,294,478
3405-000,2018,5,5,2,110,92,202,294
3405-000,2018,5,5,3,57,56,113,202
3405-000,2018,5,5,4,77,71,148,113
3405-000,2018,5,5,5,121,67,188,148
3405-000,2018,5,5,6,255,178,433,188
3405-000,2018,5,5,7,579,338,917,433
3405-000,2018,5,5,8,753,595,1348,917
3405-000,2018,5,5,9,896,842,1738,1348
3405-000,2018,5,5,10,1124,1113,2237,1738
3405-000,2018,5,5,11,1253,1025,2278,2237
3405-000,2018,5,5,12,1177,903,2080,2278
3405-000,2018,5,5,13,945,998,1943,2080
3405-000,2018,5,5,14,855,912,1767,1943
3405-000,2018,5,5,15,808,895,1703,1767
3405-000,2018,5,5,16,880,903,1783,1703
3405-000,2018,5,5,17,804,831,1635,1783
3405-000,2018,5,5,18,958,1064,2022,1635
3405-000,2018,5,5,19,656,851,1507,2022
3405-000,2018,5,5,20,445,637,1082,1507
3405-000,2018,5,5,21,376,432,808,1082
3405-000,2018,5,5,22,293,367,660,808
3405-000,2018,5,5,23,215,252,467,660
3405-000,2018,5,5,24,127,170,297,467
3405-000,2018,5,6,1,67,96,163,297
3405-000,2018,5,6,2,53,50,103,163
3405-000,2018,5,6,3,29,43,72,103
3405-000,2018,5,6,4,26,33,59,72
3405-000,2018,5,6,5,48,28,76,59
3405-000,2018,5,6,6,75,57,132,76
3405-000,2018,5,6,7,154,133,287,132
3405-000,2018,5,6,8,238,237,475,287
3405-000,2018,5,6,9,356,286,642,475
3405-000,2018,5,6,10,391,395,786,642
3405-000,2018,5,6,11,587,511,1098,786
3405-000,2018,5,6,12,646,521,1167,1098
3405-000,2018,5,6,13,560,600,1160,1167
3405-000,2018,5,6,14,566,591,1157,1160
3405-000,2018,5,6,15,714,605,1319,1157
3405-000,2018,5,6,16,714,597,1311,1319
3405-000,2018,5,6,17,722,629,1351,1311
3405-000,2018,5,6,18,639,634,1273,1351
3405-000,2018,5,6,19,575,606,1181,1273
3405-000,2018,5,6,20,403,560,963,1181
3405-000,2018,5,6,21,353,503,856,963
3405-000,2018,5,6,22,320,498,818,856
3405-000,2018,5,6,23,224,359,583,818
3405-000,2018,5,6,24,138,203,341,583
3405-000,2018,5,7,1,76,121,197,341
3405-000,2018,5,7,2,55,71,126,197
3405-000,2018,5,7,3,44,43,87,126
3405-000,2018,5,7,4,60,44,104,87
3405-000,2018,5,7,5,92,78,170,104
3405-000,2018,5,7,6,223,165,388,170
3405-000,2018,5,7,7,462,387,849,388
3405-000,2018,5,7,8,769,665,1434,849
3405-000,2018,5,7,9,776,646,1422,1434
3405-000,2018,5,7,10,734,685,1419,1422
3405-000,2018,5,7,11,935,688,1623,1419
3405-000,2018,5,7,12,934,778,1712,1623
3405-000,2018,5,7,13,804,697,1501,1712
3405-000,2018,5,7,14,809,773,1582,1501
3405-000,2018,5,7,15,912,786,1698,1582
3405-000,2018,5,7,16,883,910,1793,1698
3405-000,2018,5,7,17,928,884,1812,1793
3405-000,2018,5,7,18,875,1136,2011,1812
3405-000,2018,5,7,19,802,885,1687,2011
3405-000,2018,5,7,20,610,872,1482,1687
3405-000,2018,5,7,21,510,701,1211,1482
3405-000,2018,5,7,22,315,491,806,1211
3405-000,2018,5,7,23,239,373,612,806
3405-000,2018,5,7,24,139,236,375,612
3405-000,2018,5,8,1,65,116,181,375
3405-000,2018,5,8,2,38,83,121,181
3405-000,2018,5,8,3,43,51,94,121
3405-000,2018,5,8,4,64,67,131,94
3405-000,2018,5,8,5,145,106,251,131
3405-000,2018,5,8,6,296,248,544,251
3405-000,2018,5,8,7,697,685,1382,544
3405-000,2018,5,8,8,1273,1550,2823,1382
3405-000,2018,5,8,9,1364,1374,2738,2823
3405-000,2018,5,8,10,1157,897,2054,2738
3405-000,2018,5,8,11,1160,1067,2227,2054
3405-000,2018,5,8,12,1121,974,2095,2227
3405-000,2018,5,8,13,954,942,1896,2095
3405-000,2018,5,8,14,1054,1041,2095,1896
3405-000,2018,5,8,15,1212,1122,2334,2095
3405-000,2018,5,8,16,1197,1085,2282,2334
3405-000,2018,5,8,17,1137,1075,2212,2282
3405-000,2018,5,8,18,1303,1131,2434,2212
3405-000,2018,5,8,19,1128,1096,2224,2434
3405-000,2018,5,8,20,717,777,1494,2224
3405-000,2018,5,8,21,568,602,1170,1494
3405-000,2018,5,8,22,381,432,813,1170
3405-000,2018,5,8,23,262,285,547,813
3405-000,2018,5,8,24,172,141,313,547
3405-000,2018,5,9,1,100,112,212,313
3405-000,2018,5,9,2,60,87,147,212
3405-000,2018,5,9,3,62,71,133,147
3405-000,2018,5,9,4,79,69,148,133
3405-000,2018,5,9,5,141,96,237,148
3405-000,2018,5,9,6,305,226,531,237
3405-000,2018,5,9,7,737,611,1348,531
3405-000,2018,5,9,8,1194,1418,2612,1348
3405-000,2018,5,9,9,1396,1372,2768,2612
3405-000,2018,5,9,10,1167,1102,2269,2768
3405-000,2018,5,9,11,1141,1097,2238,2269
3405-000,2018,5,9,12,1149,1043,2192,2238
3405-000,2018,5,9,13,955,898,1853,2192
3405-000,2018,5,9,14,1074,1018,2092,1853
3405-000,2018,5,9,15,1217,1086,2303,2092
3405-000,2018,5,9,16,1287,1138,2425,2303
3405-000,2018,5,9,17,1213,1082,2295,2425
3405-000,2018,5,9,18,1346,1140,2486,2295
3405-000,2018,5,9,19,1353,1080,2433,2486
3405-000,2018,5,9,20,726,643,1369,2433
3405-000,2018,5,9,21,491,562,1053,1369
3405-000,2018,5,9,22,404,352,756,1053
3405-000,2018,5,9,23,261,261,522,756
3405-000,2018,5,9,24,135,112,247,522
3405-000,2018,5,10,1,96,109,205,247
3405-000,2018,5,10,2,62,89,151,205
3405-000,2018,5,10,3,72,64,136,151
3405-000,2018,5,10,4,69,66,135,136
3405-000,2018,5,10,5,136,109,245,135
3405-000,2018,5,10,6,338,216,554,245
3405-000,2018,5,10,7,724,599,1323,554
3405-000,2018,5,10,8,1194,1350,2544,1323
3405-000,2018,5,10,9,1362,973,2335,2544
3405-000,2018,5,10,10,1192,1063,2255,2335
3405-000,2018,5,10,11,1184,1060,2244,2255
3405-000,2018,5,10,12,1110,985,2095,2244
3405-000,2018,5,10,13,972,857,1829,2095
3405-000,2018,5,10,14,1085,969,2054,1829
3405-000,2018,5,10,15,1189,1137,2326,2054
3405-000,2018,5,10,16,1158,1028,2186,2326
3405-000,2018,5,10,17,1146,1056,2202,2186
3405-000,2018,5,10,18,1334,1144,2478,2202
3405-000,2018,5,10,19,1150,1065,2215,2478
3405-000,2018,5,10,20,750,694,1444,2215
3405-000,2018,5,10,21,547,662,1209,1444
3405-000,2018,5,10,22,393,445,838,1209
3405-000,2018,5,10,23,258,240,498,838
3405-000,2018,5,10,24,148,162,310,498
3405-000,2018,5,11,1,96,94,190,310
3405-000,2018,5,11,2,92,75,167,190
3405-000,2018,5,11,3,58,58,116,167
3405-000,2018,5,11,4,78,84,162,116
3405-000,2018,5,11,5,140,104,244,162
3405-000,2018,5,11,6,355,208,563,244
3405-000,2018,5,11,7,746,621,1367,563
3405-000,2018,5,11,8,1226,1372,2598,1367
3405-000,2018,5,11,9,1382,1362,2744,2598
3405-000,2018,5,11,10,1145,1030,2175,2744
3405-000,2018,5,11,11,1194,1044,2238,2175
3405-000,2018,5,11,12,1063,958,2021,2238
3405-000,2018,5,11,13,989,904,1893,2021
3405-000,2018,5,11,14,1134,1094,2228,1893
3405-000,2018,5,11,15,1243,1197,2440,2228
3405-000,2018,5,11,16,1233,1144,2377,2440
3405-000,2018,5,11,17,1211,1008,2219,2377
3405-000,2018,5,11,18,1602,1181,2783,2219
3405-000,2018,5,11,19,1794,1255,3049,2783
3405-000,2018,5,11,20,871,862,1733,3049
3405-000,2018,5,11,21,613,639,1252,1733
3405-000,2018,5,11,22,406,430,836,1252
3405-000,2018,5,11,23,289,285,574,836
3405-000,2018,5,11,24,175,164,339,574
3405-000,2018,5,12,1,101,119,220,339
3405-000,2018,5,12,2,77,92,169,220
3405-000,2018,5,12,3,73,58,131,169
3405-000,2018,5,12,4,73,70,143,131
3405-000,2018,5,12,5,151,78,229,143
3405-000,2018,5,12,6,252,180,432,229
3405-000,2018,5,12,7,441,376,817,432
3405-000,2018,5,12,8,679,658,1337,817
3405-000,2018,5,12,9,826,844,1670,1337
3405-000,2018,5,12,10,849,924,1773,1670
3405-000,2018,5,12,11,838,918,1756,1773
3405-000,2018,5,12,12,802,834,1636,1756
3405-000,2018,5,12,13,752,890,1642,1636
3405-000,2018,5,12,14,655,840,1495,1642
3405-000,2018,5,12,15,668,846,1514,1495
3405-000,2018,5,12,16,682,874,1556,1514
3405-000,2018,5,12,17,709,812,1521,1556
3405-000,2018,5,12,18,736,997,1733,1521
3405-000,2018,5,12,19,545,808,1353,1733
3405-000,2018,5,12,20,433,605,1038,1353
3405-000,2018,5,12,21,274,454,728,1038
3405-000,2018,5,12,22,230,334,564,728
3405-000,2018,5,12,23,151,240,391,564
3405-000,2018,5,12,24,101,160,261,391
3405-000,2018,5,13,1,70,94,164,261
3405-000,2018,5,13,2,55,52,107,164
3405-000,2018,5,13,3,26,44,70,107
3405-000,2018,5,13,4,36,34,70,70
3405-000,2018,5,13,5,54,30,84,70
3405-000,2018,5,13,6,123,76,199,84
3405-000,2018,5,13,7,230,174,404,199
3405-000,2018,5,13,8,334,272,606,404
3405-000,2018,5,13,9,419,330,749,606
3405-000,2018,5,13,10,494,420,914,749
3405-000,2018,5,13,11,565,530,1095,914
3405-000,2018,5,13,12,586,512,1098,1095
3405-000,2018,5,13,13,544,564,1108,1098
3405-000,2018,5,13,14,540,612,1152,1108
3405-000,2018,5,13,15,605,634,1239,1152
3405-000,2018,5,13,16,621,624,1245,1239
3405-000,2018,5,13,17,575,626,1201,1245
3405-000,2018,5,13,18,592,651,1243,1201
3405-000,2018,5,13,19,456,613,1069,1243
3405-000,2018,5,13,20,397,568,965,1069
3405-000,2018,5,13,21,334,470,804,965
3405-000,2018,5,13,22,289,392,681,804
3405-000,2018,5,13,23,202,322,524,681
3405-000,2018,5,13,24,155,182,337,524
3405-000,2018,5,14,1,56,28,84,337
3405-000,2018,5,14,2,45,8,53,84
3405-000,2018,5,14,3,44,11,55,53
3405-000,2018,5,14,4,72,38,110,55
3405-000,2018,5,14,5,176,75,251,110
3405-000,2018,5,14,6,378,200,578,251
3405-000,2018,5,14,7,793,526,1319,578
3405-000,2018,5,14,8,1254,1138,2392,1319
3405-000,2018,5,14,9,1358,992,2350,2392
3405-000,2018,5,14,10,1258,838,2096,2350
3405-000,2018,5,14,11,1133,866,1999,2096
3405-000,2018,5,14,12,1004,886,1890,1999
3405-000,2018,5,14,13,944,778,1722,1890
3405-000,2018,5,14,14,935,993,1928,1722
3405-000,2018,5,14,15,1172,1061,2233,1928
3405-000,2018,5,14,16,1160,1110,2270,2233
3405-000,2018,5,14,17,1132,1047,2179,2270
3405-000,2018,5,14,18,1202,1148,2350,2179
3405-000,2018,5,14,19,1188,1128,2316,2350
3405-000,2018,5,14,20,686,707,1393,2316
3405-000,2018,5,14,21,551,611,1162,1393
3405-000,2018,5,14,22,375,419,794,1162
3405-000,2018,5,14,23,271,319,590,794
3405-000,2018,5,14,24,143,206,349,590
3405-000,2018,5,15,1,91,112,203,349
3405-000,2018,5,15,2,69,78,147,203
3405-000,2018,5,15,3,58,52,110,147
3405-000,2018,5,15,4,68,64,132,110
3405-000,2018,5,15,5,146,93,239,132
3405-000,2018,5,15,6,351,203,554,239
3405-000,2018,5,15,7,747,507,1254,554
3405-000,2018,5,15,8,1262,1166,2428,1254
3405-000,2018,5,15,9,1487,1096,2583,2428
3405-000,2018,5,15,10,1202,802,2004,2583
3405-000,2018,5,15,11,1240,918,2158,2004
3405-000,2018,5,15,12,1081,997,2078,2158
3405-000,2018,5,15,13,1030,901,1931,2078
3405-000,2018,5,15,14,1093,1036,2129,1931
3405-000,2018,5,15,15,1224,1098,2322,2129
3405-000,2018,5,15,16,1237,1144,2381,2322
3405-000,2018,5,15,17,1144,1113,2257,2381
3405-000,2018,5,15,18,1287,1172,2459,2257
3405-000,2018,5,15,19,1164,1158,2322,2459
3405-000,2018,5,15,20,698,744,1442,2322
3405-000,2018,5,15,21,561,682,1243,1442
3405-000,2018,5,15,22,346,421,767,1243
3405-000,2018,5,15,23,240,222,462,767
3405-000,2018,5,15,24,139,167,306,462
3405-000,2018,5,16,1,101,103,204,306
3405-000,2018,5,16,2,50,87,137,204
3405-000,2018,5,16,3,63,61,124,137
3405-000,2018,5,16,4,64,72,136,124
3405-000,2018,5,16,5,144,97,241,136
3405-000,2018,5,16,6,248,153,401,241
3405-000,2018,5,16,7,621,482,1103,401
3405-000,2018,5,16,8,1183,1273,2456,1103
3405-000,2018,5,16,9,1313,1344,2657,2456
3405-000,2018,5,16,10,1162,960,2122,2657
3405-000,2018,5,16,11,1132,990,2122,2122
3405-000,2018,5,16,12,1071,901,1972,2122
3405-000,2018,5,16,13,875,835,1710,1972
3405-000,2018,5,16,14,902,933,1835,1710
3405-000,2018,5,16,15,1080,926,2006,1835
3405-000,2018,5,16,16,1037,1025,2062,2006
3405-000,2018,5,16,17,998,1041,2039,2062
3405-000,2018,5,16,18,1195,1095,2290,2039
3405-000,2018,5,16,19,1061,1027,2088,2290
3405-000,2018,5,16,20,612,609,1221,2088
3405-000,2018,5,16,21,407,474,881,1221
3405-000,2018,5,16,22,320,342,662,881
3405-000,2018,5,16,23,233,178,411,662
3405-000,2018,5,16,24,125,137,262,411
3405-000,2018,5,17,1,107,94,201,262
3405-000,2018,5,17,2,68,63,131,201
3405-000,2018,5,17,3,58,53,111,131
3405-000,2018,5,17,4,66,77,143,111
3405-000,2018,5,17,5,98,90,188,143
3405-000,2018,5,17,6,226,186,412,188
3405-000,2018,5,17,7,534,448,982,412
3405-000,2018,5,17,8,1084,1222,2306,982
3405-000,2018,5,17,9,1280,1330,2610,2306
3405-000,2018,5,17,10,1035,884,1919,2610
3405-000,2018,5,17,11,1038,1018,2056,1919
3405-000,2018,5,17,12,983,932,1915,2056
3405-000,2018,5,17,13,954,759,1713,1915
3405-000,2018,5,17,14,1014,1006,2020,1713
3405-000,2018,5,17,15,1054,1039,2093,2020
3405-000,2018,5,17,16,1107,962,2069,2093
3405-000,2018,5,17,17,1012,975,1987,2069
3405-000,2018,5,17,18,1075,992,2067,1987
3405-000,2018,5,17,19,981,959,1940,2067
3405-000,2018,5,17,20,636,598,1234,1940
3405-000,2018,5,17,21,490,593,1083,1234
3405-000,2018,5,17,22,322,397,719,1083
3405-000,2018,5,17,23,223,194,417,719
3405-000,2018,5,17,24,140,147,287,417
3405-000,2018,5,18,1,76,87,163,287
3405-000,2018,5,18,2,75,66,141,163
3405-000,2018,5,18,3,52,49,101,141
3405-000,2018,5,18,4,61,65,126,101
3405-000,2018,5,18,5,119,106,225,126
3405-000,2018,5,18,6,293,205,498,225
3405-000,2018,5,18,7,609,489,1098,498
3405-000,2018,5,18,8,1105,1218,2323,1098
3405-000,2018,5,18,9,1318,1296,2614,2323
3405-000,2018,5,18,10,1136,988,2124,2614
3405-000,2018,5,18,11,1190,1029,2219,2124
3405-000,2018,5,18,12,1094,964,2058,2219
3405-000,2018,5,18,13,947,872,1819,2058
3405-000,2018,5,18,14,1000,952,1952,1819
3405-000,2018,5,18,15,1160,1038,2198,1952
3405-000,2018,5,18,16,1202,1091,2293,2198
3405-000,2018,5,18,17,1123,1273,2396,2293
3405-000,2018,5,18,18,1441,1247,2688,2396
3405-000,2018,5,18,19,1526,1272,2798,2688
3405-000,2018,5,18,20,872,853,1725,2798
3405-000,2018,5,18,21,636,631,1267,1725
3405-000,2018,5,18,22,426,420,846,1267
3405-000,2018,5,18,23,295,251,546,846
3405-000,2018,5,18,24,165,189,354,546
3405-000,2018,5,19,1,104,119,223,354
3405-000,2018,5,19,2,66,81,147,223
3405-000,2018,5,19,3,75,62,137,147
3405-000,2018,5,19,4,71,79,150,137
3405-000,2018,5,19,5,110,92,202,150
3405-000,2018,5,19,6,295,183,478,202
3405-000,2018,5,19,7,553,406,959,478
3405-000,2018,5,19,8,827,734,1561,959
3405-000,2018,5,19,9,921,871,1792,1561
3405-000,2018,5,19,10,935,795,1730,1792
3405-000,2018,5,19,11,922,890,1812,1730
3405-000,2018,5,19,12,918,771,1689,1812
3405-000,2018,5,19,13,806,899,1705,1689
3405-000,2018,5,19,14,846,814,1660,1705
3405-000,2018,5,19,15,877,749,1626,1660
3405-000,2018,5,19,16,870,739,1609,1626
3405-000,2018,5,19,17,805,839,1644,1609
3405-000,2018,5,19,18,889,915,1804,1644
3405-000,2018,5,19,19,720,732,1452,1804
3405-000,2018,5,19,20,496,581,1077,1452
3405-000,2018,5,19,21,375,401,776,1077
3405-000,2018,5,19,22,287,341,628,776
3405-000,2018,5,19,23,194,252,446,628
3405-000,2018,5,19,24,131,162,293,446
3405-000,2018,5,20,1,94,100,194,293
3405-000,2018,5,20,2,50,64,114,194
3405-000,2018,5,20,3,37,31,68,114
3405-000,2018,5,20,4,29,42,71,68
3405-000,2018,5,20,5,69,56,125,71
3405-000,2018,5,20,6,154,87,241,125
3405-000,2018,5,20,7,302,226,528,241
3405-000,2018,5,20,8,450,305,755,528
3405-000,2018,5,20,9,500,379,879,755
3405-000,2018,5,20,10,560,448,1008,879
3405-000,2018,5,20,11,713,518,1231,1008
3405-000,2018,5,20,12,555,573,1128,1231
3405-000,2018,5,20,13,575,575,1150,1128
3405-000,2018,5,20,14,608,622,1230,1150
3405-000,2018,5,20,15,616,674,1290,1230
3405-000,2018,5,20,16,630,714,1344,1290
3405-000,2018,5,20,17,614,635,1249,1344
3405-000,2018,5,20,18,634,751,1385,1249
3405-000,2018,5,20,19,550,643,1193,1385
3405-000,2018,5,20,20,498,560,1058,1193
3405-000,2018,5,20,21,356,462,818,1058
3405-000,2018,5,20,22,291,415,706,818
3405-000,2018,5,20,23,238,289,527,706
3405-000,2018,5,20,24,123,187,310,527
3405-000,2018,5,21,1,81,103,184,310
3405-000,2018,5,21,2,41,75,116,184
3405-000,2018,5,21,3,52,59,111,116
3405-000,2018,5,21,4,49,67,116,111
3405-000,2018,5,21,5,132,118,250,116
3405-000,2018,5,21,6,336,238,574,250
3405-000,2018,5,21,7,767,637,1404,574
3405-000,2018,5,21,8,1119,1340,2459,1404
3405-000,2018,5,21,9,1243,1182,2425,2459
3405-000,2018,5,21,10,1096,963,2059,2425
3405-000,2018,5,21,11,1015,961,1976,2059
3405-000,2018,5,21,12,1061,973,2034,1976
3405-000,2018,5,21,13,903,913,1816,2034
3405-000,2018,5,21,14,987,952,1939,1816
3405-000,2018,5,21,15,1165,1083,2248,1939
3405-000,2018,5,21,16,1088,1061,2149,2248
3405-000,2018,5,21,17,1093,925,2018,2149
3405-000,2018,5,21,18,1296,1132,2428,2018
3405-000,2018,5,21,19,1261,1065,2326,2428
3405-000,2018,5,21,20,732,726,1458,2326
3405-000,2018,5,21,21,565,626,1191,1458
3405-000,2018,5,21,22,359,438,797,1191
3405-000,2018,5,21,23,228,232,460,797
3405-000,2018,5,21,24,147,168,315,460
3405-000,2018,5,22,1,100,117,217,315
3405-000,2018,5,22,2,61,75,136,217
3405-000,2018,5,22,3,57,53,110,136
3405-000,2018,5,22,4,80,74,154,110
3405-000,2018,5,22,5,102,89,191,154
3405-000,2018,5,22,6,261,191,452,191
3405-000,2018,5,22,7,600,386,986,452
3405-000,2018,5,22,8,771,686,1457,986
3405-000,2018,5,22,9,854,694,1548,1457
3405-000,2018,5,22,10,885,650,1535,1548
3405-000,2018,5,22,11,897,705,1602,1535
3405-000,2018,5,22,12,895,621,1516,1602
3405-000,2018,5,22,13,762,657,1419,1516
3405-000,2018,5,22,14,741,713,1454,1419
3405-000,2018,5,22,15,792,787,1579,1454
3405-000,2018,5,22,16,822,725,1547,1579
3405-000,2018,5,22,17,720,814,1534,1547
3405-000,2018,5,22,18,783,919,1702,1534
3405-000,2018,5,22,19,646,740,1386,1702
3405-000,2018,5,22,20,467,760,1227,1386
3405-000,2018,5,22,21,367,642,1009,1227
3405-000,2018,5,22,22,259,426,685,1009
3405-000,2018,5,22,23,182,254,436,685
3405-000,2018,5,22,24,96,154,250,436
3405-000,2018,5,23,1,66,34,100,250
3405-000,2018,5,23,2,36,60,96,100
3405-000,2018,5,23,3,60,45,105,96
3405-000,2018,5,23,4,81,56,137,105
3405-000,2018,5,23,5,131,97,228,137
3405-000,2018,5,23,6,301,221,522,228
3405-000,2018,5,23,7,743,640,1383,522
3405-000,2018,5,23,8,1270,1563,2833,1383
3405-000,2018,5,23,9,1352,1434,2786,2833
3405-000,2018,5,23,10,1138,975,2113,2786
3405-000,2018,5,23,11,1149,1044,2193,2113
3405-000,2018,5,23,12,1148,972,2120,2193
3405-000,2018,5,23,13,913,866,1779,2120
3405-000,2018,5,23,14,1065,976,2041,1779
3405-000,2018,5,23,15,1224,1006,2230,2041
3405-000,2018,5,23,16,1232,1082,2314,2230
3405-000,2018,5,23,17,1109,1062,2171,2314
3405-000,2018,5,23,18,1305,1118,2423,2171
3405-000,2018,5,23,19,1337,1054,2391,2423
3405-000,2018,5,23,20,770,626,1396,2391
3405-000,2018,5,23,21,549,518,1067,1396
3405-000,2018,5,23,22,358,347,705,1067
3405-000,2018,5,23,23,257,218,475,705
3405-000,2018,5,23,24,131,153,284,475
3405-000,2018,5,24,1,106,115,221,284
3405-000,2018,5,24,2,61,67,128,221
3405-000,2018,5,24,3,57,62,119,128
3405-000,2018,5,24,4,63,74,137,119
3405-000,2018,5,24,5,160,113,273,137
3405-000,2018,5,24,6,314,244,558,273
3405-000,2018,5,24,7,776,629,1405,558
3405-000,2018,5,24,8,1252,1336,2588,1405
3405-000,2018,5,24,9,1398,1360,2758,2588
3405-000,2018,5,24,10,1143,1000,2143,2758
3405-000,2018,5,24,11,1182,1097,2279,2143
3405-000,2018,5,24,12,1192,1017,2209,2279
3405-000,2018,5,24,13,997,837,1834,2209
3405-000,2018,5,24,14,1033,1057,2090,1834
3405-000,2018,5,24,15,1175,1069,2244,2090
3405-000,2018,5,24,16,1209,972,2181,2244
3405-000,2018,5,24,17,1119,1046,2165,2181
3405-000,2018,5,24,18,1251,1144,2395,2165
3405-000,2018,5,24,19,1184,1081,2265,2395
3405-000,2018,5,24,20,714,715,1429,2265
3405-000,2018,5,24,21,528,638,1166,1429
3405-000,2018,5,24,22,383,440,823,1166
3405-000,2018,5,24,23,258,233,491,823
3405-000,2018,5,24,24,154,154,308,491
3405-000,2018,5,25,1,95,109,204,308
3405-000,2018,5,25,2,60,89,149,204
3405-000,2018,5,25,3,77,62,139,149
3405-000,2018,5,25,4,89,70,159,139
3405-000,2018,5,25,5,138,96,234,159
3405-000,2018,5,25,6,355,233,588,234
3405-000,2018,5,25,7,729,574,1303,588
3405-000,2018,5,25,8,1273,1398,2671,1303
3405-000,2018,5,25,9,1320,1314,2634,2671
3405-000,2018,5,25,10,1151,1036,2187,2634
3405-000,2018,5,25,11,1281,1078,2359,2187
3405-000,2018,5,25,12,1196,905,2101,2359
3405-000,2018,5,25,13,968,884,1852,2101
3405-000,2018,5,25,14,1044,1022,2066,1852
3405-000,2018,5,25,15,1208,1055,2263,2066
3405-000,2018,5,25,16,1189,1129,2318,2263
3405-000,2018,5,25,17,1189,1047,2236,2318
3405-000,2018,5,25,18,1562,1195,2757,2236
3405-000,2018,5,25,19,1458,1189,2647,2757
3405-000,2018,5,25,20,926,769,1695,2647
3405-000,2018,5,25,21,577,633,1210,1695
3405-000,2018,5,25,22,410,425,835,1210
3405-000,2018,5,25,23,248,291,539,835
3405-000,2018,5,25,24,195,180,375,539
3405-000,2018,5,26,1,87,136,223,375
3405-000,2018,5,26,2,81,73,154,223
3405-000,2018,5,26,3,53,64,117,154
3405-000,2018,5,26,4,75,79,154,117
3405-000,2018,5,26,5,138,100,238,154
3405-000,2018,5,26,6,300,192,492,238
3405-000,2018,5,26,7,619,397,1016,492
3405-000,2018,5,26,8,849,680,1529,1016
3405-000,2018,5,26,9,977,731,1708,1529
3405-000,2018,5,26,10,979,854,1833,1708
3405-000,2018,5,26,11,965,957,1922,1833
3405-000,2018,5,26,12,931,849,1780,1922
3405-000,2018,5,26,13,869,894,1763,1780
3405-000,2018,5,26,14,736,827,1563,1763
3405-000,2018,5,26,15,901,764,1665,1563
3405-000,2018,5,26,16,867,741,1608,1665
3405-000,2018,5,26,17,865,813,1678,1608
3405-000,2018,5,26,18,890,934,1824,1678
3405-000,2018,5,26,19,698,692,1390,1824
3405-000,2018,5,26,20,428,585,1013,1390
3405-000,2018,5,26,21,318,418,736,1013
3405-000,2018,5,26,22,273,314,587,736
3405-000,2018,5,26,23,204,239,443,587
3405-000,2018,5,26,24,131,162,293,443
3405-000,2018,5,27,1,69,86,155,293
3405-000,2018,5,27,2,61,54,115,155
3405-000,2018,5,27,3,34,49,83,115
3405-000,2018,5,27,4,30,34,64,83
3405-000,2018,5,27,5,67,47,114,64
3405-000,2018,5,27,6,170,99,269,114
3405-000,2018,5,27,7,291,213,504,269
3405-000,2018,5,27,8,479,269,748,504
3405-000,2018,5,27,9,514,382,896,748
3405-000,2018,5,27,10,610,451,1061,896
3405-000,2018,5,27,11,634,508,1142,1061
3405-000,2018,5,27,12,647,505,1152,1142
3405-000,2018,5,27,13,519,535,1054,1152
3405-000,2018,5,27,14,615,566,1181,1054
3405-000,2018,5,27,15,648,634,1282,1181
3405-000,2018,5,27,16,666,651,1317,1282
3405-000,2018,5,27,17,658,704,1362,1317
3405-000,2018,5,27,18,652,748,1400,1362
3405-000,2018,5,27,19,472,749,1221,1400
3405-000,2018,5,27,20,405,590,995,1221
3405-000,2018,5,27,21,337,443,780,995
3405-000,2018,5,27,22,246,391,637,780
3405-000,2018,5,27,23,206,294,500,637
3405-000,2018,5,27,24,113,180,293,500
3405-000,2018,5,28,1,75,108,183,293
3405-000,2018,5,28,2,41,72,113,183
3405-000,2018,5,28,3,48,73,121,113
3405-000,2018,5,28,4,53,60,113,121
3405-000,2018,5,28,5,129,122,251,113
3405-000,2018,5,28,6,396,269,665,251
3405-000,2018,5,28,7,817,767,1584,665
3405-000,2018,5,28,8,1307,1628,2935,1584
3405-000,2018,5,28,9,1368,1388,2756,2935
3405-000,2018,5,28,10,1172,1007,2179,2756
3405-000,2018,5,28,11,1208,1025,2233,2179
3405-000,2018,5,28,12,1078,1012,2090,2233
3405-000,2018,5,28,13,936,816,1752,2090
3405-000,2018,5,28,14,1038,953,1991,1752
3405-000,2018,5,28,15,1219,1110,2329,1991
3405-000,2018,5,28,16,1137,1016,2153,2329
3405-000,2018,5,28,17,1109,988,2097,2153
3405-000,2018,5,28,18,1202,1167,2369,2097
3405-000,2018,5,28,19,1153,1088,2241,2369
3405-000,2018,5,28,20,726,791,1517,2241
3405-000,2018,5,28,21,500,665,1165,1517
3405-000,2018,5,28,22,348,425,773,1165
3405-000,2018,5,28,23,232,188,420,773
3405-000,2018,5,28,24,159,146,305,420
3405-000,2018,5,29,1,100,114,214,305
3405-000,2018,5,29,2,62,66,128,214
3405-000,2018,5,29,3,56,77,133,128
3405-000,2018,5,29,4,70,73,143,133
3405-000,2018,5,29,5,129,120,249,143
3405-000,2018,5,29,6,337,232,569,249
3405-000,2018,5,29,7,793,629,1422,569
3405-000,2018,5,29,8,1290,1361,2651,1422
3405-000,2018,5,29,9,1424,1387,2811,2651
3405-000,2018,5,29,10,1168,1094,2262,2811
3405-000,2018,5,29,11,1188,1074,2262,2262
3405-000,2018,5,29,12,1173,1044,2217,2262
3405-000,2018,5,29,13,989,842,1831,2217
3405-000,2018,5,29,14,1049,1046,2095,1831
3405-000,2018,5,29,15,1177,1044,2221,2095
3405-000,2018,5,29,16,1226,1039,2265,2221
3405-000,2018,5,29,17,1136,1067,2203,2265
3405-000,2018,5,29,18,1278,1151,2429,2203
3405-000,2018,5,29,19,1064,1155,2219,2429
3405-000,2018,5,29,20,693,695,1388,2219
3405-000,2018,5,29,21,530,614,1144,1388
3405-000,2018,5,29,22,333,425,758,1144
3405-000,2018,5,29,23,276,230,506,758
3405-000,2018,5,29,24,134,158,292,506
3405-000,2018,5,30,1,95,94,189,292
3405-000,2018,5,30,2,60,83,143,189
3405-000,2018,5,30,3,50,59,109,143
3405-000,2018,5,30,4,62,69,131,109
3405-000,2018,5,30,5,102,98,200,131
3405-000,2018,5,30,6,323,203,526,200
3405-000,2018,5,30,7,683,574,1257,526
3405-000,2018,5,30,8,1301,1330,2631,1257
3405-000,2018,5,30,9,1460,1414,2874,2631
3405-000,2018,5,30,10,1199,979,2178,2874
3405-000,2018,5,30,11,1141,1074,2215,2178
3405-000,2018,5,30,12,1136,991,2127,2215
3405-000,2018,5,30,13,896,876,1772,2127
3405-000,2018,5,30,14,1063,1039,2102,1772
3405-000,2018,5,30,15,1194,1066,2260,2102
3405-000,2018,5,30,16,1193,1046,2239,2260
3405-000,2018,5,30,17,1115,1004,2119,2239
3405-000,2018,5,30,18,1403,1135,2538,2119
3405-000,2018,5,30,19,1371,1095,2466,2538
3405-000,2018,5,30,20,700,721,1421,2466
3405-000,2018,5,30,21,514,548,1062,1421
3405-000,2018,5,30,22,386,378,764,1062
3405-000,2018,5,30,23,242,240,482,764
3405-000,2018,5,30,24,180,148,328,482
3405-000,2018,5,31,1,90,121,211,328
3405-000,2018,5,31,2,53,80,133,211
3405-000,2018,5,31,3,56,55,111,133
3405-000,2018,5,31,4,66,70,136,111
3405-000,2018,5,31,5,106,124,230,136
3405-000,2018,5,31,6,320,239,559,230
3405-000,2018,5,31,7,738,611,1349,559
3405-000,2018,5,31,8,1296,1393,2689,1349
3405-000,2018,5,31,9,1458,1374,2832,2689
3405-000,2018,5,31,10,1131,997,2128,2832
3405-000,2018,5,31,11,1196,1055,2251,2128
3405-000,2018,5,31,12,1056,1015,2071,2251
3405-000,2018,5,31,13,840,834,1674,2071
3405-000,2018,5,31,14,1051,996,2047,1674
3405-000,2018,5,31,15,1169,809,1978,2047
3405-000,2018,5,31,16,1161,930,2091,1978
3405-000,2018,5,31,17,1148,1041,2189,2091
3405-000,2018,5,31,18,1331,1155,2486,2189
3405-000,2018,5,31,19,1267,1076,2343,2486
3405-000,2018,5,31,20,775,720,1495,2343
3405-000,2018,5,31,21,598,596,1194,1495
3405-000,2018,5,31,22,405,455,860,1194
3405-000,2018,5,31,23,274,237,511,860
3405-000,2018,5,31,24,145,162,307,511
3405-000,2018,6,1,1,117,124,241,307
3405-000,2018,6,1,2,55,80,135,241
3405-000,2018,6,1,3,54,55,109,135
3405-000,2018,6,1,4,75,76,151,109
3405-000,2018,6,1,5,121,102,223,151
3405-000,2018,6,1,6,315,236,551,223
3405-000,2018,6,1,7,749,577,1326,551
3405-000,2018,6,1,8,1267,1364,2631,1326
3405-000,2018,6,1,9,1472,1262,2734,2631
3405-000,2018,6,1,10,1127,1024,2151,2734
3405-000,2018,6,1,11,1181,1027,2208,2151
3405-000,2018,6,1,12,1078,959,2037,2208
3405-000,2018,6,1,13,995,835,1830,2037
3405-000,2018,6,1,14,1104,981,2085,1830
3405-000,2018,6,1,15,1211,1053,2264,2085
3405-000,2018,6,1,16,1190,1141,2331,2264
3405-000,2018,6,1,17,1257,1098,2355,2331
3405-000,2018,6,1,18,1632,1254,2886,2355
3405-000,2018,6,1,19,1739,1233,2972,2886
3405-000,2018,6,1,20,1031,862,1893,2972
3405-000,2018,6,1,21,685,609,1294,1893
3405-000,2018,6,1,22,445,435,880,1294
3405-000,2018,6,1,23,333,249,582,880
3405-000,2018,6,1,24,159,174,333,582
3405-000,2018,6,2,1,101,114,215,333
3405-000,2018,6,2,2,64,84,148,215
3405-000,2018,6,2,3,61,56,117,148
3405-000,2018,6,2,4,73,66,139,117
3405-000,2018,6,2,5,118,107,225,139
3405-000,2018,6,2,6,307,205,512,225
3405-000,2018,6,2,7,647,418,1065,512
3405-000,2018,6,2,8,845,628,1473,1065
3405-000,2018,6,2,9,931,740,1671,1473
3405-000,2018,6,2,10,951,786,1737,1671
3405-000,2018,6,2,11,1018,794,1812,1737
3405-000,2018,6,2,12,967,753,1720,1812
3405-000,2018,6,2,13,887,737,1624,1720
3405-000,2018,6,2,14,802,741,1543,1624
3405-000,2018,6,2,15,820,770,1590,1543
3405-000,2018,6,2,16,885,796,1681,1590
3405-000,2018,6,2,17,914,709,1623,1681
3405-000,2018,6,2,18,1018,934,1952,1623
3405-000,2018,6,2,19,801,780,1581,1952
3405-000,2018,6,2,20,481,548,1029,1581
3405-000,2018,6,2,21,393,404,797,1029
3405-000,2018,6,2,22,302,320,622,797
3405-000,2018,6,2,23,223,212,435,622
3405-000,2018,6,2,24,140,207,347,435
3405-000,2018,6,3,1,86,111,197,347
3405-000,2018,6,3,2,64,59,123,197
3405-000,2018,6,3,3,41,44,85,123
3405-000,2018,6,3,4,50,45,95,85
3405-000,2018,6,3,5,95,43,138,95
3405-000,2018,6,3,6,154,98,252,138
3405-000,2018,6,3,7,294,214,508,252
3405-000,2018,6,3,8,381,301,682,508
3405-000,2018,6,3,9,439,380,819,682
3405-000,2018,6,3,10,588,450,1038,819
3405-000,2018,6,3,11,604,513,1117,1038
3405-000,2018,6,3,12,617,539,1156,1117
3405-000,2018,6,3,13,559,508,1067,1156
3405-000,2018,6,3,14,592,584,1176,1067
3405-000,2018,6,3,15,639,701,1340,1176
3405-000,2018,6,3,16,728,608,1336,1340
3405-000,2018,6,3,17,697,644,1341,1336
3405-000,2018,6,3,18,677,708,1385,1341
3405-000,2018,6,3,19,592,628,1220,1385
3405-000,2018,6,3,20,424,573,997,1220
3405-000,2018,6,3,21,426,492,918,997
3405-000,2018,6,3,22,329,422,751,918
3405-000,2018,6,3,23,234,311,545,751
3405-000,2018,6,3,24,118,204,322,545
3405-000,2018,6,4,1,67,96,163,322
3405-000,2018,6,4,2,43,56,99,163
3405-000,2018,6,4,3,42,44,86,99
3405-000,2018,6,4,4,57,76,133,86
3405-000,2018,6,4,5,124,95,219,133
3405-000,2018,6,4,6,353,264,617,219
3405-000,2018,6,4,7,842,728,1570,617
3405-000,2018,6,4,8,1354,1657,3011,1570
3405-000,2018,6,4,9,1452,1453,2905,3011
3405-000,2018,6,4,10,1204,1018,2222,2905
3405-000,2018,6,4,11,1106,1006,2112,2222
3405-000,2018,6,4,12,1109,951,2060,2112
3405-000,2018,6,4,13,911,839,1750,2060
3405-000,2018,6,4,14,1009,971,1980,1750
3405-000,2018,6,4,15,1264,1125,2389,1980
3405-000,2018,6,4,16,1192,1035,2227,2389
3405-000,2018,6,4,17,1165,977,2142,2227
3405-000,2018,6,4,18,1322,1123,2445,2142
3405-000,2018,6,4,19,1262,1092,2354,2445
3405-000,2018,6,4,20,700,751,1451,2354
3405-000,2018,6,4,21,551,592,1143,1451
3405-000,2018,6,4,22,400,440,840,1143
3405-000,2018,6,4,23,236,214,450,840
3405-000,2018,6,4,24,139,130,269,450
3405-000,2018,6,5,1,87,90,177,269
3405-000,2018,6,5,2,51,69,120,177
3405-000,2018,6,5,3,52,65,117,120
3405-000,2018,6,5,4,67,73,140,117
3405-000,2018,6,5,5,105,111,216,140
3405-000,2018,6,5,6,365,240,605,216
3405-000,2018,6,5,7,736,599,1335,605
3405-000,2018,6,5,8,1314,1398,2712,1335
3405-000,2018,6,5,9,1459,1333,2792,2712
3405-000,2018,6,5,10,1188,1003,2191,2792
3405-000,2018,6,5,11,1229,1026,2255,2191
3405-000,2018,6,5,12,1108,959,2067,2255
3405-000,2018,6,5,13,986,893,1879,2067
3405-000,2018,6,5,14,1067,1107,2174,1879
3405-000,2018,6,5,15,1310,1086,2396,2174
3405-000,2018,6,5,16,1298,1097,2395,2396
3405-000,2018,6,5,17,1210,1110,2320,2395
3405-000,2018,6,5,18,1539,1146,2685,2320
3405-000,2018,6,5,19,1564,1151,2715,2685
3405-000,2018,6,5,20,911,827,1738,2715
3405-000,2018,6,5,21,665,692,1357,1738
3405-000,2018,6,5,22,446,428,874,1357
3405-000,2018,6,5,23,297,266,563,874
3405-000,2018,6,5,24,186,180,366,563
3405-000,2018,6,6,1,103,105,208,366
3405-000,2018,6,6,2,78,85,163,208
3405-000,2018,6,6,3,56,53,109,163
3405-000,2018,6,6,4,74,83,157,109
3405-000,2018,6,6,5,113,108,221,157
3405-000,2018,6,6,6,317,201,518,221
3405-000,2018,6,6,7,581,370,951,518
3405-000,2018,6,6,8,851,656,1507,951
3405-000,2018,6,6,9,879,706,1585,1507
3405-000,2018,6,6,10,816,678,1494,1585
3405-000,2018,6,6,11,895,747,1642,1494
3405-000,2018,6,6,12,838,712,1550,1642
3405-000,2018,6,6,13,725,639,1364,1550
3405-000,2018,6,6,14,739,692,1431,1364
3405-000,2018,6,6,15,825,723,1548,1431
3405-000,2018,6,6,16,776,852,1628,1548
3405-000,2018,6,6,17,834,753,1587,1628
3405-000,2018,6,6,18,846,900,1746,1587
3405-000,2018,6,6,19,689,715,1404,1746
3405-000,2018,6,6,20,473,530,1003,1404
3405-000,2018,6,6,21,363,437,800,1003
3405-000,2018,6,6,22,299,341,640,800
3405-000,2018,6,6,23,232,232,464,640
3405-000,2018,6,6,24,117,137,254,464
3405-000,2018,6,7,1,72,86,158,254
3405-000,2018,6,7,2,51,58,109,158
3405-000,2018,6,7,3,48,48,96,109
3405-000,2018,6,7,4,52,63,115,96
3405-000,2018,6,7,5,136,107,243,115
3405-000,2018,6,7,6,323,233,556,243
3405-000,2018,6,7,7,717,653,1370,556
3405-000,2018,6,7,8,1342,1543,2885,1370
3405-000,2018,6,7,9,1453,1442,2895,2885
3405-000,2018,6,7,10,1262,1034,2296,2895
3405-000,2018,6,7,11,1235,1036,2271,2296
3405-000,2018,6,7,12,1133,1020,2153,2271
3405-000,2018,6,7,13,934,835,1769,2153
3405-000,2018,6,7,14,1137,1008,2145,1769
3405-000,2018,6,7,15,1196,1173,2369,2145
3405-000,2018,6,7,16,1232,1050,2282,2369
3405-000,2018,6,7,17,1163,1105,2268,2282
3405-000,2018,6,7,18,1471,1127,2598,2268
3405-000,2018,6,7,19,1259,1036,2295,2598
3405-000,2018,6,7,20,819,736,1555,2295
3405-000,2018,6,7,21,582,611,1193,1555
3405-000,2018,6,7,22,395,432,827,1193
3405-000,2018,6,7,23,278,254,532,827
3405-000,2018,6,7,24,153,140,293,532
3405-000,2018,6,8,1,105,111,216,293
3405-000,2018,6,8,2,61,80,141,216
3405-000,2018,6,8,3,52,58,110,141
3405-000,2018,6,8,4,78,81,159,110
3405-000,2018,6,8,5,128,131,259,159
3405-000,2018,6,8,6,333,239,572,259
3405-000,2018,6,8,7,726,596,1322,572
3405-000,2018,6,8,8,1314,1373,2687,1322
3405-000,2018,6,8,9,1455,1406,2861,2687
3405-000,2018,6,8,10,1197,1016,2213,2861
3405-000,2018,6,8,11,1177,1053,2230,2213
3405-000,2018,6,8,12,1160,1029,2189,2230
3405-000,2018,6,8,13,1017,894,1911,2189
3405-000,2018,6,8,14,1124,1065,2189,1911
3405-000,2018,6,8,15,1221,1117,2338,2189
3405-000,2018,6,8,16,1248,1159,2407,2338
3405-000,2018,6,8,17,1219,1079,2298,2407
3405-000,2018,6,8,18,1756,1202,2958,2298
3405-000,2018,6,8,19,1619,1264,2883,2958
3405-000,2018,6,8,20,1004,1261,2265,2883
3405-000,2018,6,8,21,715,575,1290,2265
3405-000,2018,6,8,22,478,466,944,1290
3405-000,2018,6,8,23,311,250,561,944
3405-000,2018,6,8,24,188,176,364,561
3405-000,2018,6,9,1,86,112,198,364
3405-000,2018,6,9,2,65,81,146,198
3405-000,2018,6,9,3,52,58,110,146
3405-000,2018,6,9,4,66,75,141,110
3405-000,2018,6,9,5,134,100,234,141
3405-000,2018,6,9,6,312,189,501,234
3405-000,2018,6,9,7,576,420,996,501
3405-000,2018,6,9,8,830,633,1463,996
3405-000,2018,6,9,9,908,754,1662,1463
3405-000,2018,6,9,10,904,795,1699,1662
3405-000,2018,6,9,11,1011,830,1841,1699
3405-000,2018,6,9,12,944,831,1775,1841
3405-000,2018,6,9,13,787,737,1524,1775
3405-000,2018,6,9,14,804,726,1530,1524
3405-000,2018,6,9,15,871,715,1586,1530
3405-000,2018,6,9,16,900,744,1644,1586
3405-000,2018,6,9,17,912,768,1680,1644
3405-000,2018,6,9,18,955,933,1888,1680
3405-000,2018,6,9,19,780,700,1480,1888
3405-000,2018,6,9,20,509,480,989,1480
3405-000,2018,6,9,21,394,368,762,989
3405-000,2018,6,9,22,271,310,581,762
3405-000,2018,6,9,23,201,188,389,581
3405-000,2018,6,9,24,116,167,283,389
3405-000,2018,6,10,1,95,102,197,283
3405-000,2018,6,10,2,74,67,141,197
3405-000,2018,6,10,3,33,47,80,141
3405-000,2018,6,10,4,42,38,80,80
3405-000,2018,6,10,5,64,44,108,80
3405-000,2018,6,10,6,164,95,259,108
3405-000,2018,6,10,7,279,181,460,259
3405-000,2018,6,10,8,371,268,639,460
3405-000,2018,6,10,9,495,342,837,639
3405-000,2018,6,10,10,537,414,951,837
3405-000,2018,6,10,11,617,455,1072,951
3405-000,2018,6,10,12,612,479,1091,1072
3405-000,2018,6,10,13,576,541,1117,1091
3405-000,2018,6,10,14,620,584,1204,1117
3405-000,2018,6,10,15,621,608,1229,1204
3405-000,2018,6,10,16,691,611,1302,1229
3405-000,2018,6,10,17,681,705,1386,1302
3405-000,2018,6,10,18,646,693,1339,1386
3405-000,2018,6,10,19,531,651,1182,1339
3405-000,2018,6,10,20,438,520,958,1182
3405-000,2018,6,10,21,379,453,832,958
3405-000,2018,6,10,22,304,408,712,832
3405-000,2018,6,10,23,217,332,549,712
3405-000,2018,6,10,24,133,181,314,549
3405-000,2018,6,11,1,65,120,185,314
3405-000,2018,6,11,2,45,60,105,185
3405-000,2018,6,11,3,37,45,82,105
3405-000,2018,6,11,4,59,68,127,82
3405-000,2018,6,11,5,142,143,285,127
3405-000,2018,6,11,6,391,312,703,285
3405-000,2018,6,11,7,801,738,1539,703
3405-000,2018,6,11,8,1373,1614,2987,1539
3405-000,2018,6,11,9,1432,1484,2916,2987
3405-000,2018,6,11,10,1099,993,2092,2916
3405-000,2018,6,11,11,1136,1034,2170,2092
3405-000,2018,6,11,12,1130,1000,2130,2170
3405-000,2018,6,11,13,964,855,1819,2130
3405-000,2018,6,11,14,1048,1004,2052,1819
3405-000,2018,6,11,15,1150,1102,2252,2052
3405-000,2018,6,11,16,1174,1143,2317,2252
3405-000,2018,6,11,17,1156,1003,2159,2317
3405-000,2018,6,11,18,1325,1084,2409,2159
3405-000,2018,6,11,19,1142,1071,2213,2409
3405-000,2018,6,11,20,723,721,1444,2213
3405-000,2018,6,11,21,588,548,1136,1444
3405-000,2018,6,11,22,377,436,813,1136
3405-000,2018,6,11,23,227,197,424,813
3405-000,2018,6,11,24,133,171,304,424
3405-000,2018,6,12,1,84,125,209,304
3405-000,2018,6,12,2,46,82,128,209
3405-000,2018,6,12,3,54,62,116,128
3405-000,2018,6,12,4,64,80,144,116
3405-000,2018,6,12,5,137,116,253,144
3405-000,2018,6,12,6,338,248,586,253
3405-000,2018,6,12,7,784,569,1353,586
3405-000,2018,6,12,8,1287,1379,2666,1353
3405-000,2018,6,12,9,1430,1372,2802,2666
3405-000,2018,6,12,10,1224,1018,2242,2802
3405-000,2018,6,12,11,1261,1120,2381,2242
3405-000,2018,6,12,12,1138,974,2112,2381
3405-000,2018,6,12,13,989,903,1892,2112
3405-000,2018,6,12,14,1167,1087,2254,1892
3405-000,2018,6,12,15,1205,1110,2315,2254
3405-000,2018,6,12,16,1185,1091,2276,2315
3405-000,2018,6,12,17,1166,1065,2231,2276
3405-000,2018,6,12,18,1567,1169,2736,2231
3405-000,2018,6,12,19,1466,1164,2630,2736
3405-000,2018,6,12,20,866,819,1685,2630
3405-000,2018,6,12,21,653,640,1293,1685
3405-000,2018,6,12,22,410,461,871,1293
3405-000,2018,6,12,23,290,246,536,871
3405-000,2018,6,12,24,183,178,361,536
3405-000,2018,6,13,1,99,122,221,361
3405-000,2018,6,13,2,84,84,168,221
3405-000,2018,6,13,3,45,62,107,168
3405-000,2018,6,13,4,54,56,110,107
3405-000,2018,6,13,5,135,104,239,110
3405-000,2018,6,13,6,310,176,486,239
3405-000,2018,6,13,7,571,400,971,486
3405-000,2018,6,13,8,866,657,1523,971
3405-000,2018,6,13,9,902,774,1676,1523
3405-000,2018,6,13,10,999,843,1842,1676
3405-000,2018,6,13,11,928,795,1723,1842
3405-000,2018,6,13,12,906,730,1636,1723
3405-000,2018,6,13,13,778,704,1482,1636
3405-000,2018,6,13,14,775,726,1501,1482
3405-000,2018,6,13,15,782,729,1511,1501
3405-000,2018,6,13,16,877,829,1706,1511
3405-000,2018,6,13,17,870,810,1680,1706
3405-000,2018,6,13,18,921,938,1859,1680
3405-000,2018,6,13,19,615,693,1308,1859
3405-000,2018,6,13,20,464,508,972,1308
3405-000,2018,6,13,21,375,402,777,972
3405-000,2018,6,13,22,308,338,646,777
3405-000,2018,6,13,23,199,210,409,646
3405-000,2018,6,13,24,117,138,255,409
3405-000,2018,6,14,1,86,97,183,255
3405-000,2018,6,14,2,42,47,89,183
3405-000,2018,6,14,3,42,28,70,89
3405-000,2018,6,14,4,68,68,136,70
3405-000,2018,6,14,5,116,115,231,136
3405-000,2018,6,14,6,320,258,578,231
3405-000,2018,6,14,7,767,619,1386,578
3405-000,2018,6,14,8,1321,1386,2707,1386
3405-000,2018,6,14,9,1478,1452,2930,2707
3405-000,2018,6,14,10,1204,1020,2224,2930
3405-000,2018,6,14,11,1194,1030,2224,2224
3405-000,2018,6,14,12,1222,1025,2247,2224
3405-000,2018,6,14,13,969,891,1860,2247
3405-000,2018,6,14,14,1090,1093,2183,1860
3405-000,2018,6,14,15,1230,1049,2279,2183
3405-000,2018,6,14,16,1254,986,2240,2279
3405-000,2018,6,14,17,1219,1055,2274,2240
3405-000,2018,6,14,18,1350,1115,2465,2274
3405-000,2018,6,14,19,1238,1113,2351,2465
3405-000,2018,6,14,20,767,767,1534,2351
3405-000,2018,6,14,21,589,609,1198,1534
3405-000,2018,6,14,22,368,431,799,1198
3405-000,2018,6,14,23,251,240,491,799
3405-000,2018,6,14,24,164,142,306,491
3405-000,2018,6,15,1,105,127,232,306
3405-000,2018,6,15,2,52,96,148,232
3405-000,2018,6,15,3,55,71,126,148
3405-000,2018,6,15,4,63,87,150,126
3405-000,2018,6,15,5,134,118,252,150
3405-000,2018,6,15,6,324,239,563,252
3405-000,2018,6,15,7,696,594,1290,563
3405-000,2018,6,15,8,1238,1307,2545,1290
3405-000,2018,6,15,9,1454,1392,2846,2545
3405-000,2018,6,15,10,1201,1063,2264,2846
3405-000,2018,6,15,11,1218,1059,2277,2264
3405-000,2018,6,15,12,1120,1015,2135,2277
3405-000,2018,6,15,13,1032,895,1927,2135
3405-000,2018,6,15,14,1119,1048,2167,1927
3405-000,2018,6,15,15,1256,1107,2363,2167
3405-000,2018,6,15,16,1215,1098,2313,2363
3405-000,2018,6,15,17,1331,1023,2354,2313
3405-000,2018,6,15,18,1552,1254,2806,2354
3405-000,2018,6,15,19,1806,1354,3160,2806
3405-000,2018,6,15,20,1050,927,1977,3160
3405-000,2018,6,15,21,709,727,1436,1977
3405-000,2018,6,15,22,477,444,921,1436
3405-000,2018,6,15,23,320,259,579,921
3405-000,2018,6,15,24,190,183,373,579
3405-000,2018,6,16,1,102,123,225,373
3405-000,2018,6,16,2,90,94,184,225
3405-000,2018,6,16,3,66,68,134,184
3405-000,2018,6,16,4,69,62,131,134
3405-000,2018,6,16,5,146,102,248,131
3405-000,2018,6,16,6,329,202,531,248
3405-000,2018,6,16,7,561,387,948,531
3405-000,2018,6,16,8,802,591,1393,948
3405-000,2018,6,16,9,917,743,1660,1393
3405-000,2018,6,16,10,979,810,1789,1660
3405-000,2018,6,16,11,932,817,1749,1789
3405-000,2018,6,16,12,933,806,1739,1749
3405-000,2018,6,16,13,861,720,1581,1739
3405-000,2018,6,16,14,795,798,1593,1581
3405-000,2018,6,16,15,849,697,1546,1593
3405-000,2018,6,16,16,910,755,1665,1546
3405-000,2018,6,16,17,906,733,1639,1665
3405-000,2018,6,16,18,965,875,1840,1639
3405-000,2018,6,16,19,765,709,1474,1840
3405-000,2018,6,16,20,533,544,1077,1474
3405-000,2018,6,16,21,357,408,765,1077
3405-000,2018,6,16,22,302,319,621,765
3405-000,2018,6,16,23,246,243,489,621
3405-000,2018,6,16,24,133,201,334,489
3405-000,2018,6,17,1,83,96,179,334
3405-000,2018,6,17,2,62,70,132,179
3405-000,2018,6,17,3,48,47,95,132
3405-000,2018,6,17,4,38,47,85,95
3405-000,2018,6,17,5,88,64,152,85
3405-000,2018,6,17,6,175,89,264,152
3405-000,2018,6,17,7,262,190,452,264
3405-000,2018,6,17,8,361,294,655,452
3405-000,2018,6,17,9,501,322,823,655
3405-000,2018,6,17,10,491,414,905,823
3405-000,2018,6,17,11,560,460,1020,905
3405-000,2018,6,17,12,595,503,1098,1020
3405-000,2018,6,17,13,482,541,1023,1098
3405-000,2018,6,17,14,673,591,1264,1023
3405-000,2018,6,17,15,730,577,1307,1264
3405-000,2018,6,17,16,688,622,1310,1307
3405-000,2018,6,17,17,636,702,1338,1310
3405-000,2018,6,17,18,701,691,1392,1338
3405-000,2018,6,17,19,628,671,1299,1392
3405-000,2018,6,17,20,545,532,1077,1299
3405-000,2018,6,17,21,419,469,888,1077
3405-000,2018,6,17,22,301,397,698,888
3405-000,2018,6,17,23,213,319,532,698
3405-000,2018,6,17,24,136,210,346,532
3405-000,2018,6,18,1,72,128,200,346
3405-000,2018,6,18,2,33,62,95,200
3405-000,2018,6,18,3,45,43,88,95
3405-000,2018,6,18,4,62,64,126,88
3405-000,2018,6,18,5,144,102,246,126
3405-000,2018,6,18,6,379,266,645,246
3405-000,2018,6,18,7,810,733,1543,645
3405-000,2018,6,18,8,1344,1589,2933,1543
3405-000,2018,6,18,9,1511,1483,2994,2933
3405-000,2018,6,18,10,1097,939,2036,2994
3405-000,2018,6,18,11,1145,1045,2190,2036
3405-000,2018,6,18,12,1015,1036,2051,2190
3405-000,2018,6,18,13,857,1243,2100,2051
3405-000,2018,6,18,14,1043,981,2024,2100
3405-000,2018,6,18,15,1161,1117,2278,2024
3405-000,2018,6,18,16,1156,1048,2204,2278
3405-000,2018,6,18,17,1152,1044,2196,2204
3405-000,2018,6,18,18,1247,1075,2322,2196
3405-000,2018,6,18,19,1211,1168,2379,2322
3405-000,2018,6,18,20,825,728,1553,2379
3405-000,2018,6,18,21,551,649,1200,1553
3405-000,2018,6,18,22,277,331,608,1200
3405-000,2018,6,18,23,176,163,339,608
3405-000,2018,6,18,24,151,125,276,339
3405-000,2018,6,19,1,85,111,196,276
3405-000,2018,6,19,2,50,66,116,196
3405-000,2018,6,19,3,38,45,83,116
3405-000,2018,6,19,4,75,72,147,83
3405-000,2018,6,19,5,127,114,241,147
3405-000,2018,6,19,6,343,241,584,241
3405-000,2018,6,19,7,745,579,1324,584
3405-000,2018,6,19,8,1256,1292,2548,1324
3405-000,2018,6,19,9,1455,1414,2869,2548
3405-000,2018,6,19,10,1200,979,2179,2869
3405-000,2018,6,19,11,1215,1088,2303,2179
3405-000,2018,6,19,12,1040,1001,2041,2303
3405-000,2018,6,19,13,807,830,1637,2041
3405-000,2018,6,19,14,1016,978,1994,1637
3405-000,2018,6,19,15,1187,1035,2222,1994
3405-000,2018,6,19,16,1146,1072,2218,2222
3405-000,2018,6,19,17,1095,981,2076,2218
3405-000,2018,6,19,18,1283,1130,2413,2076
3405-000,2018,6,19,19,1150,1069,2219,2413
3405-000,2018,6,19,20,761,721,1482,2219
3405-000,2018,6,19,21,506,622,1128,1482
3405-000,2018,6,19,22,397,441,838,1128
3405-000,2018,6,19,23,261,208,469,838
3405-000,2018,6,19,24,135,158,293,469
3405-000,2018,6,20,1,99,98,197,293
3405-000,2018,6,20,2,62,83,145,197
3405-000,2018,6,20,3,48,49,97,145
3405-000,2018,6,20,4,72,64,136,97
3405-000,2018,6,20,5,135,101,236,136
3405-000,2018,6,20,6,324,246,570,236
3405-000,2018,6,20,7,745,567,1312,570
3405-000,2018,6,20,8,1336,1392,2728,1312
3405-000,2018,6,20,9,1452,1365,2817,2728
3405-000,2018,6,20,10,1167,986,2153,2817
3405-000,2018,6,20,11,1228,1043,2271,2153
3405-000,2018,6,20,12,1041,1008,2049,2271
3405-000,2018,6,20,13,924,846,1770,2049
3405-000,2018,6,20,14,1057,1013,2070,1770
3405-000,2018,6,20,15,1190,1038,2228,2070
3405-000,2018,6,20,16,1223,1036,2259,2228
3405-000,2018,6,20,17,1155,1018,2173,2259
3405-000,2018,6,20,18,1449,1176,2625,2173
3405-000,2018,6,20,19,1391,1185,2576,2625
3405-000,2018,6,20,20,732,761,1493,2576
3405-000,2018,6,20,21,507,602,1109,1493
3405-000,2018,6,20,22,367,398,765,1109
3405-000,2018,6,20,23,249,243,492,765
3405-000,2018,6,20,24,150,205,355,492
3405-000,2018,6,21,1,83,113,196,355
3405-000,2018,6,21,2,64,85,149,196
3405-000,2018,6,21,3,69,62,131,149
3405-000,2018,6,21,4,72,71,143,131
3405-000,2018,6,21,5,138,110,248,143
3405-000,2018,6,21,6,335,245,580,248
3405-000,2018,6,21,7,713,570,1283,580
3405-000,2018,6,21,8,1299,1339,2638,1283
3405-000,2018,6,21,9,1489,1430,2919,2638
3405-000,2018,6,21,10,1209,1078,2287,2919
3405-000,2018,6,21,11,1198,1052,2250,2287
3405-000,2018,6,21,12,1118,1018,2136,2250
3405-000,2018,6,21,13,960,832,1792,2136
3405-000,2018,6,21,14,1062,1014,2076,1792
3405-000,2018,6,21,15,1192,1022,2214,2076
3405-000,2018,6,21,16,1166,1080,2246,2214
3405-000,2018,6,21,17,1165,1065,2230,2246
3405-000,2018,6,21,18,1271,1130,2401,2230
3405-000,2018,6,21,19,1263,1110,2373,2401
3405-000,2018,6,21,20,723,743,1466,2373
3405-000,2018,6,21,21,582,657,1239,1466
3405-000,2018,6,21,22,435,441,876,1239
3405-000,2018,6,21,23,282,229,511,876
3405-000,2018,6,21,24,157,182,339,511
3405-000,2018,6,22,1,105,126,231,339
3405-000,2018,6,22,2,76,77,153,231
3405-000,2018,6,22,3,63,59,122,153
3405-000,2018,6,22,4,74,67,141,122
3405-000,2018,6,22,5,124,113,237,141
3405-000,2018,6,22,6,359,249,608,237
3405-000,2018,6,22,7,711,560,1271,608
3405-000,2018,6,22,8,1316,1288,2604,1271
3405-000,2018,6,22,9,1402,1334,2736,2604
3405-000,2018,6,22,10,1215,1059,2274,2736
3405-000,2018,6,22,11,1243,1031,2274,2274
3405-000,2018,6,22,12,1191,948,2139,2274
3405-000,2018,6,22,13,899,842,1741,2139
3405-000,2018,6,22,14,1089,1001,2090,1741
3405-000,2018,6,22,15,1215,1085,2300,2090
3405-000,2018,6,22,16,1295,1103,2398,2300
3405-000,2018,6,22,17,1252,1113,2365,2398
3405-000,2018,6,22,18,1724,1291,3015,2365
3405-000,2018,6,22,19,1700,1279,2979,3015
3405-000,2018,6,22,20,975,845,1820,2979
3405-000,2018,6,22,21,670,723,1393,1820
3405-000,2018,6,22,22,450,472,922,1393
3405-000,2018,6,22,23,339,244,583,922
3405-000,2018,6,22,24,177,174,351,583
3405-000,2018,6,23,1,110,133,243,351
3405-000,2018,6,23,2,72,80,152,243
3405-000,2018,6,23,3,66,50,116,152
3405-000,2018,6,23,4,74,82,156,116
3405-000,2018,6,23,5,138,113,251,156
3405-000,2018,6,23,6,342,206,548,251
3405-000,2018,6,23,7,622,431,1053,548
3405-000,2018,6,23,8,859,626,1485,1053
3405-000,2018,6,23,9,995,765,1760,1485
3405-000,2018,6,23,10,1031,747,1778,1760
3405-000,2018,6,23,11,1088,815,1903,1778
3405-000,2018,6,23,12,941,802,1743,1903
3405-000,2018,6,23,13,910,752,1662,1743
3405-000,2018,6,23,14,895,773,1668,1662
3405-000,2018,6,23,15,866,811,1677,1668
3405-000,2018,6,23,16,826,822,1648,1677
3405-000,2018,6,23,17,863,845,1708,1648
3405-000,2018,6,23,18,975,888,1863,1708
3405-000,2018,6,23,19,783,765,1548,1863
3405-000,2018,6,23,20,561,546,1107,1548
3405-000,2018,6,23,21,417,414,831,1107
3405-000,2018,6,23,22,335,307,642,831
3405-000,2018,6,23,23,224,243,467,642
3405-000,2018,6,23,24,144,175,319,467
3405-000,2018,6,24,1,61,98,159,319
3405-000,2018,6,24,2,49,49,98,159
3405-000,2018,6,24,3,41,59,100,98
3405-000,2018,6,24,4,43,49,92,100
3405-000,2018,6,24,5,76,52,128,92
3405-000,2018,6,24,6,191,102,293,128
3405-000,2018,6,24,7,308,172,480,293
3405-000,2018,6,24,8,373,266,639,480
3405-000,2018,6,24,9,467,333,800,639
3405-000,2018,6,24,10,508,415,923,800
3405-000,2018,6,24,11,622,448,1070,923
3405-000,2018,6,24,12,569,502,1071,1070
3405-000,2018,6,24,13,538,541,1079,1071
3405-000,2018,6,24,14,598,589,1187,1079
3405-000,2018,6,24,15,639,661,1300,1187
3405-000,2018,6,24,16,710,773,1483,1300
3405-000,2018,6,24,17,704,710,1414,1483
3405-000,2018,6,24,18,689,688,1377,1414
3405-000,2018,6,24,19,580,645,1225,1377
3405-000,2018,6,24,20,481,557,1038,1225
3405-000,2018,6,24,21,404,509,913,1038
3405-000,2018,6,24,22,323,419,742,913
3405-000,2018,6,24,23,224,328,552,742
3405-000,2018,6,24,24,129,216,345,552
3405-000,2018,6,25,1,83,141,224,345
3405-000,2018,6,25,2,42,66,108,224
3405-000,2018,6,25,3,41,60,101,108
3405-000,2018,6,25,4,55,67,122,101
3405-000,2018,6,25,5,134,105,239,122
3405-000,2018,6,25,6,406,289,695,239
3405-000,2018,6,25,7,832,763,1595,695
3405-000,2018,6,25,8,1387,1594,2981,1595
3405-000,2018,6,25,9,1398,1449,2847,2981
3405-000,2018,6,25,10,1205,970,2175,2847
3405-000,2018,6,25,11,1124,961,2085,2175
3405-000,2018,6,25,12,1140,972,2112,2085
3405-000,2018,6,25,13,976,875,1851,2112
3405-000,2018,6,25,14,1042,1023,2065,1851
3405-000,2018,6,25,15,1186,1086,2272,2065
3405-000,2018,6,25,16,1189,1104,2293,2272
3405-000,2018,6,25,17,1076,1100,2176,2293
3405-000,2018,6,25,18,1326,1080,2406,2176
3405-000,2018,6,25,19,1273,1149,2422,2406
3405-000,2018,6,25,20,786,778,1564,2422
3405-000,2018,6,25,21,647,673,1320,1564
3405-000,2018,6,25,22,408,458,866,1320
3405-000,2018,6,25,23,242,241,483,866
3405-000,2018,6,25,24,145,159,304,483
3405-000,2018,6,26,1,96,108,204,304
3405-000,2018,6,26,2,50,77,127,204
3405-000,2018,6,26,3,54,60,114,127
3405-000,2018,6,26,4,65,69,134,114
3405-000,2018,6,26,5,126,112,238,134
3405-000,2018,6,26,6,301,212,513,238
3405-000,2018,6,26,7,597,499,1096,513
3405-000,2018,6,26,8,1235,1232,2467,1096
3405-000,2018,6,26,9,1367,1273,2640,2467
3405-000,2018,6,26,10,1063,851,1914,2640
3405-000,2018,6,26,11,981,872,1853,1914
3405-000,2018,6,26,12,906,846,1752,1853
3405-000,2018,6,26,13,763,765,1528,1752
3405-000,2018,6,26,14,859,808,1667,1528
3405-000,2018,6,26,15,1039,904,1943,1667
3405-000,2018,6,26,16,1083,948,2031,1943
3405-000,2018,6,26,17,959,955,1914,2031
3405-000,2018,6,26,18,1136,947,2083,1914
3405-000,2018,6,26,19,1192,1042,2234,2083
3405-000,2018,6,26,20,648,627,1275,2234
3405-000,2018,6,26,21,497,481,978,1275
3405-000,2018,6,26,22,320,379,699,978
3405-000,2018,6,26,23,231,187,418,699
3405-000,2018,6,26,24,115,121,236,418
3405-000,2018,6,27,1,95,89,184,236
3405-000,2018,6,27,2,45,71,116,184
3405-000,2018,6,27,3,36,45,81,116
3405-000,2018,6,27,4,58,70,128,81
3405-000,2018,6,27,5,99,98,197,128
3405-000,2018,6,27,6,299,193,492,197
3405-000,2018,6,27,7,623,475,1098,492
3405-000,2018,6,27,8,1228,1220,2448,1098
3405-000,2018,6,27,9,1371,1383,2754,2448
3405-000,2018,6,27,10,1147,967,2114,2754
3405-000,2018,6,27,11,1160,1090,2250,2114
3405-000,2018,6,27,12,1099,939,2038,2250
3405-000,2018,6,27,13,881,884,1765,2038
3405-000,2018,6,27,14,1021,1004,2025,1765
3405-000,2018,6,27,15,1187,1099,2286,2025
3405-000,2018,6,27,16,1174,1037,2211,2286
3405-000,2018,6,27,17,1160,1014,2174,2211
3405-000,2018,6,27,18,1336,1196,2532,2174
3405-000,2018,6,27,19,1316,1099,2415,2532
3405-000,2018,6,27,20,689,702,1391,2415
3405-000,2018,6,27,21,486,549,1035,1391
3405-000,2018,6,27,22,361,365,726,1035
3405-000,2018,6,27,23,232,249,481,726
3405-000,2018,6,27,24,145,182,327,481
3405-000,2018,6,28,1,75,88,163,327
3405-000,2018,6,28,2,71,71,142,163
3405-000,2018,6,28,3,49,55,104,142
3405-000,2018,6,28,4,62,64,126,104
3405-000,2018,6,28,5,132,109,241,126
3405-000,2018,6,28,6,319,212,531,241
3405-000,2018,6,28,7,727,530,1257,531
3405-000,2018,6,28,8,1318,1404,2722,1257
3405-000,2018,6,28,9,1448,1414,2862,2722
3405-000,2018,6,28,10,1127,978,2105,2862
3405-000,2018,6,28,11,1095,1059,2154,2105
3405-000,2018,6,28,12,1129,972,2101,2154
3405-000,2018,6,28,13,912,853,1765,2101
3405-000,2018,6,28,14,949,931,1880,1765
3405-000,2018,6,28,15,1091,1060,2151,1880
3405-000,2018,6,28,16,1153,1024,2177,2151
3405-000,2018,6,28,17,1132,1010,2142,2177
3405-000,2018,6,28,18,1230,1100,2330,2142
3405-000,2018,6,28,19,1196,1071,2267,2330
3405-000,2018,6,28,20,690,662,1352,2267
3405-000,2018,6,28,21,509,567,1076,1352
3405-000,2018,6,28,22,392,358,750,1076
3405-000,2018,6,28,23,243,245,488,750
3405-000,2018,6,28,24,139,140,279,488
3405-000,2018,6,29,1,96,103,199,279
3405-000,2018,6,29,2,64,73,137,199
3405-000,2018,6,29,3,53,57,110,137
3405-000,2018,6,29,4,62,72,134,110
3405-000,2018,6,29,5,124,117,241,134
3405-000,2018,6,29,6,359,244,603,241
3405-000,2018,6,29,7,702,526,1228,603
3405-000,2018,6,29,8,1319,1316,2635,1228
3405-000,2018,6,29,9,1514,1331,2845,2635
3405-000,2018,6,29,10,1171,1039,2210,2845
3405-000,2018,6,29,11,1204,1040,2244,2210
3405-000,2018,6,29,12,1202,1042,2244,2244
3405-000,2018,6,29,13,1000,896,1896,2244
3405-000,2018,6,29,14,1037,965,2002,1896
3405-000,2018,6,29,15,1178,1082,2260,2002
3405-000,2018,6,29,16,1273,1145,2418,2260
3405-000,2018,6,29,17,1239,1154,2393,2418
3405-000,2018,6,29,18,1590,1173,2763,2393
3405-000,2018,6,29,19,1633,1264,2897,2763
3405-000,2018,6,29,20,986,845,1831,2897
3405-000,2018,6,29,21,746,699,1445,1831
3405-000,2018,6,29,22,485,435,920,1445
3405-000,2018,6,29,23,337,319,656,920
3405-000,2018,6,29,24,195,206,401,656
3405-000,2018,6,30,1,147,127,274,401
3405-000,2018,6,30,2,91,94,185,274
3405-000,2018,6,30,3,68,68,136,185
3405-000,2018,6,30,4,59,65,124,136
3405-000,2018,6,30,5,117,94,211,124
3405-000,2018,6,30,6,295,156,451,211
3405-000,2018,6,30,7,534,362,896,451
3405-000,2018,6,30,8,776,544,1320,896
3405-000,2018,6,30,9,886,761,1647,1320
3405-000,2018,6,30,10,919,645,1564,1647
3405-000,2018,6,30,11,931,758,1689,1564
3405-000,2018,6,30,12,928,687,1615,1689
3405-000,2018,6,30,13,832,709,1541,1615
3405-000,2018,6,30,14,897,682,1579,1541
3405-000,2018,6,30,15,811,675,1486,1579
3405-000,2018,6,30,16,879,733,1612,1486
3405-000,2018,6,30,17,866,710,1576,1612
3405-000,2018,6,30,18,943,869,1812,1576
3405-000,2018,6,30,19,689,643,1332,1812
3405-000,2018,6,30,20,420,455,875,1332
3405-000,2018,6,30,21,356,369,725,875
3405-000,2018,6,30,22,247,296,543,725
3405-000,2018,6,30,23,202,237,439,543
3405-000,2018,6,30,24,123,127,250,439
3405-000,2018,7,1,1,72,89,161,250
3405-000,2018,7,1,2,76,63,139,161
3405-000,2018,7,1,3,48,37,85,139
3405-000,2018,7,1,4,27,34,61,85
3405-000,2018,7,1,5,50,36,86,61
3405-000,2018,7,1,6,99,66,165,86
3405-000,2018,7,1,7,179,108,287,165
3405-000,2018,7,1,8,225,190,415,287
3405-000,2018,7,1,9,252,263,515,415
3405-000,2018,7,1,10,329,297,626,515
3405-000,2018,7,1,11,459,383,842,626
3405-000,2018,7,1,12,420,452,872,842
3405-000,2018,7,1,13,464,463,927,872
3405-000,2018,7,1,14,483,487,970,927
3405-000,2018,7,1,15,592,534,1126,970
3405-000,2018,7,1,16,569,556,1125,1126
3405-000,2018,7,1,17,522,502,1024,1125
3405-000,2018,7,1,18,522,485,1007,1024
3405-000,2018,7,1,19,426,495,921,1007
3405-000,2018,7,1,20,342,407,749,921
3405-000,2018,7,1,21,304,335,639,749
3405-000,2018,7,1,22,239,274,513,639
3405-000,2018,7,1,23,165,243,408,513
3405-000,2018,7,1,24,114,144,258,408
3405-000,2018,7,2,1,62,91,153,258
3405-000,2018,7,2,2,34,65,99,153
3405-000,2018,7,2,3,39,41,80,99
3405-000,2018,7,2,4,45,59,104,80
3405-000,2018,7,2,5,95,79,174,104
3405-000,2018,7,2,6,255,197,452,174
3405-000,2018,7,2,7,669,552,1221,452
3405-000,2018,7,2,8,1298,1481,2779,1221
3405-000,2018,7,2,9,1418,1335,2753,2779
3405-000,2018,7,2,10,1062,911,1973,2753
3405-000,2018,7,2,11,1055,915,1970,1973
3405-000,2018,7,2,12,1024,961,1985,1970
3405-000,2018,7,2,13,909,857,1766,1985
3405-000,2018,7,2,14,899,973,1872,1766
3405-000,2018,7,2,15,1111,1016,2127,1872
3405-000,2018,7,2,16,1043,970,2013,2127
3405-000,2018,7,2,17,1007,866,1873,2013
3405-000,2018,7,2,18,1139,991,2130,1873
3405-000,2018,7,2,19,1074,1002,2076,2130
3405-000,2018,7,2,20,669,645,1314,2076
3405-000,2018,7,2,21,481,516,997,1314
3405-000,2018,7,2,22,332,318,650,997
3405-000,2018,7,2,23,231,193,424,650
3405-000,2018,7,2,24,139,140,279,424
3405-000,2018,7,3,1,62,90,152,279
3405-000,2018,7,3,2,50,82,132,152
3405-000,2018,7,3,3,37,57,94,132
3405-000,2018,7,3,4,53,74,127,94
3405-000,2018,7,3,5,123,104,227,127
3405-000,2018,7,3,6,282,188,470,227
3405-000,2018,7,3,7,637,525,1162,470
3405-000,2018,7,3,8,1234,1303,2537,1162
3405-000,2018,7,3,9,1409,1254,2663,2537
3405-000,2018,7,3,10,1071,992,2063,2663
3405-000,2018,7,3,11,1032,1022,2054,2063
3405-000,2018,7,3,12,1088,879,1967,2054
3405-000,2018,7,3,13,915,830,1745,1967
3405-000,2018,7,3,14,1017,947,1964,1745
3405-000,2018,7,3,15,1136,1049,2185,1964
3405-000,2018,7,3,16,1095,1074,2169,2185
3405-000,2018,7,3,17,1078,919,1997,2169
3405-000,2018,7,3,18,1177,1092,2269,1997
3405-000,2018,7,3,19,1146,1131,2277,2269
3405-000,2018,7,3,20,710,706,1416,2277
3405-000,2018,7,3,21,616,619,1235,1416
3405-000,2018,7,3,22,388,409,797,1235
3405-000,2018,7,3,23,276,251,527,797
3405-000,2018,7,3,24,137,171,308,527
3405-000,2018,7,4,1,72,93,165,308
3405-000,2018,7,4,2,55,79,134,165
3405-000,2018,7,4,3,48,55,103,134
3405-000,2018,7,4,4,62,70,132,103
3405-000,2018,7,4,5,129,99,228,132
3405-000,2018,7,4,6,344,213,557,228
3405-000,2018,7,4,7,715,522,1237,557
3405-000,2018,7,4,8,1297,1309,2606,1237
3405-000,2018,7,4,9,1479,1307,2786,2606
3405-000,2018,7,4,10,1160,1050,2210,2786
3405-000,2018,7,4,11,1169,1038,2207,2210
3405-000,2018,7,4,12,1109,1015,2124,2207
3405-000,2018,7,4,13,965,874,1839,2124
3405-000,2018,7,4,14,1046,1005,2051,1839
3405-000,2018,7,4,15,1142,1057,2199,2051
3405-000,2018,7,4,16,1156,1037,2193,2199
3405-000,2018,7,4,17,1110,1032,2142,2193
3405-000,2018,7,4,18,1325,1115,2440,2142
3405-000,2018,7,4,19,1380,1140,2520,2440
3405-000,2018,7,4,20,697,717,1414,2520
3405-000,2018,7,4,21,499,530,1029,1414
3405-000,2018,7,4,22,385,369,754,1029
3405-000,2018,7,4,23,271,216,487,754
3405-000,2018,7,4,24,106,149,255,487
3405-000,2018,7,5,1,101,92,193,255
3405-000,2018,7,5,2,59,79,138,193
3405-000,2018,7,5,3,47,59,106,138
3405-000,2018,7,5,4,69,80,149,106
3405-000,2018,7,5,5,134,88,222,149
3405-000,2018,7,5,6,309,217,526,222
3405-000,2018,7,5,7,660,535,1195,526
3405-000,2018,7,5,8,1313,1334,2647,1195
3405-000,2018,7,5,9,1461,1236,2697,2647
3405-000,2018,7,5,10,1090,991,2081,2697
3405-000,2018,7,5,11,1115,1007,2122,2081
3405-000,2018,7,5,12,1045,963,2008,2122
3405-000,2018,7,5,13,945,895,1840,2008
3405-000,2018,7,5,14,1001,972,1973,1840
3405-000,2018,7,5,15,1117,1087,2204,1973
3405-000,2018,7,5,16,1161,1072,2233,2204
3405-000,2018,7,5,17,1114,989,2103,2233
3405-000,2018,7,5,18,1286,1115,2401,2103
3405-000,2018,7,5,19,1264,1131,2395,2401
3405-000,2018,7,5,20,704,681,1385,2395
3405-000,2018,7,5,21,527,568,1095,1385
3405-000,2018,7,5,22,365,423,788,1095
3405-000,2018,7,5,23,252,257,509,788
3405-000,2018,7,5,24,141,145,286,509
3405-000,2018,7,6,1,114,99,213,286
3405-000,2018,7,6,2,63,72,135,213
3405-000,2018,7,6,3,56,67,123,135
3405-000,2018,7,6,4,56,72,128,123
3405-000,2018,7,6,5,109,98,207,128
3405-000,2018,7,6,6,334,215,549,207
3405-000,2018,7,6,7,673,493,1166,549
3405-000,2018,7,6,8,1304,1286,2590,1166
3405-000,2018,7,6,9,1403,1311,2714,2590
3405-000,2018,7,6,10,1112,976,2088,2714
3405-000,2018,7,6,11,1153,1026,2179,2088
3405-000,2018,7,6,12,1159,962,2121,2179
3405-000,2018,7,6,13,960,844,1804,2121
3405-000,2018,7,6,14,1055,1028,2083,1804
3405-000,2018,7,6,15,1224,1006,2230,2083
3405-000,2018,7,6,16,1218,1028,2246,2230
3405-000,2018,7,6,17,1232,1079,2311,2246
3405-000,2018,7,6,18,1615,1295,2910,2311
3405-000,2018,7,6,19,1688,1336,3024,2910
3405-000,2018,7,6,20,974,765,1739,3024
3405-000,2018,7,6,21,679,620,1299,1739
3405-000,2018,7,6,22,458,423,881,1299
3405-000,2018,7,6,23,309,273,582,881
3405-000,2018,7,6,24,172,176,348,582
3405-000,2018,7,7,1,116,97,213,348
3405-000,2018,7,7,2,75,71,146,213
3405-000,2018,7,7,3,74,53,127,146
3405-000,2018,7,7,4,57,71,128,127
3405-000,2018,7,7,5,124,77,201,128
3405-000,2018,7,7,6,304,188,492,201
3405-000,2018,7,7,7,575,380,955,492
3405-000,2018,7,7,8,769,553,1322,955
3405-000,2018,7,7,9,907,672,1579,1322
3405-000,2018,7,7,10,995,749,1744,1579
3405-000,2018,7,7,11,984,830,1814,1744
3405-000,2018,7,7,12,968,855,1823,1814
3405-000,2018,7,7,13,976,782,1758,1823
3405-000,2018,7,7,14,950,759,1709,1758
3405-000,2018,7,7,15,903,683,1586,1709
3405-000,2018,7,7,16,869,795,1664,1586
3405-000,2018,7,7,17,830,727,1557,1664
3405-000,2018,7,7,18,1027,881,1908,1557
3405-000,2018,7,7,19,760,671,1431,1908
3405-000,2018,7,7,20,465,572,1037,1431
3405-000,2018,7,7,21,389,418,807,1037
3405-000,2018,7,7,22,346,371,717,807
3405-000,2018,7,7,23,241,256,497,717
3405-000,2018,7,7,24,132,178,310,497
3405-000,2018,7,8,1,81,95,176,310
3405-000,2018,7,8,2,64,64,128,176
3405-000,2018,7,8,3,37,44,81,128
3405-000,2018,7,8,4,39,40,79,81
3405-000,2018,7,8,5,76,32,108,79
3405-000,2018,7,8,6,180,92,272,108
3405-000,2018,7,8,7,301,184,485,272
3405-000,2018,7,8,8,332,254,586,485
3405-000,2018,7,8,9,446,285,731,586
3405-000,2018,7,8,10,513,346,859,731
3405-000,2018,7,8,11,614,432,1046,859
3405-000,2018,7,8,12,572,480,1052,1046
3405-000,2018,7,8,13,578,516,1094,1052
3405-000,2018,7,8,14,526,598,1124,1094
3405-000,2018,7,8,15,612,605,1217,1124
3405-000,2018,7,8,16,654,658,1312,1217
3405-000,2018,7,8,17,687,608,1295,1312
3405-000,2018,7,8,18,714,692,1406,1295
3405-000,2018,7,8,19,575,588,1163,1406
3405-000,2018,7,8,20,466,585,1051,1163
3405-000,2018,7,8,21,386,519,905,1051
3405-000,2018,7,8,22,314,422,736,905
3405-000,2018,7,8,23,211,354,565,736
3405-000,2018,7,8,24,132,207,339,565
3405-000,2018,7,9,1,78,117,195,339
3405-000,2018,7,9,2,49,50,99,195
3405-000,2018,7,9,3,36,52,88,99
3405-000,2018,7,9,4,53,57,110,88
3405-000,2018,7,9,5,118,108,226,110
3405-000,2018,7,9,6,306,230,536,226
3405-000,2018,7,9,7,715,620,1335,536
3405-000,2018,7,9,8,1331,1454,2785,1335
3405-000,2018,7,9,9,1398,1404,2802,2785
3405-000,2018,7,9,10,1001,955,1956,2802
3405-000,2018,7,9,11,1024,903,1927,1956
3405-000,2018,7,9,12,988,852,1840,1927
3405-000,2018,7,9,13,807,730,1537,1840
3405-000,2018,7,9,14,868,907,1775,1537
3405-000,2018,7,9,15,1047,952,1999,1775
3405-000,2018,7,9,16,1022,929,1951,1999
3405-000,2018,7,9,17,953,923,1876,1951
3405-000,2018,7,9,18,1127,1007,2134,1876
3405-000,2018,7,9,19,1050,1024,2074,2134
3405-000,2018,7,9,20,669,619,1288,2074
3405-000,2018,7,9,21,478,500,978,1288
3405-000,2018,7,9,22,329,369,698,978
3405-000,2018,7,9,23,231,189,420,698
3405-000,2018,7,9,24,115,139,254,420
3405-000,2018,7,10,1,90,76,166,254
3405-000,2018,7,10,2,55,66,121,166
3405-000,2018,7,10,3,46,48,94,121
3405-000,2018,7,10,4,52,73,125,94
3405-000,2018,7,10,5,118,97,215,125
3405-000,2018,7,10,6,271,211,482,215
3405-000,2018,7,10,7,669,557,1226,482
3405-000,2018,7,10,8,1307,1329,2636,1226
3405-000,2018,7,10,9,1459,1288,2747,2636
3405-000,2018,7,10,10,1184,979,2163,2747
3405-000,2018,7,10,11,1129,1070,2199,2163
3405-000,2018,7,10,12,1057,951,2008,2199
3405-000,2018,7,10,13,926,871,1797,2008
3405-000,2018,7,10,14,1044,1008,2052,1797
3405-000,2018,7,10,15,1211,1033,2244,2052
3405-000,2018,7,10,16,1246,998,2244,2244
3405-000,2018,7,10,17,1096,1023,2119,2244
3405-000,2018,7,10,18,1201,1123,2324,2119
3405-000,2018,7,10,19,1143,1053,2196,2324
3405-000,2018,7,10,20,702,707,1409,2196
3405-000,2018,7,10,21,536,580,1116,1409
3405-000,2018,7,10,22,376,372,748,1116
3405-000,2018,7,10,23,277,245,522,748
3405-000,2018,7,10,24,134,146,280,522
3405-000,2018,7,11,1,81,102,183,280
3405-000,2018,7,11,2,55,81,136,183
3405-000,2018,7,11,3,40,63,103,136
3405-000,2018,7,11,4,53,79,132,103
3405-000,2018,7,11,5,132,105,237,132
3405-000,2018,7,11,6,358,218,576,237
3405-000,2018,7,11,7,681,529,1210,576
3405-000,2018,7,11,8,1284,1268,2552,1210
3405-000,2018,7,11,9,1461,1338,2799,2552
3405-000,2018,7,11,10,1176,994,2170,2799
3405-000,2018,7,11,11,1098,1098,2196,2170
3405-000,2018,7,11,12,1098,932,2030,2196
3405-000,2018,7,11,13,957,879,1836,2030
3405-000,2018,7,11,14,1082,957,2039,1836
3405-000,2018,7,11,15,1158,1030,2188,2039
3405-000,2018,7,11,16,1087,1132,2219,2188
3405-000,2018,7,11,17,1146,1010,2156,2219
3405-000,2018,7,11,18,1359,1171,2530,2156
3405-000,2018,7,11,19,1314,1152,2466,2530
3405-000,2018,7,11,20,689,702,1391,2466
3405-000,2018,7,11,21,526,525,1051,1391
3405-000,2018,7,11,22,364,363,727,1051
3405-000,2018,7,11,23,239,199,438,727
3405-000,2018,7,11,24,142,160,302,438
3405-000,2018,7,12,1,82,102,184,302
3405-000,2018,7,12,2,58,81,139,184
3405-000,2018,7,12,3,45,60,105,139
3405-000,2018,7,12,4,66,69,135,105
3405-000,2018,7,12,5,114,94,208,135
3405-000,2018,7,12,6,330,228,558,208
3405-000,2018,7,12,7,695,538,1233,558
3405-000,2018,7,12,8,1326,1346,2672,1233
3405-000,2018,7,12,9,1481,1356,2837,2672
3405-000,2018,7,12,10,1163,1067,2230,2837
3405-000,2018,7,12,11,1219,1008,2227,2230
3405-000,2018,7,12,12,1049,1117,2166,2227
3405-000,2018,7,12,13,919,868,1787,2166
3405-000,2018,7,12,14,1080,1019,2099,1787
3405-000,2018,7,12,15,1148,1344,2492,2099
3405-000,2018,7,12,16,1173,1043,2216,2492
3405-000,2018,7,12,17,1139,1012,2151,2216
3405-000,2018,7,12,18,1312,1123,2435,2151
3405-000,2018,7,12,19,1198,1130,2328,2435
3405-000,2018,7,12,20,735,674,1409,2328
3405-000,2018,7,12,21,559,633,1192,1409
3405-000,2018,7,12,22,414,428,842,1192
3405-000,2018,7,12,23,240,243,483,842
3405-000,2018,7,12,24,182,184,366,483
3405-000,2018,7,13,1,102,107,209,366
3405-000,2018,7,13,2,64,83,147,209
3405-000,2018,7,13,3,57,48,105,147
3405-000,2018,7,13,4,51,96,147,105
3405-000,2018,7,13,5,131,111,242,147
3405-000,2018,7,13,6,350,209,559,242
3405-000,2018,7,13,7,703,572,1275,559
3405-000,2018,7,13,8,1309,1340,2649,1275
3405-000,2018,7,13,9,1444,1360,2804,2649
3405-000,2018,7,13,10,1260,1059,2319,2804
3405-000,2018,7,13,11,1223,1087,2310,2319
3405-000,2018,7,13,12,1175,1011,2186,2310
3405-000,2018,7,13,13,1031,888,1919,2186
3405-000,2018,7,13,14,1126,1038,2164,1919
3405-000,2018,7,13,15,1217,1056,2273,2164
3405-000,2018,7,13,16,1274,1157,2431,2273
3405-000,2018,7,13,17,1177,1076,2253,2431
3405-000,2018,7,13,18,1653,1217,2870,2253
3405-000,2018,7,13,19,1775,1249,3024,2870
3405-000,2018,7,13,20,1061,810,1871,3024
3405-000,2018,7,13,21,719,670,1389,1871
3405-000,2018,7,13,22,482,471,953,1389
3405-000,2018,7,13,23,322,266,588,953
3405-000,2018,7,13,24,184,190,374,588
3405-000,2018,7,14,1,112,118,230,374
3405-000,2018,7,14,2,69,76,145,230
3405-000,2018,7,14,3,60,55,115,145
3405-000,2018,7,14,4,52,76,128,115
3405-000,2018,7,14,5,134,88,222,128
3405-000,2018,7,14,6,323,177,500,222
3405-000,2018,7,14,7,553,350,903,500
3405-000,2018,7,14,8,816,644,1460,903
3405-000,2018,7,14,9,916,728,1644,1460
3405-000,2018,7,14,10,956,804,1760,1644
3405-000,2018,7,14,11,948,838,1786,1760
3405-000,2018,7,14,12,997,842,1839,1786
3405-000,2018,7,14,13,859,708,1567,1839
3405-000,2018,7,14,14,871,736,1607,1567
3405-000,2018,7,14,15,887,751,1638,1607
3405-000,2018,7,14,16,892,753,1645,1638
3405-000,2018,7,14,17,871,794,1665,1645
3405-000,2018,7,14,18,977,805,1782,1665
3405-000,2018,7,14,19,766,686,1452,1782
3405-000,2018,7,14,20,462,495,957,1452
3405-000,2018,7,14,21,412,444,856,957
3405-000,2018,7,14,22,330,346,676,856
3405-000,2018,7,14,23,265,236,501,676
3405-000,2018,7,14,24,140,157,297,501
3405-000,2018,7,15,1,95,92,187,297
3405-000,2018,7,15,2,65,72,137,187
3405-000,2018,7,15,3,44,39,83,137
3405-000,2018,7,15,4,30,31,61,83
3405-000,2018,7,15,5,83,45,128,61
3405-000,2018,7,15,6,173,79,252,128
3405-000,2018,7,15,7,304,173,477,252
3405-000,2018,7,15,8,367,289,656,477
3405-000,2018,7,15,9,471,300,771,656
3405-000,2018,7,15,10,540,389,929,771
3405-000,2018,7,15,11,541,476,1017,929
3405-000,2018,7,15,12,626,508,1134,1017
3405-000,2018,7,15,13,562,523,1085,1134
3405-000,2018,7,15,14,568,627,1195,1085
3405-000,2018,7,15,15,638,664,1302,1195
3405-000,2018,7,15,16,662,595,1257,1302
3405-000,2018,7,15,17,668,640,1308,1257
3405-000,2018,7,15,18,648,788,1436,1308
3405-000,2018,7,15,19,587,660,1247,1436
3405-000,2018,7,15,20,449,552,1001,1247
3405-000,2018,7,15,21,402,463,865,1001
3405-000,2018,7,15,22,337,407,744,865
3405-000,2018,7,15,23,233,332,565,744
3405-000,2018,7,15,24,136,240,376,565
3405-000,2018,7,16,1,72,110,182,376
3405-000,2018,7,16,2,42,70,112,182
3405-000,2018,7,16,3,41,52,93,112
3405-000,2018,7,16,4,67,77,144,93
3405-000,2018,7,16,5,134,84,218,144
3405-000,2018,7,16,6,372,273,645,218
3405-000,2018,7,16,7,785,686,1471,645
3405-000,2018,7,16,8,1352,1596,2948,1471
3405-000,2018,7,16,9,1435,1393,2828,2948
3405-000,2018,7,16,10,1116,965,2081,2828
3405-000,2018,7,16,11,1199,1055,2254,2081
3405-000,2018,7,16,12,1094,1003,2097,2254
3405-000,2018,7,16,13,851,830,1681,2097
3405-000,2018,7,16,14,959,1014,1973,1681
3405-000,2018,7,16,15,1137,1036,2173,1973
3405-000,2018,7,16,16,1063,1048,2111,2173
3405-000,2018,7,16,17,1159,980,2139,2111
3405-000,2018,7,16,18,1284,1161,2445,2139
3405-000,2018,7,16,19,1227,1093,2320,2445
3405-000,2018,7,16,20,772,712,1484,2320
3405-000,2018,7,16,21,568,640,1208,1484
3405-000,2018,7,16,22,355,404,759,1208
3405-000,2018,7,16,23,254,219,473,759
3405-000,2018,7,16,24,150,131,281,473
3405-000,2018,7,17,1,75,75,150,281
3405-000,2018,7,17,2,61,74,135,150
3405-000,2018,7,17,3,63,62,125,135
3405-000,2018,7,17,4,75,76,151,125
3405-000,2018,7,17,5,144,108,252,151
3405-000,2018,7,17,6,352,219,571,252
3405-000,2018,7,17,7,709,566,1275,571
3405-000,2018,7,17,8,1332,1377,2709,1275
3405-000,2018,7,17,9,1514,1372,2886,2709
3405-000,2018,7,17,10,1189,1016,2205,2886
3405-000,2018,7,17,11,1187,1047,2234,2205
3405-000,2018,7,17,12,1012,962,1974,2234
3405-000,2018,7,17,13,865,820,1685,1974
3405-000,2018,7,17,14,1058,996,2054,1685
3405-000,2018,7,17,15,1156,1035,2191,2054
3405-000,2018,7,17,16,1090,1075,2165,2191
3405-000,2018,7,17,17,1070,1009,2079,2165
3405-000,2018,7,17,18,1334,1099,2433,2079
3405-000,2018,7,17,19,1216,1084,2300,2433
3405-000,2018,7,17,20,664,725,1389,2300
3405-000,2018,7,17,21,540,571,1111,1389
3405-000,2018,7,17,22,364,411,775,1111
3405-000,2018,7,17,23,260,220,480,775
3405-000,2018,7,17,24,170,187,357,480
3405-000,2018,7,18,1,86,100,186,357
3405-000,2018,7,18,2,67,85,152,186
3405-000,2018,7,18,3,42,65,107,152
3405-000,2018,7,18,4,61,77,138,107
3405-000,2018,7,18,5,148,87,235,138
3405-000,2018,7,18,6,336,242,578,235
3405-000,2018,7,18,7,725,573,1298,578
3405-000,2018,7,18,8,1259,1318,2577,1298
3405-000,2018,7,18,9,1446,1390,2836,2577
3405-000,2018,7,18,10,1144,957,2101,2836
3405-000,2018,7,18,11,1121,1112,2233,2101
3405-000,2018,7,18,12,1109,1005,2114,2233
3405-000,2018,7,18,13,911,864,1775,2114
3405-000,2018,7,18,14,1037,1022,2059,1775
3405-000,2018,7,18,15,1173,1035,2208,2059
3405-000,2018,7,18,16,1192,1008,2200,2208
3405-000,2018,7,18,17,1119,1057,2176,2200
3405-000,2018,7,18,18,1341,1163,2504,2176
3405-000,2018,7,18,19,1316,1041,2357,2504
3405-000,2018,7,18,20,708,681,1389,2357
3405-000,2018,7,18,21,499,556,1055,1389
3405-000,2018,7,18,22,339,363,702,1055
3405-000,2018,7,18,23,289,220,509,702
3405-000,2018,7,18,24,144,169,313,509
3405-000,2018,7,19,1,97,117,214,313
3405-000,2018,7,19,2,77,69,146,214
3405-000,2018,7,19,3,60,55,115,146
3405-000,2018,7,19,4,69,82,151,115
3405-000,2018,7,19,5,139,107,246,151
3405-000,2018,7,19,6,354,238,592,246
3405-000,2018,7,19,7,724,543,1267,592
3405-000,2018,7,19,8,1381,1398,2779,1267
3405-000,2018,7,19,9,1441,1378,2819,2779
3405-000,2018,7,19,10,1219,1039,2258,2819
3405-000,2018,7,19,11,1109,1005,2114,2258
3405-000,2018,7,19,12,1000,1038,2038,2114
3405-000,2018,7,19,13,874,943,1817,2038
3405-000,2018,7,19,14,995,1005,2000,1817
3405-000,2018,7,19,15,1180,1056,2236,2000
3405-000,2018,7,19,16,1149,935,2084,2236
3405-000,2018,7,19,17,1078,1046,2124,2084
3405-000,2018,7,19,18,1375,1190,2565,2124
3405-000,2018,7,19,19,1314,1108,2422,2565
3405-000,2018,7,19,20,720,654,1374,2422
3405-000,2018,7,19,21,529,617,1146,1374
3405-000,2018,7,19,22,385,393,778,1146
3405-000,2018,7,19,23,258,258,516,778
3405-000,2018,7,19,24,155,166,321,516
3405-000,2018,7,20,1,100,128,228,321
3405-000,2018,7,20,2,68,84,152,228
3405-000,2018,7,20,3,49,61,110,152
3405-000,2018,7,20,4,49,81,130,110
3405-000,2018,7,20,5,134,83,217,130
3405-000,2018,7,20,6,327,262,589,217
3405-000,2018,7,20,7,725,545,1270,589
3405-000,2018,7,20,8,1280,1359,2639,1270
3405-000,2018,7,20,9,1430,1282,2712,2639
3405-000,2018,7,20,10,1118,1000,2118,2712
3405-000,2018,7,20,11,1168,1053,2221,2118
3405-000,2018,7,20,12,1106,901,2007,2221
3405-000,2018,7,20,13,983,809,1792,2007
3405-000,2018,7,20,14,971,1014,1985,1792
3405-000,2018,7,20,15,1240,1037,2277,1985
3405-000,2018,7,20,16,1439,958,2397,2277
3405-000,2018,7,20,17,1355,1027,2382,2397
3405-000,2018,7,20,18,1643,1223,2866,2382
3405-000,2018,7,20,19,1833,1315,3148,2866
3405-000,2018,7,20,20,1003,866,1869,3148
3405-000,2018,7,20,21,635,647,1282,1869
3405-000,2018,7,20,22,489,419,908,1282
3405-000,2018,7,20,23,335,260,595,908
3405-000,2018,7,20,24,187,209,396,595
3405-000,2018,7,21,1,121,114,235,396
3405-000,2018,7,21,2,82,96,178,235
3405-000,2018,7,21,3,53,62,115,178
3405-000,2018,7,21,4,73,97,170,115
3405-000,2018,7,21,5,158,108,266,170
3405-000,2018,7,21,6,308,205,513,266
3405-000,2018,7,21,7,600,393,993,513
3405-000,2018,7,21,8,824,640,1464,993
3405-000,2018,7,21,9,982,795,1777,1464
3405-000,2018,7,21,10,953,767,1720,1777
3405-000,2018,7,21,11,999,829,1828,1720
3405-000,2018,7,21,12,929,761,1690,1828
3405-000,2018,7,21,13,862,679,1541,1690
3405-000,2018,7,21,14,792,651,1443,1541
3405-000,2018,7,21,15,824,671,1495,1443
3405-000,2018,7,21,16,818,728,1546,1495
3405-000,2018,7,21,17,870,755,1625,1546
3405-000,2018,7,21,18,920,829,1749,1625
3405-000,2018,7,21,19,744,630,1374,1749
3405-000,2018,7,21,20,518,515,1033,1374
3405-000,2018,7,21,21,386,401,787,1033
3405-000,2018,7,21,22,363,331,694,787
3405-000,2018,7,21,23,220,267,487,694
3405-000,2018,7,21,24,120,193,313,487
3405-000,2018,7,22,1,92,84,176,313
3405-000,2018,7,22,2,61,61,122,176
3405-000,2018,7,22,3,50,55,105,122
3405-000,2018,7,22,4,49,50,99,105
3405-000,2018,7,22,5,85,47,132,99
3405-000,2018,7,22,6,202,93,295,132
3405-000,2018,7,22,7,300,192,492,295
3405-000,2018,7,22,8,361,275,636,492
3405-000,2018,7,22,9,473,358,831,636
3405-000,2018,7,22,10,514,414,928,831
3405-000,2018,7,22,11,576,435,1011,928
3405-000,2018,7,22,12,572,514,1086,1011
3405-000,2018,7,22,13,531,547,1078,1086
3405-000,2018,7,22,14,550,578,1128,1078
3405-000,2018,7,22,15,581,559,1140,1128
3405-000,2018,7,22,16,632,616,1248,1140
3405-000,2018,7,22,17,592,707,1299,1248
3405-000,2018,7,22,18,626,642,1268,1299
3405-000,2018,7,22,19,526,592,1118,1268
3405-000,2018,7,22,20,435,563,998,1118
3405-000,2018,7,22,21,372,436,808,998
3405-000,2018,7,22,22,304,391,695,808
3405-000,2018,7,22,23,191,317,508,695
3405-000,2018,7,22,24,150,205,355,508
3405-000,2018,7,23,1,63,144,207,355
3405-000,2018,7,23,2,46,79,125,207
3405-000,2018,7,23,3,53,49,102,125
3405-000,2018,7,23,4,61,84,145,102
3405-000,2018,7,23,5,165,115,280,145
3405-000,2018,7,23,6,375,283,658,280
3405-000,2018,7,23,7,807,739,1546,658
3405-000,2018,7,23,8,1390,1538,2928,1546
3405-000,2018,7,23,9,1441,1407,2848,2928
3405-000,2018,7,23,10,1096,962,2058,2848
3405-000,2018,7,23,11,1155,964,2119,2058
3405-000,2018,7,23,12,1144,909,2053,2119
3405-000,2018,7,23,13,979,865,1844,2053
3405-000,2018,7,23,14,1102,994,2096,1844
3405-000,2018,7,23,15,1196,1000,2196,2096
3405-000,2018,7,23,16,1165,1087,2252,2196
3405-000,2018,7,23,17,1079,1049,2128,2252
3405-000,2018,7,23,18,1251,1127,2378,2128
3405-000,2018,7,23,19,1235,1116,2351,2378
3405-000,2018,7,23,20,764,795,1559,2351
3405-000,2018,7,23,21,570,655,1225,1559
3405-000,2018,7,23,22,371,383,754,1225
3405-000,2018,7,23,23,237,219,456,754
3405-000,2018,7,23,24,135,176,311,456
3405-000,2018,7,24,1,87,107,194,311
3405-000,2018,7,24,2,53,72,125,194
3405-000,2018,7,24,3,58,60,118,125
3405-000,2018,7,24,4,68,98,166,118
3405-000,2018,7,24,5,148,120,268,166
3405-000,2018,7,24,6,333,230,563,268
3405-000,2018,7,24,7,708,560,1268,563
3405-000,2018,7,24,8,1327,1362,2689,1268
3405-000,2018,7,24,9,1467,1276,2743,2689
3405-000,2018,7,24,10,1251,1002,2253,2743
3405-000,2018,7,24,11,1120,1013,2133,2253
3405-000,2018,7,24,12,1152,991,2143,2133
3405-000,2018,7,24,13,951,888,1839,2143
3405-000,2018,7,24,14,1038,1028,2066,1839
3405-000,2018,7,24,15,1200,1080,2280,2066
3405-000,2018,7,24,16,1123,983,2106,2280
3405-000,2018,7,24,17,1121,1022,2143,2106
3405-000,2018,7,24,18,1281,1193,2474,2143
3405-000,2018,7,24,19,1203,1184,2387,2474
3405-000,2018,7,24,20,803,754,1557,2387
3405-000,2018,7,24,21,576,637,1213,1557
3405-000,2018,7,24,22,389,430,819,1213
3405-000,2018,7,24,23,214,230,444,819
3405-000,2018,7,24,24,170,149,319,444
3405-000,2018,7,25,1,75,79,154,319
3405-000,2018,7,25,2,52,77,129,154
3405-000,2018,7,25,3,47,62,109,129
3405-000,2018,7,25,4,60,73,133,109
3405-000,2018,7,25,5,147,94,241,133
3405-000,2018,7,25,6,365,245,610,241
3405-000,2018,7,25,7,715,536,1251,610
3405-000,2018,7,25,8,1328,1279,2607,1251
3405-000,2018,7,25,9,1450,1311,2761,2607
3405-000,2018,7,25,10,1178,1085,2263,2761
3405-000,2018,7,25,11,1173,1080,2253,2263
3405-000,2018,7,25,12,1110,1045,2155,2253
3405-000,2018,7,25,13,933,875,1808,2155
3405-000,2018,7,25,14,1068,1027,2095,1808
3405-000,2018,7,25,15,1223,1081,2304,2095
3405-000,2018,7,25,16,1115,1067,2182,2304
3405-000,2018,7,25,17,1157,1004,2161,2182
3405-000,2018,7,25,18,1340,1177,2517,2161
3405-000,2018,7,25,19,1244,1133,2377,2517
3405-000,2018,7,25,20,669,715,1384,2377
3405-000,2018,7,25,21,528,556,1084,1384
3405-000,2018,7,25,22,377,377,754,1084
3405-000,2018,7,25,23,254,224,478,754
3405-000,2018,7,25,24,186,177,363,478
3405-000,2018,7,26,1,93,95,188,363
3405-000,2018,7,26,2,48,78,126,188
3405-000,2018,7,26,3,47,63,110,126
3405-000,2018,7,26,4,83,76,159,110
3405-000,2018,7,26,5,142,117,259,159
3405-000,2018,7,26,6,319,224,543,259
3405-000,2018,7,26,7,715,551,1266,543
3405-000,2018,7,26,8,1340,1328,2668,1266
3405-000,2018,7,26,9,1434,1346,2780,2668
3405-000,2018,7,26,10,1259,1026,2285,2780
3405-000,2018,7,26,11,1190,1108,2298,2285
3405-000,2018,7,26,12,1093,937,2030,2298
3405-000,2018,7,26,13,970,912,1882,2030
3405-000,2018,7,26,14,1052,965,2017,1882
3405-000,2018,7,26,15,1218,1017,2235,2017
3405-000,2018,7,26,16,1170,1106,2276,2235
3405-000,2018,7,26,17,1180,1042,2222,2276
3405-000,2018,7,26,18,1316,1105,2421,2222
3405-000,2018,7,26,19,1230,1077,2307,2421
3405-000,2018,7,26,20,781,751,1532,2307
3405-000,2018,7,26,21,584,603,1187,1532
3405-000,2018,7,26,22,365,396,761,1187
3405-000,2018,7,26,23,275,227,502,761
3405-000,2018,7,26,24,155,185,340,502
3405-000,2018,7,27,1,92,129,221,340
3405-000,2018,7,27,2,55,74,129,221
3405-000,2018,7,27,3,58,57,115,129
3405-000,2018,7,27,4,58,101,159,115
3405-000,2018,7,27,5,158,99,257,159
3405-000,2018,7,27,6,326,252,578,257
3405-000,2018,7,27,7,716,570,1286,578
3405-000,2018,7,27,8,1289,1307,2596,1286
3405-000,2018,7,27,9,1451,1326,2777,2596
3405-000,2018,7,27,10,1226,987,2213,2777
3405-000,2018,7,27,11,1178,1031,2209,2213
3405-000,2018,7,27,12,1188,1017,2205,2209
3405-000,2018,7,27,13,1008,899,1907,2205
3405-000,2018,7,27,14,1106,1016,2122,1907
3405-000,2018,7,27,15,1224,1108,2332,2122
3405-000,2018,7,27,16,1253,1055,2308,2332
3405-000,2018,7,27,17,1210,1015,2225,2308
3405-000,2018,7,27,18,1688,1319,3007,2225
3405-000,2018,7,27,19,1741,1461,3202,3007
3405-000,2018,7,27,20,976,898,1874,3202
3405-000,2018,7,27,21,746,615,1361,1874
3405-000,2018,7,27,22,451,424,875,1361
3405-000,2018,7,27,23,322,292,614,875
3405-000,2018,7,27,24,181,164,345,614
3405-000,2018,7,28,1,118,134,252,345
3405-000,2018,7,28,2,77,106,183,252
3405-000,2018,7,28,3,62,67,129,183
3405-000,2018,7,28,4,71,71,142,129
3405-000,2018,7,28,5,167,100,267,142
3405-000,2018,7,28,6,359,181,540,267
3405-000,2018,7,28,7,581,390,971,540
3405-000,2018,7,28,8,805,653,1458,971
3405-000,2018,7,28,9,994,776,1770,1458
3405-000,2018,7,28,10,987,761,1748,1770
3405-000,2018,7,28,11,947,836,1783,1748
3405-000,2018,7,28,12,965,849,1814,1783
3405-000,2018,7,28,13,935,782,1717,1814
3405-000,2018,7,28,14,843,725,1568,1717
3405-000,2018,7,28,15,808,707,1515,1568
3405-000,2018,7,28,16,903,712,1615,1515
3405-000,2018,7,28,17,846,696,1542,1615
3405-000,2018,7,28,18,881,808,1689,1542
3405-000,2018,7,28,19,686,669,1355,1689
3405-000,2018,7,28,20,474,466,940,1355
3405-000,2018,7,28,21,366,365,731,940
3405-000,2018,7,28,22,293,275,568,731
3405-000,2018,7,28,23,190,229,419,568
3405-000,2018,7,28,24,142,166,308,419
3405-000,2018,7,29,1,91,96,187,308
3405-000,2018,7,29,2,59,67,126,187
3405-000,2018,7,29,3,49,44,93,126
3405-000,2018,7,29,4,38,44,82,93
3405-000,2018,7,29,5,81,60,141,82
3405-000,2018,7,29,6,195,122,317,141
3405-000,2018,7,29,7,319,201,520,317
3405-000,2018,7,29,8,384,301,685,520
3405-000,2018,7,29,9,506,342,848,685
3405-000,2018,7,29,10,581,412,993,848
3405-000,2018,7,29,11,693,472,1165,993
3405-000,2018,7,29,12,631,482,1113,1165
3405-000,2018,7,29,13,583,509,1092,1113
3405-000,2018,7,29,14,609,555,1164,1092
3405-000,2018,7,29,15,688,570,1258,1164
3405-000,2018,7,29,16,670,624,1294,1258
3405-000,2018,7,29,17,723,706,1429,1294
3405-000,2018,7,29,18,666,697,1363,1429
3405-000,2018,7,29,19,526,670,1196,1363
3405-000,2018,7,29,20,423,570,993,1196
3405-000,2018,7,29,21,417,475,892,993
3405-000,2018,7,29,22,311,406,717,892
3405-000,2018,7,29,23,218,333,551,717
3405-000,2018,7,29,24,139,202,341,551
3405-000,2018,7,30,1,88,109,197,341
3405-000,2018,7,30,2,44,57,101,197
3405-000,2018,7,30,3,36,57,93,101
3405-000,2018,7,30,4,48,80,128,93
3405-000,2018,7,30,5,142,99,241,128
3405-000,2018,7,30,6,407,239,646,241
3405-000,2018,7,30,7,739,587,1326,646
3405-000,2018,7,30,8,1170,1212,2382,1326
3405-000,2018,7,30,9,1265,1116,2381,2382
3405-000,2018,7,30,10,1027,885,1912,2381
3405-000,2018,7,30,11,1140,951,2091,1912
3405-000,2018,7,30,12,1017,904,1921,2091
3405-000,2018,7,30,13,911,807,1718,1921
3405-000,2018,7,30,14,958,963,1921,1718
3405-000,2018,7,30,15,1084,1052,2136,1921
3405-000,2018,7,30,16,999,1011,2010,2136
3405-000,2018,7,30,17,1091,970,2061,2010
3405-000,2018,7,30,18,1149,1044,2193,2061
3405-000,2018,7,30,19,999,1018,2017,2193
3405-000,2018,7,30,20,615,670,1285,2017
3405-000,2018,7,30,21,433,513,946,1285
3405-000,2018,7,30,22,314,376,690,946
3405-000,2018,7,30,23,221,228,449,690
3405-000,2018,7,30,24,139,147,286,449
3405-000,2018,7,31,1,80,98,178,286
3405-000,2018,7,31,2,61,60,121,178
3405-000,2018,7,31,3,69,71,140,121
3405-000,2018,7,31,4,60,71,131,140
3405-000,2018,7,31,5,137,97,234,131
3405-000,2018,7,31,6,279,187,466,234
3405-000,2018,7,31,7,606,478,1084,466
3405-000,2018,7,31,8,1063,1017,2080,1084
3405-000,2018,7,31,9,1229,1036,2265,2080
3405-000,2018,7,31,10,990,856,1846,2265
3405-000,2018,7,31,11,1078,1255,2333,1846
3405-000,2018,7,31,12,911,825,1736,2333
3405-000,2018,7,31,13,877,783,1660,1736
3405-000,2018,7,31,14,904,891,1795,1660
3405-000,2018,7,31,15,999,949,1948,1795
3405-000,2018,7,31,16,1042,919,1961,1948
3405-000,2018,7,31,17,1044,970,2014,1961
3405-000,2018,7,31,18,1242,1064,2306,2014
3405-000,2018,7,31,19,1092,1087,2179,2306
3405-000,2018,7,31,20,665,730,1395,2179
3405-000,2018,7,31,21,494,545,1039,1395
3405-000,2018,7,31,22,336,416,752,1039
3405-000,2018,7,31,23,239,270,509,752
3405-000,2018,7,31,24,140,162,302,509
3405-000,2018,8,1,1,89,106,195,302
3405-000,2018,8,1,2,64,77,141,195
3405-000,2018,8,1,3,55,61,116,141
3405-000,2018,8,1,4,92,76,168,116
3405-000,2018,8,1,5,140,89,229,168
3405-000,2018,8,1,6,310,169,479,229
3405-000,2018,8,1,7,665,434,1099,479
3405-000,2018,8,1,8,1020,907,1927,1099
3405-000,2018,8,1,9,1245,939,2184,1927
3405-000,2018,8,1,10,1034,830,1864,2184
3405-000,2018,8,1,11,1046,853,1899,1864
3405-000,2018,8,1,12,1032,837,1869,1899
3405-000,2018,8,1,13,875,820,1695,1869
3405-000,2018,8,1,14,898,869,1767,1695
3405-000,2018,8,1,15,973,917,1890,1767
3405-000,2018,8,1,16,926,902,1828,1890
3405-000,2018,8,1,17,890,889,1779,1828
3405-000,2018,8,1,18,1084,952,2036,1779
3405-000,2018,8,1,19,977,925,1902,2036
3405-000,2018,8,1,20,553,664,1217,1902
3405-000,2018,8,1,21,443,466,909,1217
3405-000,2018,8,1,22,329,362,691,909
3405-000,2018,8,1,23,199,256,455,691
3405-000,2018,8,1,24,116,166,282,455
3405-000,2018,8,2,1,95,115,210,282
3405-000,2018,8,2,2,73,69,142,210
3405-000,2018,8,2,3,56,47,103,142
3405-000,2018,8,2,4,52,73,125,103
3405-000,2018,8,2,5,153,81,234,125
3405-000,2018,8,2,6,321,184,505,234
3405-000,2018,8,2,7,615,426,1041,505
3405-000,2018,8,2,8,1033,917,1950,1041
3405-000,2018,8,2,9,1217,929,2146,1950
3405-000,2018,8,2,10,1087,806,1893,2146
3405-000,2018,8,2,11,1162,856,2018,1893
3405-000,2018,8,2,12,980,821,1801,2018
3405-000,2018,8,2,13,871,770,1641,1801
3405-000,2018,8,2,14,870,859,1729,1641
3405-000,2018,8,2,15,928,819,1747,1729
3405-000,2018,8,2,16,947,836,1783,1747
3405-000,2018,8,2,17,882,850,1732,1783
3405-000,2018,8,2,18,1003,903,1906,1732
3405-000,2018,8,2,19,831,990,1821,1906
3405-000,2018,8,2,20,579,627,1206,1821
3405-000,2018,8,2,21,457,515,972,1206
3405-000,2018,8,2,22,295,379,674,972
3405-000,2018,8,2,23,242,239,481,674
3405-000,2018,8,2,24,134,163,297,481
3405-000,2018,8,3,1,103,104,207,297
3405-000,2018,8,3,2,53,69,122,207
3405-000,2018,8,3,3,59,49,108,122
3405-000,2018,8,3,4,51,67,118,108
3405-000,2018,8,3,5,134,95,229,118
3405-000,2018,8,3,6,262,187,449,229
3405-000,2018,8,3,7,637,399,1036,449
3405-000,2018,8,3,8,1016,802,1818,1036
3405-000,2018,8,3,9,1152,910,2062,1818
3405-000,2018,8,3,10,953,777,1730,2062
3405-000,2018,8,3,11,1022,777,1799,1730
3405-000,2018,8,3,12,1030,803,1833,1799
3405-000,2018,8,3,13,838,781,1619,1833
3405-000,2018,8,3,14,922,929,1851,1619
3405-000,2018,8,3,15,935,891,1826,1851
3405-000,2018,8,3,16,954,862,1816,1826
3405-000,2018,8,3,17,1059,851,1910,1816
3405-000,2018,8,3,18,1278,988,2266,1910
3405-000,2018,8,3,19,1173,984,2157,2266
3405-000,2018,8,3,20,721,787,1508,2157
3405-000,2018,8,3,21,571,569,1140,1508
3405-000,2018,8,3,22,370,452,822,1140
3405-000,2018,8,3,23,258,333,591,822
3405-000,2018,8,3,24,158,211,369,591
3405-000,2018,8,4,1,119,108,227,369
3405-000,2018,8,4,2,59,84,143,227
3405-000,2018,8,4,3,64,45,109,143
3405-000,2018,8,4,4,55,69,124,109
3405-000,2018,8,4,5,142,86,228,124
3405-000,2018,8,4,6,272,143,415,228
3405-000,2018,8,4,7,522,288,810,415
3405-000,2018,8,4,8,662,436,1098,810
3405-000,2018,8,4,9,769,595,1364,1098
3405-000,2018,8,4,10,802,644,1446,1364
3405-000,2018,8,4,11,844,719,1563,1446
3405-000,2018,8,4,12,768,700,1468,1563
3405-000,2018,8,4,13,751,787,1538,1468
3405-000,2018,8,4,14,679,735,1414,1538
3405-000,2018,8,4,15,736,699,1435,1414
3405-000,2018,8,4,16,756,640,1396,1435
3405-000,2018,8,4,17,794,697,1491,1396
3405-000,2018,8,4,18,830,705,1535,1491
3405-000,2018,8,4,19,586,643,1229,1535
3405-000,2018,8,4,20,473,519,992,1229
3405-000,2018,8,4,21,336,445,781,992
3405-000,2018,8,4,22,288,370,658,781
3405-000,2018,8,4,23,209,262,471,658
3405-000,2018,8,4,24,145,184,329,471
3405-000,2018,8,5,1,69,126,195,329
3405-000,2018,8,5,2,50,66,116,195
3405-000,2018,8,5,3,30,41,71,116
3405-000,2018,8,5,4,44,37,81,71
3405-000,2018,8,5,5,75,58,133,81
3405-000,2018,8,5,6,184,72,256,133
3405-000,2018,8,5,7,262,179,441,256
3405-000,2018,8,5,8,324,254,578,441
3405-000,2018,8,5,9,460,350,810,578
3405-000,2018,8,5,10,484,379,863,810
3405-000,2018,8,5,11,559,478,1037,863
3405-000,2018,8,5,12,574,478,1052,1037
3405-000,2018,8,5,13,570,524,1094,1052
3405-000,2018,8,5,14,606,582,1188,1094
3405-000,2018,8,5,15,674,621,1295,1188
3405-000,2018,8,5,16,653,655,1308,1295
3405-000,2018,8,5,17,641,662,1303,1308
3405-000,2018,8,5,18,658,647,1305,1303
3405-000,2018,8,5,19,518,600,1118,1305
3405-000,2018,8,5,20,403,529,932,1118
3405-000,2018,8,5,21,410,493,903,932
3405-000,2018,8,5,22,300,430,730,903
3405-000,2018,8,5,23,207,324,531,730
3405-000,2018,8,5,24,138,220,358,531
3405-000,2018,8,6,1,67,129,196,358
3405-000,2018,8,6,2,51,74,125,196
3405-000,2018,8,6,3,43,56,99,125
3405-000,2018,8,6,4,58,59,117,99
3405-000,2018,8,6,5,139,107,246,117
3405-000,2018,8,6,6,363,213,576,246
3405-000,2018,8,6,7,740,607,1347,576
3405-000,2018,8,6,8,1325,1378,2703,1347
3405-000,2018,8,6,9,1340,1322,2662,2703
3405-000,2018,8,6,10,1078,923,2001,2662
3405-000,2018,8,6,11,1110,881,1991,2001
3405-000,2018,8,6,12,1005,892,1897,1991
3405-000,2018,8,6,13,868,842,1710,1897
3405-000,2018,8,6,14,960,1014,1974,1710
3405-000,2018,8,6,15,1053,1004,2057,1974
3405-000,2018,8,6,16,1101,1000,2101,2057
3405-000,2018,8,6,17,1077,930,2007,2101
3405-000,2018,8,6,18,1137,1164,2301,2007
3405-000,2018,8,6,19,1150,1061,2211,2301
3405-000,2018,8,6,20,707,706,1413,2211
3405-000,2018,8,6,21,500,595,1095,1413
3405-000,2018,8,6,22,313,403,716,1095
3405-000,2018,8,6,23,215,229,444,716
3405-000,2018,8,6,24,165,136,301,444
3405-000,2018,8,7,1,78,105,183,301
3405-000,2018,8,7,2,70,62,132,183
3405-000,2018,8,7,3,44,51,95,132
3405-000,2018,8,7,4,72,80,152,95
3405-000,2018,8,7,5,130,107,237,152
3405-000,2018,8,7,6,385,210,595,237
3405-000,2018,8,7,7,708,561,1269,595
3405-000,2018,8,7,8,1310,1294,2604,1269
3405-000,2018,8,7,9,1458,1252,2710,2604
3405-000,2018,8,7,10,1187,1011,2198,2710
3405-000,2018,8,7,11,1106,1017,2123,2198
3405-000,2018,8,7,12,1057,939,1996,2123
3405-000,2018,8,7,13,921,812,1733,1996
3405-000,2018,8,7,14,1005,1008,2013,1733
3405-000,2018,8,7,15,1160,1086,2246,2013
3405-000,2018,8,7,16,1142,1033,2175,2246
3405-000,2018,8,7,17,1055,1037,2092,2175
3405-000,2018,8,7,18,1322,1163,2485,2092
3405-000,2018,8,7,19,1162,1110,2272,2485
3405-000,2018,8,7,20,708,703,1411,2272
3405-000,2018,8,7,21,525,611,1136,1411
3405-000,2018,8,7,22,350,390,740,1136
3405-000,2018,8,7,23,266,225,491,740
3405-000,2018,8,7,24,148,169,317,491
3405-000,2018,8,8,1,93,100,193,317
3405-000,2018,8,8,2,53,80,133,193
3405-000,2018,8,8,3,46,60,106,133
3405-000,2018,8,8,4,74,68,142,106
3405-000,2018,8,8,5,115,104,219,142
3405-000,2018,8,8,6,344,209,553,219
3405-000,2018,8,8,7,713,506,1219,553
3405-000,2018,8,8,8,1331,1279,2610,1219
3405-000,2018,8,8,9,1434,1270,2704,2610
3405-000,2018,8,8,10,1122,969,2091,2704
3405-000,2018,8,8,11,1110,966,2076,2091
3405-000,2018,8,8,12,1071,941,2012,2076
3405-000,2018,8,8,13,904,848,1752,2012
3405-000,2018,8,8,14,1044,979,2023,1752
3405-000,2018,8,8,15,1098,999,2097,2023
3405-000,2018,8,8,16,1120,996,2116,2097
3405-000,2018,8,8,17,1124,1036,2160,2116
3405-000,2018,8,8,18,1370,1239,2609,2160
3405-000,2018,8,8,19,1273,1144,2417,2609
3405-000,2018,8,8,20,744,709,1453,2417
3405-000,2018,8,8,21,504,536,1040,1453
3405-000,2018,8,8,22,361,407,768,1040
3405-000,2018,8,8,23,279,234,513,768
3405-000,2018,8,8,24,134,150,284,513
3405-000,2018,8,9,1,94,107,201,284
3405-000,2018,8,9,2,64,88,152,201
3405-000,2018,8,9,3,54,63,117,152
3405-000,2018,8,9,4,64,68,132,117
3405-000,2018,8,9,5,131,106,237,132
3405-000,2018,8,9,6,362,200,562,237
3405-000,2018,8,9,7,775,530,1305,562
3405-000,2018,8,9,8,1362,1300,2662,1305
3405-000,2018,8,9,9,1459,1285,2744,2662
3405-000,2018,8,9,10,1187,998,2185,2744
3405-000,2018,8,9,11,1118,1022,2140,2185
3405-000,2018,8,9,12,1081,966,2047,2140
3405-000,2018,8,9,13,899,836,1735,2047
3405-000,2018,8,9,14,1023,980,2003,1735
3405-000,2018,8,9,15,1190,1139,2329,2003
3405-000,2018,8,9,16,1076,1074,2150,2329
3405-000,2018,8,9,17,1104,1002,2106,2150
3405-000,2018,8,9,18,1307,1170,2477,2106
3405-000,2018,8,9,19,1207,1077,2284,2477
3405-000,2018,8,9,20,712,708,1420,2284
3405-000,2018,8,9,21,544,576,1120,1420
3405-000,2018,8,9,22,357,389,746,1120
3405-000,2018,8,9,23,288,225,513,746
3405-000,2018,8,9,24,146,172,318,513
3405-000,2018,8,10,1,72,99,171,318
3405-000,2018,8,10,2,58,81,139,171
3405-000,2018,8,10,3,51,69,120,139
3405-000,2018,8,10,4,73,78,151,120
3405-000,2018,8,10,5,153,101,254,151
3405-000,2018,8,10,6,364,235,599,254
3405-000,2018,8,10,7,722,496,1218,599
3405-000,2018,8,10,8,1269,1241,2510,1218
3405-000,2018,8,10,9,1448,1213,2661,2510
3405-000,2018,8,10,10,1192,989,2181,2661
3405-000,2018,8,10,11,1141,1040,2181,2181
3405-000,2018,8,10,12,1172,982,2154,2181
3405-000,2018,8,10,13,937,950,1887,2154
3405-000,2018,8,10,14,1075,1011,2086,1887
3405-000,2018,8,10,15,1223,1123,2346,2086
3405-000,2018,8,10,16,1185,1053,2238,2346
3405-000,2018,8,10,17,1206,1045,2251,2238
3405-000,2018,8,10,18,1612,1282,2894,2251
3405-000,2018,8,10,19,1588,1329,2917,2894
3405-000,2018,8,10,20,981,790,1771,2917
3405-000,2018,8,10,21,640,662,1302,1771
3405-000,2018,8,10,22,475,460,935,1302
3405-000,2018,8,10,23,295,295,590,935
3405-000,2018,8,10,24,183,205,388,590
3405-000,2018,8,11,1,101,117,218,388
3405-000,2018,8,11,2,84,74,158,218
3405-000,2018,8,11,3,48,80,128,158
3405-000,2018,8,11,4,75,76,151,128
3405-000,2018,8,11,5,132,88,220,151
3405-000,2018,8,11,6,318,208,526,220
3405-000,2018,8,11,7,589,393,982,526
3405-000,2018,8,11,8,818,592,1410,982
3405-000,2018,8,11,9,924,704,1628,1410
3405-000,2018,8,11,10,883,720,1603,1628
3405-000,2018,8,11,11,994,915,1909,1603
3405-000,2018,8,11,12,898,793,1691,1909
3405-000,2018,8,11,13,873,748,1621,1691
3405-000,2018,8,11,14,827,689,1516,1621
3405-000,2018,8,11,15,839,695,1534,1516
3405-000,2018,8,11,16,839,760,1599,1534
3405-000,2018,8,11,17,841,774,1615,1599
3405-000,2018,8,11,18,887,823,1710,1615
3405-000,2018,8,11,19,730,749,1479,1710
3405-000,2018,8,11,20,499,548,1047,1479
3405-000,2018,8,11,21,370,425,795,1047
3405-000,2018,8,11,22,299,325,624,795
3405-000,2018,8,11,23,251,260,511,624
3405-000,2018,8,11,24,145,185,330,511
3405-000,2018,8,12,1,79,88,167,330
3405-000,2018,8,12,2,57,52,109,167
3405-000,2018,8,12,3,38,46,84,109
3405-000,2018,8,12,4,45,47,92,84
3405-000,2018,8,12,5,69,47,116,92
3405-000,2018,8,12,6,194,82,276,116
3405-000,2018,8,12,7,325,142,467,276
3405-000,2018,8,12,8,369,276,645,467
3405-000,2018,8,12,9,501,331,832,645
3405-000,2018,8,12,10,515,352,867,832
3405-000,2018,8,12,11,625,445,1070,867
3405-000,2018,8,12,12,595,429,1024,1070
3405-000,2018,8,12,13,511,545,1056,1024
3405-000,2018,8,12,14,589,563,1152,1056
3405-000,2018,8,12,15,614,637,1251,1152
3405-000,2018,8,12,16,600,623,1223,1251
3405-000,2018,8,12,17,638,679,1317,1223
3405-000,2018,8,12,18,566,737,1303,1317
3405-000,2018,8,12,19,517,616,1133,1303
3405-000,2018,8,12,20,390,538,928,1133
3405-000,2018,8,12,21,357,492,849,928
3405-000,2018,8,12,22,299,408,707,849
3405-000,2018,8,12,23,205,273,478,707
3405-000,2018,8,12,24,119,181,300,478
3405-000,2018,8,13,1,69,142,211,300
3405-000,2018,8,13,2,41,74,115,211
3405-000,2018,8,13,3,46,58,104,115
3405-000,2018,8,13,4,51,66,117,104
3405-000,2018,8,13,5,153,95,248,117
3405-000,2018,8,13,6,338,239,577,248
3405-000,2018,8,13,7,783,656,1439,577
3405-000,2018,8,13,8,1398,1516,2914,1439
3405-000,2018,8,13,9,1444,1304,2748,2914
3405-000,2018,8,13,10,1098,984,2082,2748
3405-000,2018,8,13,11,1190,1009,2199,2082
3405-000,2018,8,13,12,1084,988,2072,2199
3405-000,2018,8,13,13,938,847,1785,2072
3405-000,2018,8,13,14,1060,1023,2083,1785
3405-000,2018,8,13,15,1086,1078,2164,2083
3405-000,2018,8,13,16,1116,1066,2182,2164
3405-000,2018,8,13,17,1067,995,2062,2182
3405-000,2018,8,13,18,1245,1198,2443,2062
3405-000,2018,8,13,19,1173,1140,2313,2443
3405-000,2018,8,13,20,715,754,1469,2313
3405-000,2018,8,13,21,534,582,1116,1469
3405-000,2018,8,13,22,347,399,746,1116
3405-000,2018,8,13,23,263,213,476,746
3405-000,2018,8,13,24,125,177,302,476
3405-000,2018,8,14,1,80,114,194,302
3405-000,2018,8,14,2,77,79,156,194
3405-000,2018,8,14,3,63,77,140,156
3405-000,2018,8,14,4,55,84,139,140
3405-000,2018,8,14,5,139,101,240,139
3405-000,2018,8,14,6,366,252,618,240
3405-000,2018,8,14,7,701,555,1256,618
3405-000,2018,8,14,8,1315,1250,2565,1256
3405-000,2018,8,14,9,1468,1318,2786,2565
3405-000,2018,8,14,10,1161,1004,2165,2786
3405-000,2018,8,14,11,1241,1060,2301,2165
3405-000,2018,8,14,12,1130,1137,2267,2301
3405-000,2018,8,14,13,1019,911,1930,2267
3405-000,2018,8,14,14,1096,1048,2144,1930
3405-000,2018,8,14,15,1206,1149,2355,2144
3405-000,2018,8,14,16,1243,1228,2471,2355
3405-000,2018,8,14,17,1211,1137,2348,2471
3405-000,2018,8,14,18,1456,1241,2697,2348
3405-000,2018,8,14,19,1499,1222,2721,2697
3405-000,2018,8,14,20,855,817,1672,2721
3405-000,2018,8,14,21,640,669,1309,1672
3405-000,2018,8,14,22,398,463,861,1309
3405-000,2018,8,14,23,267,268,535,861
3405-000,2018,8,14,24,159,190,349,535
3405-000,2018,8,15,1,102,112,214,349
3405-000,2018,8,15,2,72,77,149,214
3405-000,2018,8,15,3,59,80,139,149
3405-000,2018,8,15,4,65,72,137,139
3405-000,2018,8,15,5,154,81,235,137
3405-000,2018,8,15,6,299,187,486,235
3405-000,2018,8,15,7,541,306,847,486
3405-000,2018,8,15,8,803,595,1398,847
3405-000,2018,8,15,9,848,680,1528,1398
3405-000,2018,8,15,10,894,683,1577,1528
3405-000,2018,8,15,11,878,669,1547,1577
3405-000,2018,8,15,12,815,691,1506,1547
3405-000,2018,8,15,13,707,683,1390,1506
3405-000,2018,8,15,14,709,702,1411,1390
3405-000,2018,8,15,15,709,730,1439,1411
3405-000,2018,8,15,16,730,747,1477,1439
3405-000,2018,8,15,17,753,721,1474,1477
3405-000,2018,8,15,18,864,893,1757,1474
3405-000,2018,8,15,19,634,799,1433,1757
3405-000,2018,8,15,20,502,608,1110,1433
3405-000,2018,8,15,21,384,466,850,1110
3405-000,2018,8,15,22,280,348,628,850
3405-000,2018,8,15,23,223,209,432,628
3405-000,2018,8,15,24,126,144,270,432
3405-000,2018,8,16,1,76,94,170,270
3405-000,2018,8,16,2,50,68,118,170
3405-000,2018,8,16,3,46,56,102,118
3405-000,2018,8,16,4,60,74,134,102
3405-000,2018,8,16,5,127,104,231,134
3405-000,2018,8,16,6,380,219,599,231
3405-000,2018,8,16,7,686,577,1263,599
3405-000,2018,8,16,8,1366,1360,2726,1263
3405-000,2018,8,16,9,1490,1366,2856,2726
3405-000,2018,8,16,10,1125,978,2103,2856
3405-000,2018,8,16,11,1173,1001,2174,2103
3405-000,2018,8,16,12,1161,961,2122,2174
3405-000,2018,8,16,13,947,875,1822,2122
3405-000,2018,8,16,14,1030,1055,2085,1822
3405-000,2018,8,16,15,1164,1113,2277,2085
3405-000,2018,8,16,16,1199,1064,2263,2277
3405-000,2018,8,16,17,1077,1170,2247,2263
3405-000,2018,8,16,18,1155,1171,2326,2247
3405-000,2018,8,16,19,1309,1094,2403,2326
3405-000,2018,8,16,20,739,778,1517,2403
3405-000,2018,8,16,21,509,597,1106,1517
3405-000,2018,8,16,22,387,444,831,1106
3405-000,2018,8,16,23,232,212,444,831
3405-000,2018,8,16,24,130,163,293,444
3405-000,2018,8,17,1,86,97,183,293
3405-000,2018,8,17,2,57,70,127,183
3405-000,2018,8,17,3,46,67,113,127
3405-000,2018,8,17,4,74,86,160,113
3405-000,2018,8,17,5,138,104,242,160
3405-000,2018,8,17,6,316,223,539,242
3405-000,2018,8,17,7,634,546,1180,539
3405-000,2018,8,17,8,1298,1239,2537,1180
3405-000,2018,8,17,9,1495,1274,2769,2537
3405-000,2018,8,17,10,1214,984,2198,2769
3405-000,2018,8,17,11,1202,1050,2252,2198
3405-000,2018,8,17,12,1109,1046,2155,2252
3405-000,2018,8,17,13,947,892,1839,2155
3405-000,2018,8,17,14,1064,1023,2087,1839
3405-000,2018,8,17,15,1205,1004,2209,2087
3405-000,2018,8,17,16,1278,1106,2384,2209
3405-000,2018,8,17,17,1225,1137,2362,2384
3405-000,2018,8,17,18,1573,1239,2812,2362
3405-000,2018,8,17,19,1621,1238,2859,2812
3405-000,2018,8,17,20,978,925,1903,2859
3405-000,2018,8,17,21,684,674,1358,1903
3405-000,2018,8,17,22,418,455,873,1358
3405-000,2018,8,17,23,285,256,541,873
3405-000,2018,8,17,24,167,173,340,541
3405-000,2018,8,18,1,138,107,245,340
3405-000,2018,8,18,2,87,95,182,245
3405-000,2018,8,18,3,61,57,118,182
3405-000,2018,8,18,4,66,79,145,118
3405-000,2018,8,18,5,144,99,243,145
3405-000,2018,8,18,6,293,182,475,243
3405-000,2018,8,18,7,574,339,913,475
3405-000,2018,8,18,8,850,614,1464,913
3405-000,2018,8,18,9,887,716,1603,1464
3405-000,2018,8,18,10,947,790,1737,1603
3405-000,2018,8,18,11,1002,754,1756,1737
3405-000,2018,8,18,12,970,806,1776,1756
3405-000,2018,8,18,13,844,765,1609,1776
3405-000,2018,8,18,14,802,731,1533,1609
3405-000,2018,8,18,15,882,752,1634,1533
3405-000,2018,8,18,16,841,788,1629,1634
3405-000,2018,8,18,17,877,770,1647,1629
3405-000,2018,8,18,18,896,846,1742,1647
3405-000,2018,8,18,19,707,725,1432,1742
3405-000,2018,8,18,20,439,590,1029,1432
3405-000,2018,8,18,21,369,430,799,1029
3405-000,2018,8,18,22,301,312,613,799
3405-000,2018,8,18,23,209,215,424,613
3405-000,2018,8,18,24,141,182,323,424
3405-000,2018,8,19,1,84,125,209,323
3405-000,2018,8,19,2,58,61,119,209
3405-000,2018,8,19,3,41,54,95,119
3405-000,2018,8,19,4,44,50,94,95
3405-000,2018,8,19,5,77,71,148,94
3405-000,2018,8,19,6,144,93,237,148
3405-000,2018,8,19,7,293,188,481,237
3405-000,2018,8,19,8,367,292,659,481
3405-000,2018,8,19,9,411,328,739,659
3405-000,2018,8,19,10,475,378,853,739
3405-000,2018,8,19,11,564,508,1072,853
3405-000,2018,8,19,12,583,524,1107,1072
3405-000,2018,8,19,13,566,516,1082,1107
3405-000,2018,8,19,14,591,643,1234,1082
3405-000,2018,8,19,15,679,600,1279,1234
3405-000,2018,8,19,16,749,585,1334,1279
3405-000,2018,8,19,17,714,705,1419,1334
3405-000,2018,8,19,18,648,653,1301,1419
3405-000,2018,8,19,19,574,624,1198,1301
3405-000,2018,8,19,20,470,611,1081,1198
3405-000,2018,8,19,21,404,499,903,1081
3405-000,2018,8,19,22,298,427,725,903
3405-000,2018,8,19,23,191,332,523,725
3405-000,2018,8,19,24,134,182,316,523
3405-000,2018,8,20,1,53,102,155,316
3405-000,2018,8,20,2,43,55,98,155
3405-000,2018,8,20,3,41,56,97,98
3405-000,2018,8,20,4,51,70,121,97
3405-000,2018,8,20,5,144,104,248,121
3405-000,2018,8,20,6,372,262,634,248
3405-000,2018,8,20,7,782,685,1467,634
3405-000,2018,8,20,8,1425,1553,2978,1467
3405-000,2018,8,20,9,1476,1314,2790,2978
3405-000,2018,8,20,10,1105,1009,2114,2790
3405-000,2018,8,20,11,1165,1034,2199,2114
3405-000,2018,8,20,12,1030,989,2019,2199
3405-000,2018,8,20,13,949,920,1869,2019
3405-000,2018,8,20,14,1017,1040,2057,1869
3405-000,2018,8,20,15,1258,1106,2364,2057
3405-000,2018,8,20,16,1154,1069,2223,2364
3405-000,2018,8,20,17,1161,1004,2165,2223
3405-000,2018,8,20,18,1297,1128,2425,2165
3405-000,2018,8,20,19,1147,1163,2310,2425
3405-000,2018,8,20,20,712,690,1402,2310
3405-000,2018,8,20,21,538,636,1174,1402
3405-000,2018,8,20,22,345,396,741,1174
3405-000,2018,8,20,23,201,218,419,741
3405-000,2018,8,20,24,131,135,266,419
3405-000,2018,8,21,1,77,96,173,266
3405-000,2018,8,21,2,53,79,132,173
3405-000,2018,8,21,3,62,64,126,132
3405-000,2018,8,21,4,61,87,148,126
3405-000,2018,8,21,5,148,116,264,148
3405-000,2018,8,21,6,330,232,562,264
3405-000,2018,8,21,7,680,532,1212,562
3405-000,2018,8,21,8,1309,1334,2643,1212
3405-000,2018,8,21,9,1536,1331,2867,2643
3405-000,2018,8,21,10,1142,1037,2179,2867
3405-000,2018,8,21,11,1150,1052,2202,2179
3405-000,2018,8,21,12,1110,1000,2110,2202
3405-000,2018,8,21,13,918,867,1785,2110
3405-000,2018,8,21,14,1080,1078,2158,1785
3405-000,2018,8,21,15,1205,1137,2342,2158
3405-000,2018,8,21,16,1231,1055,2286,2342
3405-000,2018,8,21,17,1091,1048,2139,2286
3405-000,2018,8,21,18,1332,1148,2480,2139
3405-000,2018,8,21,19,1218,1144,2362,2480
3405-000,2018,8,21,20,742,750,1492,2362
3405-000,2018,8,21,21,555,609,1164,1492
3405-000,2018,8,21,22,392,425,817,1164
3405-000,2018,8,21,23,307,254,561,817
3405-000,2018,8,21,24,148,158,306,561
3405-000,2018,8,22,1,82,90,172,306
3405-000,2018,8,22,2,67,78,145,172
3405-000,2018,8,22,3,47,51,98,145
3405-000,2018,8,22,4,58,83,141,98
3405-000,2018,8,22,5,139,114,253,141
3405-000,2018,8,22,6,341,232,573,253
3405-000,2018,8,22,7,699,533,1232,573
3405-000,2018,8,22,8,1351,1339,2690,1232
3405-000,2018,8,22,9,1534,1358,2892,2690
3405-000,2018,8,22,10,1137,993,2130,2892
3405-000,2018,8,22,11,1170,1082,2252,2130
3405-000,2018,8,22,12,1073,999,2072,2252
3405-000,2018,8,22,13,946,896,1842,2072
3405-000,2018,8,22,14,1107,1072,2179,1842
3405-000,2018,8,22,15,1209,1088,2297,2179
3405-000,2018,8,22,16,1197,1130,2327,2297
3405-000,2018,8,22,17,1181,1160,2341,2327
3405-000,2018,8,22,18,1443,1196,2639,2341
3405-000,2018,8,22,19,1423,1220,2643,2639
3405-000,2018,8,22,20,742,728,1470,2643
3405-000,2018,8,22,21,521,553,1074,1470
3405-000,2018,8,22,22,351,429,780,1074
3405-000,2018,8,22,23,265,223,488,780
3405-000,2018,8,22,24,169,167,336,488
3405-000,2018,8,23,1,74,94,168,336
3405-000,2018,8,23,2,48,84,132,168
3405-000,2018,8,23,3,64,69,133,132
3405-000,2018,8,23,4,63,75,138,133
3405-000,2018,8,23,5,125,100,225,138
3405-000,2018,8,23,6,238,175,413,225
3405-000,2018,8,23,7,618,433,1051,413
3405-000,2018,8,23,8,1335,1269,2604,1051
3405-000,2018,8,23,9,1391,1242,2633,2604
3405-000,2018,8,23,10,1086,912,1998,2633
3405-000,2018,8,23,11,1011,982,1993,1998
3405-000,2018,8,23,12,992,903,1895,1993
3405-000,2018,8,23,13,856,805,1661,1895
3405-000,2018,8,23,14,1016,899,1915,1661
3405-000,2018,8,23,15,1048,965,2013,1915
3405-000,2018,8,23,16,1044,944,1988,2013
3405-000,2018,8,23,17,880,967,1847,1988
3405-000,2018,8,23,18,1119,1000,2119,1847
3405-000,2018,8,23,19,1070,1036,2106,2119
3405-000,2018,8,23,20,609,641,1250,2106
3405-000,2018,8,23,21,414,513,927,1250
3405-000,2018,8,23,22,270,293,563,927
3405-000,2018,8,23,23,157,155,312,563
3405-000,2018,8,23,24,105,109,214,312
3405-000,2018,8,24,1,73,73,146,214
3405-000,2018,8,24,2,40,64,104,146
3405-000,2018,8,24,3,54,46,100,104
3405-000,2018,8,24,4,63,62,125,100
3405-000,2018,8,24,5,86,67,153,125
3405-000,2018,8,24,6,168,134,302,153
3405-000,2018,8,24,7,467,350,817,302
3405-000,2018,8,24,8,1167,981,2148,817
3405-000,2018,8,24,9,1254,1021,2275,2148
3405-000,2018,8,24,10,896,770,1666,2275
3405-000,2018,8,24,11,958,812,1770,1666
3405-000,2018,8,24,12,948,774,1722,1770
3405-000,2018,8,24,13,832,675,1507,1722
3405-000,2018,8,24,14,889,942,1831,1507
3405-000,2018,8,24,15,1011,973,1984,1831
3405-000,2018,8,24,16,1019,884,1903,1984
3405-000,2018,8,24,17,1020,933,1953,1903
3405-000,2018,8,24,18,1426,1066,2492,1953
3405-000,2018,8,24,19,1383,1130,2513,2492
3405-000,2018,8,24,20,776,737,1513,2513
3405-000,2018,8,24,21,605,556,1161,1513
3405-000,2018,8,24,22,378,385,763,1161
3405-000,2018,8,24,23,238,226,464,763
3405-000,2018,8,24,24,180,135,315,464
3405-000,2018,8,25,1,102,102,204,315
3405-000,2018,8,25,2,80,78,158,204
3405-000,2018,8,25,3,64,68,132,158
3405-000,2018,8,25,4,55,73,128,132
3405-000,2018,8,25,5,132,91,223,128
3405-000,2018,8,25,6,313,178,491,223
3405-000,2018,8,25,7,587,370,957,491
3405-000,2018,8,25,8,803,614,1417,957
3405-000,2018,8,25,9,971,689,1660,1417
3405-000,2018,8,25,10,988,716,1704,1660
3405-000,2018,8,25,11,964,793,1757,1704
3405-000,2018,8,25,12,979,731,1710,1757
3405-000,2018,8,25,13,862,718,1580,1710
3405-000,2018,8,25,14,917,745,1662,1580
3405-000,2018,8,25,15,860,711,1571,1662
3405-000,2018,8,25,16,821,765,1586,1571
3405-000,2018,8,25,17,886,742,1628,1586
3405-000,2018,8,25,18,889,887,1776,1628
3405-000,2018,8,25,19,666,696,1362,1776
3405-000,2018,8,25,20,497,509,1006,1362
3405-000,2018,8,25,21,364,412,776,1006
3405-000,2018,8,25,22,319,317,636,776
3405-000,2018,8,25,23,212,262,474,636
3405-000,2018,8,25,24,116,150,266,474
3405-000,2018,8,26,1,72,88,160,266
3405-000,2018,8,26,2,53,61,114,160
3405-000,2018,8,26,3,56,53,109,114
3405-000,2018,8,26,4,28,49,77,109
3405-000,2018,8,26,5,77,43,120,77
3405-000,2018,8,26,6,155,82,237,120
3405-000,2018,8,26,7,295,173,468,237
3405-000,2018,8,26,8,351,248,599,468
3405-000,2018,8,26,9,386,336,722,599
3405-000,2018,8,26,10,459,349,808,722
3405-000,2018,8,26,11,573,442,1015,808
3405-000,2018,8,26,12,558,483,1041,1015
3405-000,2018,8,26,13,533,528,1061,1041
3405-000,2018,8,26,14,561,563,1124,1061
3405-000,2018,8,26,15,610,583,1193,1124
3405-000,2018,8,26,16,674,617,1291,1193
3405-000,2018,8,26,17,665,638,1303,1291
3405-000,2018,8,26,18,611,626,1237,1303
3405-000,2018,8,26,19,519,604,1123,1237
3405-000,2018,8,26,20,400,492,892,1123
3405-000,2018,8,26,21,346,415,761,892
3405-000,2018,8,26,22,218,367,585,761
3405-000,2018,8,26,23,169,274,443,585
3405-000,2018,8,26,24,124,156,280,443
3405-000,2018,8,27,1,71,114,185,280
3405-000,2018,8,27,2,31,66,97,185
3405-000,2018,8,27,3,39,50,89,97
3405-000,2018,8,27,4,50,70,120,89
3405-000,2018,8,27,5,125,88,213,120
3405-000,2018,8,27,6,302,188,490,213
3405-000,2018,8,27,7,654,511,1165,490
3405-000,2018,8,27,8,1262,1318,2580,1165
3405-000,2018,8,27,9,1404,1384,2788,2580
3405-000,2018,8,27,10,1047,879,1926,2788
3405-000,2018,8,27,11,1014,941,1955,1926
3405-000,2018,8,27,12,997,880,1877,1955
3405-000,2018,8,27,13,794,783,1577,1877
3405-000,2018,8,27,14,933,939,1872,1577
3405-000,2018,8,27,15,1015,1026,2041,1872
3405-000,2018,8,27,16,1029,930,1959,2041
3405-000,2018,8,27,17,1034,982,2016,1959
3405-000,2018,8,27,18,1230,1141,2371,2016
3405-000,2018,8,27,19,1162,1031,2193,2371
3405-000,2018,8,27,20,647,646,1293,2193
3405-000,2018,8,27,21,415,552,967,1293
3405-000,2018,8,27,22,324,371,695,967
3405-000,2018,8,27,23,209,205,414,695
3405-000,2018,8,27,24,117,121,238,414
3405-000,2018,8,28,1,77,78,155,238
3405-000,2018,8,28,2,51,76,127,155
3405-000,2018,8,28,3,40,57,97,127
3405-000,2018,8,28,4,58,92,150,97
3405-000,2018,8,28,5,114,84,198,150
3405-000,2018,8,28,6,235,177,412,198
3405-000,2018,8,28,7,570,436,1006,412
3405-000,2018,8,28,8,1254,1178,2432,1006
3405-000,2018,8,28,9,1448,1268,2716,2432
3405-000,2018,8,28,10,1044,928,1972,2716
3405-000,2018,8,28,11,1110,961,2071,1972
3405-000,2018,8,28,12,1037,907,1944,2071
3405-000,2018,8,28,13,821,857,1678,1944
3405-000,2018,8,28,14,1005,944,1949,1678
3405-000,2018,8,28,15,1139,1055,2194,1949
3405-000,2018,8,28,16,1148,1114,2262,2194
3405-000,2018,8,28,17,1032,1006,2038,2262
3405-000,2018,8,28,18,1131,1069,2200,2038
3405-000,2018,8,28,19,1120,1030,2150,2200
3405-000,2018,8,28,20,671,697,1368,2150
3405-000,2018,8,28,21,501,551,1052,1368
3405-000,2018,8,28,22,329,377,706,1052
3405-000,2018,8,28,23,230,201,431,706
3405-000,2018,8,28,24,134,129,263,431
3405-000,2018,8,29,1,84,98,182,263
3405-000,2018,8,29,2,62,70,132,182
3405-000,2018,8,29,3,44,53,97,132
3405-000,2018,8,29,4,70,83,153,97
3405-000,2018,8,29,5,127,99,226,153
3405-000,2018,8,29,6,296,194,490,226
3405-000,2018,8,29,7,632,470,1102,490
3405-000,2018,8,29,8,1267,1296,2563,1102
3405-000,2018,8,29,9,1473,1300,2773,2563
3405-000,2018,8,29,10,1097,989,2086,2773
3405-000,2018,8,29,11,1139,1023,2162,2086
3405-000,2018,8,29,12,1119,987,2106,2162
3405-000,2018,8,29,13,937,858,1795,2106
3405-000,2018,8,29,14,1119,1027,2146,1795
3405-000,2018,8,29,15,1149,1036,2185,2146
3405-000,2018,8,29,16,1105,1039,2144,2185
3405-000,2018,8,29,17,1055,993,2048,2144
3405-000,2018,8,29,18,1474,1263,2737,2048
3405-000,2018,8,29,19,1337,1105,2442,2737
3405-000,2018,8,29,20,613,600,1213,2442
3405-000,2018,8,29,21,454,491,945,1213
3405-000,2018,8,29,22,336,328,664,945
3405-000,2018,8,29,23,224,205,429,664
3405-000,2018,8,29,24,127,129,256,429
3405-000,2018,8,30,1,96,83,179,256
3405-000,2018,8,30,2,49,61,110,179
3405-000,2018,8,30,3,50,56,106,110
3405-000,2018,8,30,4,75,90,165,106
3405-000,2018,8,30,5,107,90,197,165
3405-000,2018,8,30,6,303,185,488,197
3405-000,2018,8,30,7,631,484,1115,488
3405-000,2018,8,30,8,1187,1193,2380,1115
3405-000,2018,8,30,9,1475,1362,2837,2380
3405-000,2018,8,30,10,1191,1071,2262,2837
3405-000,2018,8,30,11,1162,1325,2487,2262
3405-000,2018,8,30,12,1074,988,2062,2487
3405-000,2018,8,30,13,878,858,1736,2062
3405-000,2018,8,30,14,967,931,1898,1736
3405-000,2018,8,30,15,1058,996,2054,1898
3405-000,2018,8,30,16,996,982,1978,2054
3405-000,2018,8,30,17,1062,1007,2069,1978
3405-000,2018,8,30,18,1210,1115,2325,2069
3405-000,2018,8,30,19,1264,1092,2356,2325
3405-000,2018,8,30,20,740,694,1434,2356
3405-000,2018,8,30,21,502,562,1064,1434
3405-000,2018,8,30,22,294,333,627,1064
3405-000,2018,8,30,23,200,216,416,627
3405-000,2018,8,30,24,122,124,246,416
3405-000,2018,8,31,1,79,89,168,246
3405-000,2018,8,31,2,69,75,144,168
3405-000,2018,8,31,3,49,62,111,144
3405-000,2018,8,31,4,58,79,137,111
3405-000,2018,8,31,5,119,97,216,137
3405-000,2018,8,31,6,285,190,475,216
3405-000,2018,8,31,7,625,477,1102,475
3405-000,2018,8,31,8,1254,1182,2436,1102
3405-000,2018,8,31,9,1485,1332,2817,2436
3405-000,2018,8,31,10,1075,949,2024,2817
3405-000,2018,8,31,11,1142,1041,2183,2024
3405-000,2018,8,31,12,1210,917,2127,2183
3405-000,2018,8,31,13,986,910,1896,2127
3405-000,2018,8,31,14,1088,1057,2145,1896
3405-000,2018,8,31,15,1209,1090,2299,2145
3405-000,2018,8,31,16,1382,1074,2456,2299
3405-000,2018,8,31,17,1245,1163,2408,2456
3405-000,2018,8,31,18,1657,1237,2894,2408
3405-000,2018,8,31,19,1707,1227,2934,2894
3405-000,2018,8,31,20,1030,896,1926,2934
3405-000,2018,8,31,21,704,655,1359,1926
3405-000,2018,8,31,22,435,440,875,1359
3405-000,2018,8,31,23,298,273,571,875
3405-000,2018,8,31,24,187,208,395,571
3405-000,2018,9,1,1,125,127,252,395
3405-000,2018,9,1,2,78,65,143,252
3405-000,2018,9,1,3,66,78,144,143
3405-000,2018,9,1,4,78,87,165,144
3405-000,2018,9,1,5,121,105,226,165
3405-000,2018,9,1,6,297,171,468,226
3405-000,2018,9,1,7,587,412,999,468
3405-000,2018,9,1,8,834,651,1485,999
3405-000,2018,9,1,9,1011,797,1808,1485
3405-000,2018,9,1,10,1005,808,1813,1808
3405-000,2018,9,1,11,1018,810,1828,1813
3405-000,2018,9,1,12,1053,839,1892,1828
3405-000,2018,9,1,13,916,772,1688,1892
3405-000,2018,9,1,14,877,792,1669,1688
3405-000,2018,9,1,15,942,828,1770,1669
3405-000,2018,9,1,16,914,838,1752,1770
3405-000,2018,9,1,17,933,908,1841,1752
3405-000,2018,9,1,18,975,851,1826,1841
3405-000,2018,9,1,19,742,780,1522,1826
3405-000,2018,9,1,20,533,580,1113,1522
3405-000,2018,9,1,21,366,411,777,1113
3405-000,2018,9,1,22,245,299,544,777
3405-000,2018,9,1,23,170,200,370,544
3405-000,2018,9,1,24,162,161,323,370
3405-000,2018,9,2,1,101,89,190,323
3405-000,2018,9,2,2,67,69,136,190
3405-000,2018,9,2,3,37,39,76,136
3405-000,2018,9,2,4,41,53,94,76
3405-000,2018,9,2,5,85,43,128,94
3405-000,2018,9,2,6,172,86,258,128
3405-000,2018,9,2,7,326,197,523,258
3405-000,2018,9,2,8,450,312,762,523
3405-000,2018,9,2,9,481,360,841,762
3405-000,2018,9,2,10,599,417,1016,841
3405-000,2018,9,2,11,633,477,1110,1016
3405-000,2018,9,2,12,682,573,1255,1110
3405-000,2018,9,2,13,577,553,1130,1255
3405-000,2018,9,2,14,639,710,1349,1130
3405-000,2018,9,2,15,725,644,1369,1349
3405-000,2018,9,2,16,806,782,1588,1369
3405-000,2018,9,2,17,811,729,1540,1588
3405-000,2018,9,2,18,794,779,1573,1540
3405-000,2018,9,2,19,670,708,1378,1573
3405-000,2018,9,2,20,532,575,1107,1378
3405-000,2018,9,2,21,407,472,879,1107
3405-000,2018,9,2,22,338,441,779,879
3405-000,2018,9,2,23,211,294,505,779
3405-000,2018,9,2,24,133,201,334,505
3405-000,2018,9,3,1,86,124,210,334
3405-000,2018,9,3,2,37,56,93,210
3405-000,2018,9,3,3,45,49,94,93
3405-000,2018,9,3,4,52,67,119,94
3405-000,2018,9,3,5,154,133,287,119
3405-000,2018,9,3,6,360,248,608,287
3405-000,2018,9,3,7,765,655,1420,608
3405-000,2018,9,3,8,1421,1550,2971,1420
3405-000,2018,9,3,9,1497,1408,2905,2971
3405-000,2018,9,3,10,1104,934,2038,2905
3405-000,2018,9,3,11,1099,1043,2142,2038
3405-000,2018,9,3,12,1038,948,1986,2142
3405-000,2018,9,3,13,899,848,1747,1986
3405-000,2018,9,3,14,1019,1017,2036,1747
3405-000,2018,9,3,15,1160,1061,2221,2036
3405-000,2018,9,3,16,1101,1077,2178,2221
3405-000,2018,9,3,17,1120,1011,2131,2178
3405-000,2018,9,3,18,1275,1198,2473,2131
3405-000,2018,9,3,19,1423,1080,2503,2473
3405-000,2018,9,3,20,784,667,1451,2503
3405-000,2018,9,3,21,492,544,1036,1451
3405-000,2018,9,3,22,334,349,683,1036
3405-000,2018,9,3,23,209,207,416,683
3405-000,2018,9,3,24,113,108,221,416
3405-000,2018,9,4,1,60,72,132,221
3405-000,2018,9,4,2,44,58,102,132
3405-000,2018,9,4,3,34,59,93,102
3405-000,2018,9,4,4,86,97,183,93
3405-000,2018,9,4,5,115,116,231,183
3405-000,2018,9,4,6,290,216,506,231
3405-000,2018,9,4,7,642,494,1136,506
3405-000,2018,9,4,8,1359,1316,2675,1136
3405-000,2018,9,4,9,1483,1354,2837,2675
3405-000,2018,9,4,10,1181,1014,2195,2837
3405-000,2018,9,4,11,1175,1029,2204,2195
3405-000,2018,9,4,12,1102,1061,2163,2204
3405-000,2018,9,4,13,941,871,1812,2163
3405-000,2018,9,4,14,1103,1025,2128,1812
3405-000,2018,9,4,15,1181,1140,2321,2128
3405-000,2018,9,4,16,1164,1058,2222,2321
3405-000,2018,9,4,17,1237,1098,2335,2222
3405-000,2018,9,4,18,1375,1261,2636,2335
3405-000,2018,9,4,19,1268,1187,2455,2636
3405-000,2018,9,4,20,786,780,1566,2455
3405-000,2018,9,4,21,496,600,1096,1566
3405-000,2018,9,4,22,351,384,735,1096
3405-000,2018,9,4,23,292,276,568,735
3405-000,2018,9,4,24,136,144,280,568
3405-000,2018,9,5,1,115,96,211,280
3405-000,2018,9,5,2,55,61,116,211
3405-000,2018,9,5,3,66,56,122,116
3405-000,2018,9,5,4,80,91,171,122
3405-000,2018,9,5,5,128,109,237,171
3405-000,2018,9,5,6,293,227,520,237
3405-000,2018,9,5,7,762,530,1292,520
3405-000,2018,9,5,8,1373,1395,2768,1292
3405-000,2018,9,5,9,1582,1361,2943,2768
3405-000,2018,9,5,10,1200,1050,2250,2943
3405-000,2018,9,5,11,1129,1379,2508,2250
3405-000,2018,9,5,12,1069,1241,2310,2508
3405-000,2018,9,5,13,967,983,1950,2310
3405-000,2018,9,5,14,1121,1002,2123,1950
3405-000,2018,9,5,15,1280,1169,2449,2123
3405-000,2018,9,5,16,1254,1094,2348,2449
3405-000,2018,9,5,17,1130,1122,2252,2348
3405-000,2018,9,5,18,1534,1284,2818,2252
3405-000,2018,9,5,19,1369,1226,2595,2818
3405-000,2018,9,5,20,796,768,1564,2595
3405-000,2018,9,5,21,501,574,1075,1564
3405-000,2018,9,5,22,318,389,707,1075
3405-000,2018,9,5,23,230,223,453,707
3405-000,2018,9,5,24,139,177,316,453
3405-000,2018,9,6,1,95,111,206,316
3405-000,2018,9,6,2,58,94,152,206
3405-000,2018,9,6,3,59,66,125,152
3405-000,2018,9,6,4,59,96,155,125
3405-000,2018,9,6,5,125,124,249,155
3405-000,2018,9,6,6,331,212,543,249
3405-000,2018,9,6,7,734,515,1249,543
3405-000,2018,9,6,8,1426,1358,2784,1249
3405-000,2018,9,6,9,1559,1352,2911,2784
3405-000,2018,9,6,10,1253,1015,2268,2911
3405-000,2018,9,6,11,1222,1185,2407,2268
3405-000,2018,9,6,12,1055,1453,2508,2407
3405-000,2018,9,6,13,954,1267,2221,2508
3405-000,2018,9,6,14,1161,1227,2388,2221
3405-000,2018,9,6,15,1239,1181,2420,2388
3405-000,2018,9,6,16,1211,1111,2322,2420
3405-000,2018,9,6,17,1157,1145,2302,2322
3405-000,2018,9,6,18,1467,1525,2992,2302
3405-000,2018,9,6,19,1429,1232,2661,2992
3405-000,2018,9,6,20,763,744,1507,2661
3405-000,2018,9,6,21,523,614,1137,1507
3405-000,2018,9,6,22,366,437,803,1137
3405-000,2018,9,6,23,232,205,437,803
3405-000,2018,9,6,24,149,179,328,437
3405-000,2018,9,7,1,92,83,175,328
3405-000,2018,9,7,2,58,68,126,175
3405-000,2018,9,7,3,62,50,112,126
3405-000,2018,9,7,4,70,91,161,112
3405-000,2018,9,7,5,115,101,216,161
3405-000,2018,9,7,6,284,217,501,216
3405-000,2018,9,7,7,697,550,1247,501
3405-000,2018,9,7,8,1371,1300,2671,1247
3405-000,2018,9,7,9,1495,1279,2774,2671
3405-000,2018,9,7,10,1199,1007,2206,2774
3405-000,2018,9,7,11,1231,1070,2301,2206
3405-000,2018,9,7,12,1197,1053,2250,2301
3405-000,2018,9,7,13,1149,1239,2388,2250
3405-000,2018,9,7,14,1168,1048,2216,2388
3405-000,2018,9,7,15,1287,1148,2435,2216
3405-000,2018,9,7,16,1251,1091,2342,2435
3405-000,2018,9,7,17,1259,1256,2515,2342
3405-000,2018,9,7,18,1775,1347,3122,2515
3405-000,2018,9,7,19,1748,1392,3140,3122
3405-000,2018,9,7,20,1073,881,1954,3140
3405-000,2018,9,7,21,667,693,1360,1954
3405-000,2018,9,7,22,456,423,879,1360
3405-000,2018,9,7,23,301,268,569,879
3405-000,2018,9,7,24,174,168,342,569
3405-000,2018,9,8,1,117,109,226,342
3405-000,2018,9,8,2,72,72,144,226
3405-000,2018,9,8,3,56,66,122,144
3405-000,2018,9,8,4,71,95,166,122
3405-000,2018,9,8,5,155,97,252,166
3405-000,2018,9,8,6,338,199,537,252
3405-000,2018,9,8,7,654,424,1078,537
3405-000,2018,9,8,8,918,670,1588,1078
3405-000,2018,9,8,9,1060,892,1952,1588
3405-000,2018,9,8,10,994,930,1924,1952
3405-000,2018,9,8,11,1020,958,1978,1924
3405-000,2018,9,8,12,907,1335,2242,1978
3405-000,2018,9,8,13,837,981,1818,2242
3405-000,2018,9,8,14,921,881,1802,1818
3405-000,2018,9,8,15,997,887,1884,1802
3405-000,2018,9,8,16,1062,923,1985,1884
3405-000,2018,9,8,17,981,927,1908,1985
3405-000,2018,9,8,18,1298,1009,2307,1908
3405-000,2018,9,8,19,1107,903,2010,2307
3405-000,2018,9,8,20,720,672,1392,2010
3405-000,2018,9,8,21,476,490,966,1392
3405-000,2018,9,8,22,307,423,730,966
3405-000,2018,9,8,23,209,325,534,730
3405-000,2018,9,8,24,159,190,349,534
3405-000,2018,9,9,1,91,112,203,349
3405-000,2018,9,9,2,60,51,111,203
3405-000,2018,9,9,3,42,36,78,111
3405-000,2018,9,9,4,40,48,88,78
3405-000,2018,9,9,5,87,51,138,88
3405-000,2018,9,9,6,214,100,314,138
3405-000,2018,9,9,7,414,221,635,314
3405-000,2018,9,9,8,589,390,979,635
3405-000,2018,9,9,9,560,376,936,979
3405-000,2018,9,9,10,561,439,1000,936
3405-000,2018,9,9,11,773,497,1270,1000
3405-000,2018,9,9,12,701,564,1265,1270
3405-000,2018,9,9,13,678,616,1294,1265
3405-000,2018,9,9,14,784,667,1451,1294
3405-000,2018,9,9,15,862,734,1596,1451
3405-000,2018,9,9,16,869,812,1681,1596
3405-000,2018,9,9,17,861,895,1756,1681
3405-000,2018,9,9,18,847,934,1781,1756
3405-000,2018,9,9,19,770,862,1632,1781
3405-000,2018,9,9,20,686,791,1477,1632
3405-000,2018,9,9,21,556,564,1120,1477
3405-000,2018,9,9,22,355,478,833,1120
3405-000,2018,9,9,23,250,382,632,833
3405-000,2018,9,9,24,139,223,362,632
3405-000,2018,9,10,1,70,119,189,362
3405-000,2018,9,10,2,44,79,123,189
3405-000,2018,9,10,3,38,67,105,123
3405-000,2018,9,10,4,54,80,134,105
3405-000,2018,9,10,5,140,89,229,134
3405-000,2018,9,10,6,348,258,606,229
3405-000,2018,9,10,7,832,704,1536,606
3405-000,2018,9,10,8,1437,1538,2975,1536
3405-000,2018,9,10,9,1546,1500,3046,2975
3405-000,2018,9,10,10,1175,1011,2186,3046
3405-000,2018,9,10,11,1186,1027,2213,2186
3405-000,2018,9,10,12,1092,1014,2106,2213
3405-000,2018,9,10,13,981,933,1914,2106
3405-000,2018,9,10,14,1194,1106,2300,1914
3405-000,2018,9,10,15,1223,1223,2446,2300
3405-000,2018,9,10,16,1188,1179,2367,2446
3405-000,2018,9,10,17,1182,1186,2368,2367
3405-000,2018,9,10,18,1454,1321,2775,2368
3405-000,2018,9,10,19,1262,1100,2362,2775
3405-000,2018,9,10,20,823,806,1629,2362
3405-000,2018,9,10,21,556,644,1200,1629
3405-000,2018,9,10,22,368,434,802,1200
3405-000,2018,9,10,23,242,256,498,802
3405-000,2018,9,10,24,129,144,273,498
3405-000,2018,9,11,1,91,109,200,273
3405-000,2018,9,11,2,78,77,155,200
3405-000,2018,9,11,3,49,59,108,155
3405-000,2018,9,11,4,74,90,164,108
3405-000,2018,9,11,5,132,122,254,164
3405-000,2018,9,11,6,309,246,555,254
3405-000,2018,9,11,7,772,544,1316,555
3405-000,2018,9,11,8,1418,1389,2807,1316
3405-000,2018,9,11,9,1526,1375,2901,2807
3405-000,2018,9,11,10,1252,1084,2336,2901
3405-000,2018,9,11,11,1205,1018,2223,2336
3405-000,2018,9,11,12,1107,1031,2138,2223
3405-000,2018,9,11,13,1027,909,1936,2138
3405-000,2018,9,11,14,1088,1053,2141,1936
3405-000,2018,9,11,15,1334,1116,2450,2141
3405-000,2018,9,11,16,1259,1154,2413,2450
3405-000,2018,9,11,17,1184,1182,2366,2413
3405-000,2018,9,11,18,1435,1258,2693,2366
3405-000,2018,9,11,19,1312,1131,2443,2693
3405-000,2018,9,11,20,744,816,1560,2443
3405-000,2018,9,11,21,521,594,1115,1560
3405-000,2018,9,11,22,396,411,807,1115
3405-000,2018,9,11,23,265,255,520,807
3405-000,2018,9,11,24,138,157,295,520
3405-000,2018,9,12,1,111,115,226,295
3405-000,2018,9,12,2,60,66,126,226
3405-000,2018,9,12,3,64,59,123,126
3405-000,2018,9,12,4,75,83,158,123
3405-000,2018,9,12,5,134,112,246,158
3405-000,2018,9,12,6,304,200,504,246
3405-000,2018,9,12,7,703,572,1275,504
3405-000,2018,9,12,8,1419,1394,2813,1275
3405-000,2018,9,12,9,1575,1321,2896,2813
3405-000,2018,9,12,10,1281,1077,2358,2896
3405-000,2018,9,12,11,1237,1080,2317,2358
3405-000,2018,9,12,12,1184,1064,2248,2317
3405-000,2018,9,12,13,1045,885,1930,2248
3405-000,2018,9,12,14,1112,1233,2345,1930
3405-000,2018,9,12,15,1216,1313,2529,2345
3405-000,2018,9,12,16,1249,1135,2384,2529
3405-000,2018,9,12,17,1201,1133,2334,2384
3405-000,2018,9,12,18,1620,1294,2914,2334
3405-000,2018,9,12,19,1446,1199,2645,2914
3405-000,2018,9,12,20,786,763,1549,2645
3405-000,2018,9,12,21,535,556,1091,1549
3405-000,2018,9,12,22,341,360,701,1091
3405-000,2018,9,12,23,243,233,476,701
3405-000,2018,9,12,24,131,137,268,476
3405-000,2018,9,13,1,87,107,194,268
3405-000,2018,9,13,2,65,78,143,194
3405-000,2018,9,13,3,58,66,124,143
3405-000,2018,9,13,4,73,82,155,124
3405-000,2018,9,13,5,150,121,271,155
3405-000,2018,9,13,6,314,217,531,271
3405-000,2018,9,13,7,750,578,1328,531
3405-000,2018,9,13,8,1423,1394,2817,1328
3405-000,2018,9,13,9,1553,1392,2945,2817
3405-000,2018,9,13,10,1216,1043,2259,2945
3405-000,2018,9,13,11,1186,1075,2261,2259
3405-000,2018,9,13,12,1142,996,2138,2261
3405-000,2018,9,13,13,1024,886,1910,2138
3405-000,2018,9,13,14,1128,1016,2144,1910
3405-000,2018,9,13,15,1293,1119,2412,2144
3405-000,2018,9,13,16,1291,1156,2447,2412
3405-000,2018,9,13,17,1151,1146,2297,2447
3405-000,2018,9,13,18,1407,1276,2683,2297
3405-000,2018,9,13,19,1232,1145,2377,2683
3405-000,2018,9,13,20,827,816,1643,2377
3405-000,2018,9,13,21,591,670,1261,1643
3405-000,2018,9,13,22,407,462,869,1261
3405-000,2018,9,13,23,245,244,489,869
3405-000,2018,9,13,24,171,180,351,489
3405-000,2018,9,14,1,101,109,210,351
3405-000,2018,9,14,2,69,81,150,210
3405-000,2018,9,14,3,46,74,120,150
3405-000,2018,9,14,4,72,100,172,120
3405-000,2018,9,14,5,140,97,237,172
3405-000,2018,9,14,6,316,252,568,237
3405-000,2018,9,14,7,706,559,1265,568
3405-000,2018,9,14,8,1399,1420,2819,1265
3405-000,2018,9,14,9,1564,1383,2947,2819
3405-000,2018,9,14,10,1252,1073,2325,2947
3405-000,2018,9,14,11,1262,1146,2408,2325
3405-000,2018,9,14,12,1145,1009,2154,2408
3405-000,2018,9,14,13,970,891,1861,2154
3405-000,2018,9,14,14,1144,1096,2240,1861
3405-000,2018,9,14,15,1311,1146,2457,2240
3405-000,2018,9,14,16,1342,1141,2483,2457
3405-000,2018,9,14,17,1289,1136,2425,2483
3405-000,2018,9,14,18,1738,1310,3048,2425
3405-000,2018,9,14,19,1625,1271,2896,3048
3405-000,2018,9,14,20,1119,901,2020,2896
3405-000,2018,9,14,21,681,630,1311,2020
3405-000,2018,9,14,22,441,453,894,1311
3405-000,2018,9,14,23,261,266,527,894
3405-000,2018,9,14,24,162,180,342,527
3405-000,2018,9,15,1,99,97,196,342
3405-000,2018,9,15,2,70,79,149,196
3405-000,2018,9,15,3,55,66,121,149
3405-000,2018,9,15,4,73,91,164,121
3405-000,2018,9,15,5,146,107,253,164
3405-000,2018,9,15,6,333,190,523,253
3405-000,2018,9,15,7,563,364,927,523
3405-000,2018,9,15,8,879,637,1516,927
3405-000,2018,9,15,9,949,787,1736,1516
3405-000,2018,9,15,10,1027,809,1836,1736
3405-000,2018,9,15,11,1115,849,1964,1836
3405-000,2018,9,15,12,1110,825,1935,1964
3405-000,2018,9,15,13,987,840,1827,1935
3405-000,2018,9,15,14,956,805,1761,1827
3405-000,2018,9,15,15,970,846,1816,1761
3405-000,2018,9,15,16,1073,891,1964,1816
3405-000,2018,9,15,17,1010,808,1818,1964
3405-000,2018,9,15,18,1050,921,1971,1818
3405-000,2018,9,15,19,857,739,1596,1971
3405-000,2018,9,15,20,507,552,1059,1596
3405-000,2018,9,15,21,397,418,815,1059
3405-000,2018,9,15,22,281,251,532,815
3405-000,2018,9,15,23,203,225,428,532
3405-000,2018,9,15,24,136,151,287,428
3405-000,2018,9,16,1,83,90,173,287
3405-000,2018,9,16,2,59,45,104,173
3405-000,2018,9,16,3,47,49,96,104
3405-000,2018,9,16,4,48,56,104,96
3405-000,2018,9,16,5,72,45,117,104
3405-000,2018,9,16,6,184,109,293,117
3405-000,2018,9,16,7,362,220,582,293
3405-000,2018,9,16,8,506,339,845,582
3405-000,2018,9,16,9,596,457,1053,845
3405-000,2018,9,16,10,609,395,1004,1053
3405-000,2018,9,16,11,707,513,1220,1004
3405-000,2018,9,16,12,630,609,1239,1220
3405-000,2018,9,16,13,639,603,1242,1239
3405-000,2018,9,16,14,748,687,1435,1242
3405-000,2018,9,16,15,844,736,1580,1435
3405-000,2018,9,16,16,805,774,1579,1580
3405-000,2018,9,16,17,785,759,1544,1579
3405-000,2018,9,16,18,848,868,1716,1544
3405-000,2018,9,16,19,620,768,1388,1716
3405-000,2018,9,16,20,488,614,1102,1388
3405-000,2018,9,16,21,427,481,908,1102
3405-000,2018,9,16,22,290,332,622,908
3405-000,2018,9,16,23,210,275,485,622
3405-000,2018,9,16,24,135,168,303,485
3405-000,2018,9,17,1,82,102,184,303
3405-000,2018,9,17,2,39,68,107,184
3405-000,2018,9,17,3,39,39,78,107
3405-000,2018,9,17,4,80,80,160,78
3405-000,2018,9,17,5,165,99,264,160
3405-000,2018,9,17,6,353,270,623,264
3405-000,2018,9,17,7,792,679,1471,623
3405-000,2018,9,17,8,1531,1606,3137,1471
3405-000,2018,9,17,9,1647,1441,3088,3137
3405-000,2018,9,17,10,1167,1044,2211,3088
3405-000,2018,9,17,11,1226,1085,2311,2211
3405-000,2018,9,17,12,1126,1043,2169,2311
3405-000,2018,9,17,13,996,933,1929,2169
3405-000,2018,9,17,14,1128,1060,2188,1929
3405-000,2018,9,17,15,1255,1216,2471,2188
3405-000,2018,9,17,16,1347,1144,2491,2471
3405-000,2018,9,17,17,1308,1196,2504,2491
3405-000,2018,9,17,18,1406,1252,2658,2504
3405-000,2018,9,17,19,1386,1087,2473,2658
3405-000,2018,9,17,20,811,801,1612,2473
3405-000,2018,9,17,21,571,607,1178,1612
3405-000,2018,9,17,22,431,469,900,1178
3405-000,2018,9,17,23,257,217,474,900
3405-000,2018,9,17,24,157,171,328,474
3405-000,2018,9,18,1,103,118,221,328
3405-000,2018,9,18,2,68,70,138,221
3405-000,2018,9,18,3,56,64,120,138
3405-000,2018,9,18,4,69,92,161,120
3405-000,2018,9,18,5,138,115,253,161
3405-000,2018,9,18,6,338,234,572,253
3405-000,2018,9,18,7,707,519,1226,572
3405-000,2018,9,18,8,1482,1473,2955,1226
3405-000,2018,9,18,9,1576,1425,3001,2955
3405-000,2018,9,18,10,1306,1111,2417,3001
3405-000,2018,9,18,11,1284,1108,2392,2417
3405-000,2018,9,18,12,1104,1046,2150,2392
3405-000,2018,9,18,13,973,945,1918,2150
3405-000,2018,9,18,14,1187,888,2075,1918
3405-000,2018,9,18,15,1299,1211,2510,2075
3405-000,2018,9,18,16,1252,1195,2447,2510
3405-000,2018,9,18,17,1166,1130,2296,2447
3405-000,2018,9,18,18,1507,1308,2815,2296
3405-000,2018,9,18,19,1402,1174,2576,2815
3405-000,2018,9,18,20,835,784,1619,2576
3405-000,2018,9,18,21,616,613,1229,1619
3405-000,2018,9,18,22,421,468,889,1229
3405-000,2018,9,18,23,316,241,557,889
3405-000,2018,9,18,24,149,176,325,557
3405-000,2018,9,19,1,83,103,186,325
3405-000,2018,9,19,2,75,105,180,186
3405-000,2018,9,19,3,58,61,119,180
3405-000,2018,9,19,4,87,81,168,119
3405-000,2018,9,19,5,129,120,249,168
3405-000,2018,9,19,6,325,265,590,249
3405-000,2018,9,19,7,767,596,1363,590
3405-000,2018,9,19,8,1490,1462,2952,1363
3405-000,2018,9,19,9,1578,1391,2969,2952
3405-000,2018,9,19,10,1270,1134,2404,2969
3405-000,2018,9,19,11,1277,1130,2407,2404
3405-000,2018,9,19,12,1289,1150,2439,2407
3405-000,2018,9,19,13,1085,934,2019,2439
3405-000,2018,9,19,14,1237,1118,2355,2019
3405-000,2018,9,19,15,1361,1241,2602,2355
3405-000,2018,9,19,16,1330,1114,2444,2602
3405-000,2018,9,19,17,1381,1128,2509,2444
3405-000,2018,9,19,18,1742,1289,3031,2509
3405-000,2018,9,19,19,1531,1254,2785,3031
3405-000,2018,9,19,20,890,772,1662,2785
3405-000,2018,9,19,21,576,608,1184,1662
3405-000,2018,9,19,22,402,423,825,1184
3405-000,2018,9,19,23,294,228,522,825
3405-000,2018,9,19,24,174,157,331,522
3405-000,2018,9,20,1,108,24,132,331
3405-000,2018,9,20,2,71,88,159,132
3405-000,2018,9,20,3,50,50,100,159
3405-000,2018,9,20,4,71,87,158,100
3405-000,2018,9,20,5,140,122,262,158
3405-000,2018,9,20,6,318,210,528,262
3405-000,2018,9,20,7,713,508,1221,528
3405-000,2018,9,20,8,1370,1322,2692,1221
3405-000,2018,9,20,9,1488,1414,2902,2692
3405-000,2018,9,20,10,1218,1108,2326,2902
3405-000,2018,9,20,11,1310,1163,2473,2326
3405-000,2018,9,20,12,1230,1088,2318,2473
3405-000,2018,9,20,13,1079,930,2009,2318
3405-000,2018,9,20,14,1239,1157,2396,2009
3405-000,2018,9,20,15,1285,1223,2508,2396
3405-000,2018,9,20,16,1325,1204,2529,2508
3405-000,2018,9,20,17,1258,1175,2433,2529
3405-000,2018,9,20,18,1480,1269,2749,2433
3405-000,2018,9,20,19,1428,1176,2604,2749
3405-000,2018,9,20,20,887,708,1595,2604
3405-000,2018,9,20,21,576,627,1203,1595
3405-000,2018,9,20,22,415,402,817,1203
3405-000,2018,9,20,23,272,243,515,817
3405-000,2018,9,20,24,160,178,338,515
3405-000,2018,9,21,1,105,126,231,338
3405-000,2018,9,21,2,74,89,163,231
3405-000,2018,9,21,3,52,61,113,163
3405-000,2018,9,21,4,74,81,155,113
3405-000,2018,9,21,5,140,92,232,155
3405-000,2018,9,21,6,267,222,489,232
3405-000,2018,9,21,7,590,478,1068,489
3405-000,2018,9,21,8,1256,1202,2458,1068
3405-000,2018,9,21,9,1459,1395,2854,2458
3405-000,2018,9,21,10,1180,988,2168,2854
3405-000,2018,9,21,11,1184,1133,2317,2168
3405-000,2018,9,21,12,1281,1051,2332,2317
3405-000,2018,9,21,13,1144,943,2087,2332
3405-000,2018,9,21,14,1200,1040,2240,2087
3405-000,2018,9,21,15,1339,1104,2443,2240
3405-000,2018,9,21,16,1446,1295,2741,2443
3405-000,2018,9,21,17,1529,1171,2700,2741
3405-000,2018,9,21,18,1685,1299,2984,2700
3405-000,2018,9,21,19,1192,1067,2259,2984
3405-000,2018,9,21,20,785,650,1435,2259
3405-000,2018,9,21,21,568,482,1050,1435
3405-000,2018,9,21,22,384,357,741,1050
3405-000,2018,9,21,23,315,235,550,741
3405-000,2018,9,21,24,156,158,314,550
3405-000,2018,9,22,1,140,112,252,314
3405-000,2018,9,22,2,97,82,179,252
3405-000,2018,9,22,3,88,69,157,179
3405-000,2018,9,22,4,67,83,150,157
3405-000,2018,9,22,5,179,112,291,150
3405-000,2018,9,22,6,252,158,410,291
3405-000,2018,9,22,7,469,308,777,410
3405-000,2018,9,22,8,745,537,1282,777
3405-000,2018,9,22,9,805,646,1451,1282
3405-000,2018,9,22,10,839,765,1604,1451
3405-000,2018,9,22,11,939,955,1894,1604
3405-000,2018,9,22,12,901,1080,1981,1894
3405-000,2018,9,22,13,805,910,1715,1981
3405-000,2018,9,22,14,801,843,1644,1715
3405-000,2018,9,22,15,818,866,1684,1644
3405-000,2018,9,22,16,885,907,1792,1684
3405-000,2018,9,22,17,800,868,1668,1792
3405-000,2018,9,22,18,810,965,1775,1668
3405-000,2018,9,22,19,600,821,1421,1775
3405-000,2018,9,22,20,460,612,1072,1421
3405-000,2018,9,22,21,419,454,873,1072
3405-000,2018,9,22,22,299,199,498,873
3405-000,2018,9,22,23,203,172,375,498
3405-000,2018,9,22,24,129,127,256,375
3405-000,2018,9,23,1,102,84,186,256
3405-000,2018,9,23,2,80,61,141,186
3405-000,2018,9,23,3,55,51,106,141
3405-000,2018,9,23,4,64,52,116,106
3405-000,2018,9,23,5,96,48,144,116
3405-000,2018,9,23,6,192,104,296,144
3405-000,2018,9,23,7,276,220,496,296
3405-000,2018,9,23,8,376,364,740,496
3405-000,2018,9,23,9,526,416,942,740
3405-000,2018,9,23,10,674,417,1091,942
3405-000,2018,9,23,11,783,505,1288,1091
3405-000,2018,9,23,12,724,586,1310,1288
3405-000,2018,9,23,13,669,610,1279,1310
3405-000,2018,9,23,14,654,677,1331,1279
3405-000,2018,9,23,15,593,735,1328,1331
3405-000,2018,9,23,16,544,793,1337,1328
3405-000,2018,9,23,17,541,827,1368,1337
3405-000,2018,9,23,18,455,901,1356,1368
3405-000,2018,9,23,19,369,815,1184,1356
3405-000,2018,9,23,20,300,702,1002,1184
3405-000,2018,9,23,21,274,522,796,1002
3405-000,2018,9,23,22,189,179,368,796
3405-000,2018,9,23,23,115,114,229,368
3405-000,2018,9,23,24,91,112,203,229
3405-000,2018,9,24,1,65,56,121,203
3405-000,2018,9,24,2,44,31,75,121
3405-000,2018,9,24,3,22,24,46,75
3405-000,2018,9,24,4,45,24,69,46
3405-000,2018,9,24,5,61,20,81,69
3405-000,2018,9,24,6,146,60,206,81
3405-000,2018,9,24,7,331,195,526,206
3405-000,2018,9,24,8,513,313,826,526
3405-000,2018,9,24,9,523,293,816,826
3405-000,2018,9,24,10,744,404,1148,816
3405-000,2018,9,24,11,1106,645,1751,1148
3405-000,2018,9,24,12,1167,1147,2314,1751
3405-000,2018,9,24,13,1373,933,2306,2314
3405-000,2018,9,24,14,1322,1083,2405,2306
3405-000,2018,9,24,15,1237,1220,2457,2405
3405-000,2018,9,24,16,988,1162,2150,2457
3405-000,2018,9,24,17,1097,1191,2288,2150
3405-000,2018,9,24,18,1049,1286,2335,2288
3405-000,2018,9,24,19,762,1094,1856,2335
3405-000,2018,9,24,20,545,804,1349,1856
3405-000,2018,9,24,21,614,512,1126,1349
3405-000,2018,9,24,22,416,488,904,1126
3405-000,2018,9,24,23,282,406,688,904
3405-000,2018,9,24,24,132,239,371,688
3405-000,2018,9,25,1,124,150,274,371
3405-000,2018,9,25,2,57,96,153,274
3405-000,2018,9,25,3,38,63,101,153
3405-000,2018,9,25,4,32,28,60,101
3405-000,2018,9,25,5,59,27,86,60
3405-000,2018,9,25,6,93,64,157,86
3405-000,2018,9,25,7,198,122,320,157
3405-000,2018,9,25,8,338,189,527,320
3405-000,2018,9,25,9,372,238,610,527
3405-000,2018,9,25,10,486,331,817,610
3405-000,2018,9,25,11,646,478,1124,817
3405-000,2018,9,25,12,795,575,1370,1124
3405-000,2018,9,25,13,752,547,1299,1370
3405-000,2018,9,25,14,684,622,1306,1299
3405-000,2018,9,25,15,816,637,1453,1306
3405-000,2018,9,25,16,844,628,1472,1453
3405-000,2018,9,25,17,750,710,1460,1472
3405-000,2018,9,25,18,746,821,1567,1460
3405-000,2018,9,25,19,683,660,1343,1567
3405-000,2018,9,25,20,598,671,1269,1343
3405-000,2018,9,25,21,498,502,1000,1269
3405-000,2018,9,25,22,396,416,812,1000
3405-000,2018,9,25,23,308,302,610,812
3405-000,2018,9,25,24,183,263,446,610
3405-000,2018,9,26,1,115,156,271,446
3405-000,2018,9,26,2,93,103,196,271
3405-000,2018,9,26,3,53,68,121,196
3405-000,2018,9,26,4,49,38,87,121
3405-000,2018,9,26,5,72,70,142,87
3405-000,2018,9,26,6,138,101,239,142
3405-000,2018,9,26,7,254,176,430,239
3405-000,2018,9,26,8,481,329,810,430
3405-000,2018,9,26,9,510,400,910,810
3405-000,2018,9,26,10,545,377,922,910
3405-000,2018,9,26,11,644,490,1134,922
3405-000,2018,9,26,12,677,564,1241,1134
3405-000,2018,9,26,13,654,580,1234,1241
3405-000,2018,9,26,14,701,628,1329,1234
3405-000,2018,9,26,15,701,700,1401,1329
3405-000,2018,9,26,16,760,728,1488,1401
3405-000,2018,9,26,17,698,698,1396,1488
3405-000,2018,9,26,18,723,719,1442,1396
3405-000,2018,9,26,19,582,688,1270,1442
3405-000,2018,9,26,20,471,534,1005,1270
3405-000,2018,9,26,21,399,443,842,1005
3405-000,2018,9,26,22,251,341,592,842
3405-000,2018,9,26,23,188,222,410,592
3405-000,2018,9,26,24,99,176,275,410
3405-000,2018,9,27,1,66,114,180,275
3405-000,2018,9,27,2,40,70,110,180
3405-000,2018,9,27,3,43,54,97,110
3405-000,2018,9,27,4,60,74,134,97
3405-000,2018,9,27,5,135,105,240,134
3405-000,2018,9,27,6,319,234,553,240
3405-000,2018,9,27,7,708,554,1262,553
3405-000,2018,9,27,8,1432,1493,2925,1262
3405-000,2018,9,27,9,1338,1291,2629,2925
3405-000,2018,9,27,10,1119,924,2043,2629
3405-000,2018,9,27,11,1110,955,2065,2043
3405-000,2018,9,27,12,1032,871,1903,2065
3405-000,2018,9,27,13,941,780,1721,1903
3405-000,2018,9,27,14,941,985,1926,1721
3405-000,2018,9,27,15,1067,1101,2168,1926
3405-000,2018,9,27,16,991,1018,2009,2168
3405-000,2018,9,27,17,1055,1041,2096,2009
3405-000,2018,9,27,18,1234,1132,2366,2096
3405-000,2018,9,27,19,1173,1031,2204,2366
3405-000,2018,9,27,20,684,657,1341,2204
3405-000,2018,9,27,21,472,588,1060,1341
3405-000,2018,9,27,22,332,384,716,1060
3405-000,2018,9,27,23,209,217,426,716
3405-000,2018,9,27,24,114,160,274,426
3405-000,2018,9,28,1,78,88,166,274
3405-000,2018,9,28,2,54,61,115,166
3405-000,2018,9,28,3,56,61,117,115
3405-000,2018,9,28,4,69,84,153,117
3405-000,2018,9,28,5,136,120,256,153
3405-000,2018,9,28,6,315,260,575,256
3405-000,2018,9,28,7,669,552,1221,575
3405-000,2018,9,28,8,1418,1321,2739,1221
3405-000,2018,9,28,9,1460,1329,2789,2739
3405-000,2018,9,28,10,1183,1045,2228,2789
3405-000,2018,9,28,11,1169,1043,2212,2228
3405-000,2018,9,28,12,1165,950,2115,2212
3405-000,2018,9,28,13,1007,897,1904,2115
3405-000,2018,9,28,14,1129,1109,2238,1904
3405-000,2018,9,28,15,1199,1115,2314,2238
3405-000,2018,9,28,16,1219,1017,2236,2314
3405-000,2018,9,28,17,1170,1091,2261,2236
3405-000,2018,9,28,18,1541,1195,2736,2261
3405-000,2018,9,28,19,1515,1254,2769,2736
3405-000,2018,9,28,20,843,765,1608,2769
3405-000,2018,9,28,21,567,538,1105,1608
3405-000,2018,9,28,22,375,382,757,1105
3405-000,2018,9,28,23,257,247,504,757
3405-000,2018,9,28,24,130,169,299,504
3405-000,2018,9,29,1,104,108,212,299
3405-000,2018,9,29,2,83,76,159,212
3405-000,2018,9,29,3,61,73,134,159
3405-000,2018,9,29,4,79,76,155,134
3405-000,2018,9,29,5,131,113,244,155
3405-000,2018,9,29,6,287,187,474,244
3405-000,2018,9,29,7,551,346,897,474
3405-000,2018,9,29,8,847,688,1535,897
3405-000,2018,9,29,9,933,791,1724,1535
3405-000,2018,9,29,10,924,790,1714,1724
3405-000,2018,9,29,11,969,902,1871,1714
3405-000,2018,9,29,12,932,952,1884,1871
3405-000,2018,9,29,13,841,875,1716,1884
3405-000,2018,9,29,14,824,768,1592,1716
3405-000,2018,9,29,15,908,813,1721,1592
3405-000,2018,9,29,16,857,767,1624,1721
3405-000,2018,9,29,17,848,817,1665,1624
3405-000,2018,9,29,18,997,905,1902,1665
3405-000,2018,9,29,19,831,752,1583,1902
3405-000,2018,9,29,20,497,530,1027,1583
3405-000,2018,9,29,21,383,387,770,1027
3405-000,2018,9,29,22,230,278,508,770
3405-000,2018,9,29,23,199,202,401,508
3405-000,2018,9,29,24,129,138,267,401
3405-000,2018,9,30,1,69,65,134,267
3405-000,2018,9,30,2,48,43,91,134
3405-000,2018,9,30,3,36,33,69,91
3405-000,2018,9,30,4,32,36,68,69
3405-000,2018,9,30,5,77,66,143,68
3405-000,2018,9,30,6,140,83,223,143
3405-000,2018,9,30,7,268,190,458,223
3405-000,2018,9,30,8,387,287,674,458
3405-000,2018,9,30,9,487,395,882,674
3405-000,2018,9,30,10,557,418,975,882
3405-000,2018,9,30,11,697,484,1181,975
3405-000,2018,9,30,12,600,538,1138,1181
3405-000,2018,9,30,13,579,543,1122,1138
3405-000,2018,9,30,14,617,640,1257,1122
3405-000,2018,9,30,15,668,657,1325,1257
3405-000,2018,9,30,16,779,675,1454,1325
3405-000,2018,9,30,17,732,777,1509,1454
3405-000,2018,9,30,18,649,791,1440,1509
3405-000,2018,9,30,19,634,661,1295,1440
3405-000,2018,9,30,20,401,577,978,1295
3405-000,2018,9,30,21,363,438,801,978
3405-000,2018,9,30,22,269,279,548,801
3405-000,2018,9,30,23,180,249,429,548
3405-000,2018,9,30,24,111,147,258,429
3405-000,2018,10,1,1,56,107,163,258
3405-000,2018,10,1,2,46,60,106,163
3405-000,2018,10,1,3,32,54,86,106
3405-000,2018,10,1,4,54,70,124,86
3405-000,2018,10,1,5,160,110,270,124
3405-000,2018,10,1,6,325,255,580,270
3405-000,2018,10,1,7,734,602,1336,580
3405-000,2018,10,1,8,1469,1510,2979,1336
3405-000,2018,10,1,9,1507,1438,2945,2979
3405-000,2018,10,1,10,1146,990,2136,2945
3405-000,2018,10,1,11,1212,995,2207,2136
3405-000,2018,10,1,12,1020,926,1946,2207
3405-000,2018,10,1,13,923,879,1802,1946
3405-000,2018,10,1,14,1025,983,2008,1802
3405-000,2018,10,1,15,1130,1100,2230,2008
3405-000,2018,10,1,16,1110,1060,2170,2230
3405-000,2018,10,1,17,1114,1030,2144,2170
3405-000,2018,10,1,18,1327,1169,2496,2144
3405-000,2018,10,1,19,1200,1043,2243,2496
3405-000,2018,10,1,20,745,666,1411,2243
3405-000,2018,10,1,21,503,583,1086,1411
3405-000,2018,10,1,22,333,344,677,1086
3405-000,2018,10,1,23,217,201,418,677
3405-000,2018,10,1,24,110,140,250,418
3405-000,2018,10,2,1,67,101,168,250
3405-000,2018,10,2,2,49,55,104,168
3405-000,2018,10,2,3,41,47,88,104
3405-000,2018,10,2,4,75,81,156,88
3405-000,2018,10,2,5,126,119,245,156
3405-000,2018,10,2,6,292,213,505,245
3405-000,2018,10,2,7,698,517,1215,505
3405-000,2018,10,2,8,1403,1368,2771,1215
3405-000,2018,10,2,9,1557,1371,2928,2771
3405-000,2018,10,2,10,1224,1082,2306,2928
3405-000,2018,10,2,11,1226,1021,2247,2306
3405-000,2018,10,2,12,1151,986,2137,2247
3405-000,2018,10,2,13,975,977,1952,2137
3405-000,2018,10,2,14,1154,1122,2276,1952
3405-000,2018,10,2,15,1272,1251,2523,2276
3405-000,2018,10,2,16,1266,1165,2431,2523
3405-000,2018,10,2,17,1282,1208,2490,2431
3405-000,2018,10,2,18,1577,1401,2978,2490
3405-000,2018,10,2,19,1683,1180,2863,2978
3405-000,2018,10,2,20,900,838,1738,2863
3405-000,2018,10,2,21,605,638,1243,1738
3405-000,2018,10,2,22,373,402,775,1243
3405-000,2018,10,2,23,244,213,457,775
3405-000,2018,10,2,24,162,151,313,457
3405-000,2018,10,3,1,88,89,177,313
3405-000,2018,10,3,2,63,76,139,177
3405-000,2018,10,3,3,54,56,110,139
3405-000,2018,10,3,4,70,65,135,110
3405-000,2018,10,3,5,108,102,210,135
3405-000,2018,10,3,6,245,175,420,210
3405-000,2018,10,3,7,512,361,873,420
3405-000,2018,10,3,8,879,651,1530,873
3405-000,2018,10,3,9,922,749,1671,1530
3405-000,2018,10,3,10,841,701,1542,1671
3405-000,2018,10,3,11,928,724,1652,1542
3405-000,2018,10,3,12,920,744,1664,1652
3405-000,2018,10,3,13,785,606,1391,1664
3405-000,2018,10,3,14,761,628,1389,1391
3405-000,2018,10,3,15,828,773,1601,1389
3405-000,2018,10,3,16,888,816,1704,1601
3405-000,2018,10,3,17,857,878,1735,1704
3405-000,2018,10,3,18,963,989,1952,1735
3405-000,2018,10,3,19,756,820,1576,1952
3405-000,2018,10,3,20,545,538,1083,1576
3405-000,2018,10,3,21,395,409,804,1083
3405-000,2018,10,3,22,274,292,566,804
3405-000,2018,10,3,23,205,194,399,566
3405-000,2018,10,3,24,132,149,281,399
3405-000,2018,10,4,1,75,119,194,281
3405-000,2018,10,4,2,40,65,105,194
3405-000,2018,10,4,3,42,45,87,105
3405-000,2018,10,4,4,64,73,137,87
3405-000,2018,10,4,5,128,132,260,137
3405-000,2018,10,4,6,292,218,510,260
3405-000,2018,10,4,7,734,597,1331,510
3405-000,2018,10,4,8,1490,1460,2950,1331
3405-000,2018,10,4,9,1574,1458,3032,2950
3405-000,2018,10,4,10,1194,1011,2205,3032
3405-000,2018,10,4,11,1227,1074,2301,2205
3405-000,2018,10,4,12,1187,1030,2217,2301
3405-000,2018,10,4,13,962,930,1892,2217
3405-000,2018,10,4,14,1150,1032,2182,1892
3405-000,2018,10,4,15,1221,1236,2457,2182
3405-000,2018,10,4,16,1239,1195,2434,2457
3405-000,2018,10,4,17,1192,1176,2368,2434
3405-000,2018,10,4,18,1435,1196,2631,2368
3405-000,2018,10,4,19,1415,1173,2588,2631
3405-000,2018,10,4,20,794,792,1586,2588
3405-000,2018,10,4,21,521,623,1144,1586
3405-000,2018,10,4,22,391,364,755,1144
3405-000,2018,10,4,23,224,244,468,755
3405-000,2018,10,4,24,141,146,287,468
3405-000,2018,10,5,1,87,115,202,287
3405-000,2018,10,5,2,63,77,140,202
3405-000,2018,10,5,3,51,59,110,140
3405-000,2018,10,5,4,85,88,173,110
3405-000,2018,10,5,5,140,123,263,173
3405-000,2018,10,5,6,274,180,454,263
3405-000,2018,10,5,7,621,465,1086,454
3405-000,2018,10,5,8,1335,1247,2582,1086
3405-000,2018,10,5,9,1485,1314,2799,2582
3405-000,2018,10,5,10,1065,967,2032,2799
3405-000,2018,10,5,11,1094,966,2060,2032
3405-000,2018,10,5,12,1009,911,1920,2060
3405-000,2018,10,5,13,928,800,1728,1920
3405-000,2018,10,5,14,1043,941,1984,1728
3405-000,2018,10,5,15,1103,1062,2165,1984
3405-000,2018,10,5,16,1119,972,2091,2165
3405-000,2018,10,5,17,1137,990,2127,2091
3405-000,2018,10,5,18,1543,1132,2675,2127
3405-000,2018,10,5,19,1580,1204,2784,2675
3405-000,2018,10,5,20,862,740,1602,2784
3405-000,2018,10,5,21,564,569,1133,1602
3405-000,2018,10,5,22,365,351,716,1133
3405-000,2018,10,5,23,212,199,411,716
3405-000,2018,10,5,24,137,134,271,411
3405-000,2018,10,6,1,77,107,184,271
3405-000,2018,10,6,2,58,66,124,184
3405-000,2018,10,6,3,45,51,96,124
3405-000,2018,10,6,4,57,73,130,96
3405-000,2018,10,6,5,86,94,180,130
3405-000,2018,10,6,6,149,118,267,180
3405-000,2018,10,6,7,350,215,565,267
3405-000,2018,10,6,8,570,434,1004,565
3405-000,2018,10,6,9,694,565,1259,1004
3405-000,2018,10,6,10,714,567,1281,1259
3405-000,2018,10,6,11,735,576,1311,1281
3405-000,2018,10,6,12,891,513,1404,1311
3405-000,2018,10,6,13,695,574,1269,1404
3405-000,2018,10,6,14,694,668,1362,1269
3405-000,2018,10,6,15,779,685,1464,1362
3405-000,2018,10,6,16,753,712,1465,1464
3405-000,2018,10,6,17,799,755,1554,1465
3405-000,2018,10,6,18,857,688,1545,1554
3405-000,2018,10,6,19,628,567,1195,1545
3405-000,2018,10,6,20,411,378,789,1195
3405-000,2018,10,6,21,310,288,598,789
3405-000,2018,10,6,22,250,182,432,598
3405-000,2018,10,6,23,178,156,334,432
3405-000,2018,10,6,24,112,129,241,334
3405-000,2018,10,7,1,74,64,138,241
3405-000,2018,10,7,2,42,72,114,138
3405-000,2018,10,7,3,50,44,94,114
3405-000,2018,10,7,4,42,38,80,94
3405-000,2018,10,7,5,79,58,137,80
3405-000,2018,10,7,6,151,85,236,137
3405-000,2018,10,7,7,266,201,467,236
3405-000,2018,10,7,8,420,296,716,467
3405-000,2018,10,7,9,537,323,860,716
3405-000,2018,10,7,10,569,377,946,860
3405-000,2018,10,7,11,739,455,1194,946
3405-000,2018,10,7,12,761,503,1264,1194
3405-000,2018,10,7,13,633,575,1208,1264
3405-000,2018,10,7,14,675,582,1257,1208
3405-000,2018,10,7,15,767,690,1457,1257
3405-000,2018,10,7,16,716,723,1439,1457
3405-000,2018,10,7,17,666,784,1450,1439
3405-000,2018,10,7,18,683,833,1516,1450
3405-000,2018,10,7,19,536,703,1239,1516
3405-000,2018,10,7,20,451,579,1030,1239
3405-000,2018,10,7,21,350,446,796,1030
3405-000,2018,10,7,22,257,388,645,796
3405-000,2018,10,7,23,181,258,439,645
3405-000,2018,10,7,24,128,151,279,439
3405-000,2018,10,8,1,53,90,143,279
3405-000,2018,10,8,2,61,50,111,143
3405-000,2018,10,8,3,42,44,86,111
3405-000,2018,10,8,4,64,61,125,86
3405-000,2018,10,8,5,140,135,275,125
3405-000,2018,10,8,6,284,222,506,275
3405-000,2018,10,8,7,763,592,1355,506
3405-000,2018,10,8,8,1425,1408,2833,1355
3405-000,2018,10,8,9,1414,1258,2672,2833
3405-000,2018,10,8,10,1127,952,2079,2672
3405-000,2018,10,8,11,1213,1027,2240,2079
3405-000,2018,10,8,12,1198,958,2156,2240
3405-000,2018,10,8,13,1002,963,1965,2156
3405-000,2018,10,8,14,974,1073,2047,1965
3405-000,2018,10,8,15,1207,1095,2302,2047
3405-000,2018,10,8,16,1169,1147,2316,2302
3405-000,2018,10,8,17,1167,1148,2315,2316
3405-000,2018,10,8,18,1413,1222,2635,2315
3405-000,2018,10,8,19,1443,1179,2622,2635
3405-000,2018,10,8,20,844,778,1622,2622
3405-000,2018,10,8,21,565,607,1172,1622
3405-000,2018,10,8,22,383,389,772,1172
3405-000,2018,10,8,23,199,222,421,772
3405-000,2018,10,8,24,137,138,275,421
3405-000,2018,10,9,1,103,108,211,275
3405-000,2018,10,9,2,63,65,128,211
3405-000,2018,10,9,3,45,52,97,128
3405-000,2018,10,9,4,74,75,149,97
3405-000,2018,10,9,5,123,116,239,149
3405-000,2018,10,9,6,274,190,464,239
3405-000,2018,10,9,7,585,363,948,464
3405-000,2018,10,9,8,932,677,1609,948
3405-000,2018,10,9,9,919,699,1618,1609
3405-000,2018,10,9,10,826,675,1501,1618
3405-000,2018,10,9,11,855,723,1578,1501
3405-000,2018,10,9,12,806,661,1467,1578
3405-000,2018,10,9,13,697,718,1415,1467
3405-000,2018,10,9,14,795,770,1565,1415
3405-000,2018,10,9,15,788,829,1617,1565
3405-000,2018,10,9,16,583,806,1389,1617
3405-000,2018,10,9,17,567,834,1401,1389
3405-000,2018,10,9,18,530,988,1518,1401
3405-000,2018,10,9,19,349,730,1079,1518
3405-000,2018,10,9,20,197,576,773,1079
3405-000,2018,10,9,21,135,431,566,773
3405-000,2018,10,9,22,87,319,406,566
3405-000,2018,10,9,23,64,221,285,406
3405-000,2018,10,9,24,27,145,172,285
3405-000,2018,10,10,1,32,82,114,172
3405-000,2018,10,10,2,13,49,62,114
3405-000,2018,10,10,3,23,49,72,62
3405-000,2018,10,10,4,28,61,89,72
3405-000,2018,10,10,5,80,102,182,89
3405-000,2018,10,10,6,217,211,428,182
3405-000,2018,10,10,7,654,560,1214,428
3405-000,2018,10,10,8,1592,1367,2959,1214
3405-000,2018,10,10,9,1564,1092,2656,2959
3405-000,2018,10,10,10,1042,1022,2064,2656
3405-000,2018,10,10,11,1031,1101,2132,2064
3405-000,2018,10,10,12,967,1063,2030,2132
3405-000,2018,10,10,13,823,895,1718,2030
3405-000,2018,10,10,14,1060,1078,2138,1718
3405-000,2018,10,10,15,1137,1130,2267,2138
3405-000,2018,10,10,16,1104,1157,2261,2267
3405-000,2018,10,10,17,1110,1128,2238,2261
3405-000,2018,10,10,18,1550,1196,2746,2238
3405-000,2018,10,10,19,1444,1057,2501,2746
3405-000,2018,10,10,20,606,728,1334,2501
3405-000,2018,10,10,21,390,580,970,1334
3405-000,2018,10,10,22,263,317,580,970
3405-000,2018,10,10,23,175,243,418,580
3405-000,2018,10,10,24,84,138,222,418
3405-000,2018,10,11,1,36,106,142,222
3405-000,2018,10,11,2,17,67,84,142
3405-000,2018,10,11,3,17,51,68,84
3405-000,2018,10,11,4,42,69,111,68
3405-000,2018,10,11,5,55,124,179,111
3405-000,2018,10,11,6,246,216,462,179
3405-000,2018,10,11,7,765,505,1270,462
3405-000,2018,10,11,8,1637,1355,2992,1270
3405-000,2018,10,11,9,1769,1328,3097,2992
3405-000,2018,10,11,10,1121,1045,2166,3097
3405-000,2018,10,11,11,1200,1129,2329,2166
3405-000,2018,10,11,12,1127,1045,2172,2329
3405-000,2018,10,11,13,713,967,1680,2172
3405-000,2018,10,11,14,865,1047,1912,1680
3405-000,2018,10,11,15,1058,1132,2190,1912
3405-000,2018,10,11,16,1094,1145,2239,2190
3405-000,2018,10,11,17,1121,1204,2325,2239
3405-000,2018,10,11,18,1379,1240,2619,2325
3405-000,2018,10,11,19,1244,1048,2292,2619
3405-000,2018,10,11,20,667,696,1363,2292
3405-000,2018,10,11,21,415,636,1051,1363
3405-000,2018,10,11,22,290,399,689,1051
3405-000,2018,10,11,23,155,197,352,689
3405-000,2018,10,11,24,69,122,191,352
3405-000,2018,10,12,1,40,105,145,191
3405-000,2018,10,12,2,21,67,88,145
3405-000,2018,10,12,3,32,58,90,88
3405-000,2018,10,12,4,25,84,109,90
3405-000,2018,10,12,5,96,112,208,109
3405-000,2018,10,12,6,219,201,420,208
3405-000,2018,10,12,7,721,511,1232,420
3405-000,2018,10,12,8,1673,1335,3008,1232
3405-000,2018,10,12,9,1866,1379,3245,3008
3405-000,2018,10,12,10,1146,1039,2185,3245
3405-000,2018,10,12,11,1173,1122,2295,2185
3405-000,2018,10,12,12,1117,1011,2128,2295
3405-000,2018,10,12,13,877,935,1812,2128
3405-000,2018,10,12,14,1048,1024,2072,1812
3405-000,2018,10,12,15,1298,1253,2551,2072
3405-000,2018,10,12,16,1217,1205,2422,2551
3405-000,2018,10,12,17,1187,1299,2486,2422
3405-000,2018,10,12,18,1906,1334,3240,2486
3405-000,2018,10,12,19,1962,1328,3290,3240
3405-000,2018,10,12,20,981,879,1860,3290
3405-000,2018,10,12,21,559,606,1165,1860
3405-000,2018,10,12,22,290,420,710,1165
3405-000,2018,10,12,23,252,235,487,710
3405-000,2018,10,12,24,88,144,232,487
3405-000,2018,10,13,1,57,101,158,232
3405-000,2018,10,13,2,42,98,140,158
3405-000,2018,10,13,3,42,65,107,140
3405-000,2018,10,13,4,38,80,118,107
3405-000,2018,10,13,5,69,103,172,118
3405-000,2018,10,13,6,223,186,409,172
3405-000,2018,10,13,7,540,322,862,409
3405-000,2018,10,13,8,973,694,1667,862
3405-000,2018,10,13,9,1116,870,1986,1667
3405-000,2018,10,13,10,1025,881,1906,1986
3405-000,2018,10,13,11,933,941,1874,1906
3405-000,2018,10,13,12,898,856,1754,1874
3405-000,2018,10,13,13,750,874,1624,1754
3405-000,2018,10,13,14,752,760,1512,1624
3405-000,2018,10,13,15,811,925,1736,1512
3405-000,2018,10,13,16,940,831,1771,1736
3405-000,2018,10,13,17,933,882,1815,1771
3405-000,2018,10,13,18,1075,943,2018,1815
3405-000,2018,10,13,19,794,702,1496,2018
3405-000,2018,10,13,20,486,563,1049,1496
3405-000,2018,10,13,21,259,416,675,1049
3405-000,2018,10,13,22,205,273,478,675
3405-000,2018,10,13,23,130,229,359,478
3405-000,2018,10,13,24,59,169,228,359
3405-000,2018,10,14,1,30,94,124,228
3405-000,2018,10,14,2,28,52,80,124
3405-000,2018,10,14,3,11,35,46,80
3405-000,2018,10,14,4,19,35,54,46
3405-000,2018,10,14,5,44,62,106,54
3405-000,2018,10,14,6,98,100,198,106
3405-000,2018,10,14,7,244,165,409,198
3405-000,2018,10,14,8,365,275,640,409
3405-000,2018,10,14,9,419,358,777,640
3405-000,2018,10,14,10,546,366,912,777
3405-000,2018,10,14,11,613,488,1101,912
3405-000,2018,10,14,12,563,523,1086,1101
3405-000,2018,10,14,13,444,547,991,1086
3405-000,2018,10,14,14,469,644,1113,991
3405-000,2018,10,14,15,509,698,1207,1113
3405-000,2018,10,14,16,623,719,1342,1207
3405-000,2018,10,14,17,636,730,1366,1342
3405-000,2018,10,14,18,723,765,1488,1366
3405-000,2018,10,14,19,634,667,1301,1488
3405-000,2018,10,14,20,484,624,1108,1301
3405-000,2018,10,14,21,330,481,811,1108
3405-000,2018,10,14,22,221,401,622,811
3405-000,2018,10,14,23,130,304,434,622
3405-000,2018,10,14,24,65,181,246,434
3405-000,2018,10,15,1,25,103,128,246
3405-000,2018,10,15,2,9,55,64,128
3405-000,2018,10,15,3,25,55,80,64
3405-000,2018,10,15,4,19,72,91,80
3405-000,2018,10,15,5,88,137,225,91
3405-000,2018,10,15,6,327,253,580,225
3405-000,2018,10,15,7,738,647,1385,580
3405-000,2018,10,15,8,1783,1549,3332,1385
3405-000,2018,10,15,9,1783,1459,3242,3332
3405-000,2018,10,15,10,1227,1026,2253,3242
3405-000,2018,10,15,11,1152,1056,2208,2253
3405-000,2018,10,15,12,1079,946,2025,2208
3405-000,2018,10,15,13,808,889,1697,2025
3405-000,2018,10,15,14,885,1102,1987,1697
3405-000,2018,10,15,15,1110,1085,2195,1987
3405-000,2018,10,15,16,1081,1126,2207,2195
3405-000,2018,10,15,17,1144,1187,2331,2207
3405-000,2018,10,15,18,1337,1168,2505,2331
3405-000,2018,10,15,19,1429,1141,2570,2505
3405-000,2018,10,15,20,656,715,1371,2570
3405-000,2018,10,15,21,390,586,976,1371
3405-000,2018,10,15,22,313,364,677,976
3405-000,2018,10,15,23,153,201,354,677
3405-000,2018,10,15,24,59,126,185,354
3405-000,2018,10,16,1,40,108,148,185
3405-000,2018,10,16,2,21,59,80,148
3405-000,2018,10,16,3,28,69,97,80
3405-000,2018,10,16,4,34,69,103,97
3405-000,2018,10,16,5,78,118,196,103
3405-000,2018,10,16,6,221,210,431,196
3405-000,2018,10,16,7,740,462,1202,431
3405-000,2018,10,16,8,1664,1353,3017,1202
3405-000,2018,10,16,9,1726,1304,3030,3017
3405-000,2018,10,16,10,1256,1070,2326,3030
3405-000,2018,10,16,11,1187,1100,2287,2326
3405-000,2018,10,16,12,1123,942,2065,2287
3405-000,2018,10,16,13,817,829,1646,2065
3405-000,2018,10,16,14,1002,1020,2022,1646
3405-000,2018,10,16,15,1214,1145,2359,2022
3405-000,2018,10,16,16,1081,1162,2243,2359
3405-000,2018,10,16,17,1208,1164,2372,2243
3405-000,2018,10,16,18,1402,1226,2628,2372
3405-000,2018,10,16,19,1339,1125,2464,2628
3405-000,2018,10,16,20,661,705,1366,2464
3405-000,2018,10,16,21,425,631,1056,1366
3405-000,2018,10,16,22,282,384,666,1056
3405-000,2018,10,16,23,236,192,428,666
3405-000,2018,10,16,24,125,135,260,428
3405-000,2018,10,17,1,28,80,108,260
3405-000,2018,10,17,2,23,84,107,108
3405-000,2018,10,17,3,21,67,88,107
3405-000,2018,10,17,4,34,62,96,88
3405-000,2018,10,17,5,50,107,157,96
3405-000,2018,10,17,6,242,229,471,157
3405-000,2018,10,17,7,771,545,1316,471
3405-000,2018,10,17,8,1816,1330,3146,1316
3405-000,2018,10,17,9,1754,1421,3175,3146
3405-000,2018,10,17,10,1123,1034,2157,3175
3405-000,2018,10,17,11,1090,1093,2183,2157
3405-000,2018,10,17,12,983,1004,1987,2183
3405-000,2018,10,17,13,758,877,1635,1987
3405-000,2018,10,17,14,1015,1048,2063,1635
3405-000,2018,10,17,15,1054,1142,2196,2063
3405-000,2018,10,17,16,1029,1160,2189,2196
3405-000,2018,10,17,17,1133,1139,2272,2189
3405-000,2018,10,17,18,1689,1284,2973,2272
3405-000,2018,10,17,19,1566,1166,2732,2973
3405-000,2018,10,17,20,669,681,1350,2732
3405-000,2018,10,17,21,384,497,881,1350
3405-000,2018,10,17,22,236,336,572,881
3405-000,2018,10,17,23,402,209,611,572
3405-000,2018,10,17,24,275,124,399,611
3405-000,2018,10,18,1,103,103,206,399
3405-000,2018,10,18,2,28,79,107,206
3405-000,2018,10,18,3,30,60,90,107
3405-000,2018,10,18,4,21,80,101,90
3405-000,2018,10,18,5,82,117,199,101
3405-000,2018,10,18,6,288,199,487,199
3405-000,2018,10,18,7,850,536,1386,487
3405-000,2018,10,18,8,1723,1328,3051,1386
3405-000,2018,10,18,9,1811,1365,3176,3051
3405-000,2018,10,18,10,1204,1084,2288,3176
3405-000,2018,10,18,11,1171,1134,2305,2288
3405-000,2018,10,18,12,1119,947,2066,2305
3405-000,2018,10,18,13,838,851,1689,2066
3405-000,2018,10,18,14,1035,1068,2103,1689
3405-000,2018,10,18,15,1040,1130,2170,2103
3405-000,2018,10,18,16,1062,1110,2172,2170
3405-000,2018,10,18,17,1231,1163,2394,2172
3405-000,2018,10,18,18,1612,1320,2932,2394
3405-000,2018,10,18,19,1414,1049,2463,2932
3405-000,2018,10,18,20,700,626,1326,2463
3405-000,2018,10,18,21,457,550,1007,1326
3405-000,2018,10,18,22,236,383,619,1007
3405-000,2018,10,18,23,227,186,413,619
3405-000,2018,10,18,24,88,125,213,413
3405-000,2018,10,19,1,34,87,121,213
3405-000,2018,10,19,2,25,82,107,121
3405-000,2018,10,19,3,21,56,77,107
3405-000,2018,10,19,4,34,87,121,77
3405-000,2018,10,19,5,65,125,190,121
3405-000,2018,10,19,6,277,224,501,190
3405-000,2018,10,19,7,669,533,1202,501
3405-000,2018,10,19,8,1631,1281,2912,1202
3405-000,2018,10,19,9,1841,1353,3194,2912
3405-000,2018,10,19,10,1202,1087,2289,3194
3405-000,2018,10,19,11,1152,1176,2328,2289
3405-000,2018,10,19,12,1092,975,2067,2328
3405-000,2018,10,19,13,946,950,1896,2067
3405-000,2018,10,19,14,1117,1098,2215,1896
3405-000,2018,10,19,15,1185,1152,2337,2215
3405-000,2018,10,19,16,1300,1172,2472,2337
3405-000,2018,10,19,17,1348,1104,2452,2472
3405-000,2018,10,19,18,1825,1290,3115,2452
3405-000,2018,10,19,19,1827,1166,2993,3115
3405-000,2018,10,19,20,1119,828,1947,2993
3405-000,2018,10,19,21,631,599,1230,1947
3405-000,2018,10,19,22,305,399,704,1230
3405-000,2018,10,19,23,194,242,436,704
3405-000,2018,10,19,24,113,174,287,436
3405-000,2018,10,20,1,48,127,175,287
3405-000,2018,10,20,2,40,75,115,175
3405-000,2018,10,20,3,25,64,89,115
3405-000,2018,10,20,4,30,71,101,89
3405-000,2018,10,20,5,78,109,187,101
3405-000,2018,10,20,6,217,160,377,187
3405-000,2018,10,20,7,552,348,900,377
3405-000,2018,10,20,8,885,656,1541,900
3405-000,2018,10,20,9,1056,750,1806,1541
3405-000,2018,10,20,10,1008,838,1846,1806
3405-000,2018,10,20,11,1006,894,1900,1846
3405-000,2018,10,20,12,967,1021,1988,1900
3405-000,2018,10,20,13,900,932,1832,1988
3405-000,2018,10,20,14,846,802,1648,1832
3405-000,2018,10,20,15,867,790,1657,1648
3405-000,2018,10,20,16,1054,794,1848,1657
3405-000,2018,10,20,17,956,867,1823,1848
3405-000,2018,10,20,18,996,1056,2052,1823
3405-000,2018,10,20,19,819,748,1567,2052
3405-000,2018,10,20,20,423,590,1013,1567
3405-000,2018,10,20,21,338,443,781,1013
3405-000,2018,10,20,22,196,324,520,781
3405-000,2018,10,20,23,121,229,350,520
3405-000,2018,10,20,24,92,139,231,350
3405-000,2018,10,21,1,42,78,120,231
3405-000,2018,10,21,2,28,55,83,120
3405-000,2018,10,21,3,11,31,42,83
3405-000,2018,10,21,4,9,35,44,42
3405-000,2018,10,21,5,36,64,100,44
3405-000,2018,10,21,6,100,87,187,100
3405-000,2018,10,21,7,211,175,386,187
3405-000,2018,10,21,8,319,301,620,386
3405-000,2018,10,21,9,469,336,805,620
3405-000,2018,10,21,10,513,421,934,805
3405-000,2018,10,21,11,565,503,1068,934
3405-000,2018,10,21,12,592,582,1174,1068
3405-000,2018,10,21,13,475,557,1032,1174
3405-000,2018,10,21,14,544,675,1219,1032
3405-000,2018,10,21,15,673,617,1290,1219
3405-000,2018,10,21,16,733,773,1506,1290
3405-000,2018,10,21,17,770,727,1497,1506
3405-000,2018,10,21,18,769,803,1572,1497
3405-000,2018,10,21,19,688,676,1364,1572
3405-000,2018,10,21,20,517,587,1104,1364
3405-000,2018,10,21,21,377,489,866,1104
3405-000,2018,10,21,22,244,518,762,866
3405-000,2018,10,21,23,125,439,564,762
3405-000,2018,10,21,24,73,180,253,564
3405-000,2018,10,22,1,32,99,131,253
3405-000,2018,10,22,2,19,73,92,131
3405-000,2018,10,22,3,19,44,63,92
3405-000,2018,10,22,4,32,70,102,63
3405-000,2018,10,22,5,78,125,203,102
3405-000,2018,10,22,6,267,279,546,203
3405-000,2018,10,22,7,833,660,1493,546
3405-000,2018,10,22,8,1876,1513,3389,1493
3405-000,2018,10,22,9,1756,1410,3166,3389
3405-000,2018,10,22,10,1121,1014,2135,3166
3405-000,2018,10,22,11,1071,1035,2106,2135
3405-000,2018,10,22,12,990,962,1952,2106
3405-000,2018,10,22,13,779,879,1658,1952
3405-000,2018,10,22,14,979,1033,2012,1658
3405-000,2018,10,22,15,1027,1112,2139,2012
3405-000,2018,10,22,16,1100,1136,2236,2139
3405-000,2018,10,22,17,1040,1168,2208,2236
3405-000,2018,10,22,18,1406,1195,2601,2208
3405-000,2018,10,22,19,1254,1160,2414,2601
3405-000,2018,10,22,20,636,746,1382,2414
3405-000,2018,10,22,21,465,596,1061,1382
3405-000,2018,10,22,22,277,376,653,1061
3405-000,2018,10,22,23,223,212,435,653
3405-000,2018,10,22,24,159,132,291,435
3405-000,2018,10,23,1,61,105,166,291
3405-000,2018,10,23,2,11,67,78,166
3405-000,2018,10,23,3,13,57,70,78
3405-000,2018,10,23,4,30,76,106,70
3405-000,2018,10,23,5,67,111,178,106
3405-000,2018,10,23,6,255,242,497,178
3405-000,2018,10,23,7,696,512,1208,497
3405-000,2018,10,23,8,1658,1361,3019,1208
3405-000,2018,10,23,9,1795,1367,3162,3019
3405-000,2018,10,23,10,1206,1026,2232,3162
3405-000,2018,10,23,11,1189,1068,2257,2232
3405-000,2018,10,23,12,988,971,1959,2257
3405-000,2018,10,23,13,831,882,1713,1959
3405-000,2018,10,23,14,990,1033,2023,1713
3405-000,2018,10,23,15,1115,1206,2321,2023
3405-000,2018,10,23,16,1054,1071,2125,2321
3405-000,2018,10,23,17,952,1092,2044,2125
3405-000,2018,10,23,18,1479,1130,2609,2044
3405-000,2018,10,23,19,1196,1041,2237,2609
3405-000,2018,10,23,20,602,669,1271,2237
3405-000,2018,10,23,21,369,576,945,1271
3405-000,2018,10,23,22,323,358,681,945
3405-000,2018,10,23,23,232,220,452,681
3405-000,2018,10,23,24,148,118,266,452
3405-000,2018,10,24,1,46,87,133,266
3405-000,2018,10,24,2,15,57,72,133
3405-000,2018,10,24,3,17,62,79,72
3405-000,2018,10,24,4,23,76,99,79
3405-000,2018,10,24,5,57,104,161,99
3405-000,2018,10,24,6,257,200,457,161
3405-000,2018,10,24,7,692,505,1197,457
3405-000,2018,10,24,8,1731,1279,3010,1197
3405-000,2018,10,24,9,1815,1438,3253,3010
3405-000,2018,10,24,10,1333,1066,2399,3253
3405-000,2018,10,24,11,1223,1117,2340,2399
3405-000,2018,10,24,12,1004,999,2003,2340
3405-000,2018,10,24,13,675,892,1567,2003
3405-000,2018,10,24,14,910,1100,2010,1567
3405-000,2018,10,24,15,1052,1083,2135,2010
3405-000,2018,10,24,16,1094,1145,2239,2135
3405-000,2018,10,24,17,1073,1138,2211,2239
3405-000,2018,10,24,18,1577,1225,2802,2211
3405-000,2018,10,24,19,1323,1110,2433,2802
3405-000,2018,10,24,20,590,677,1267,2433
3405-000,2018,10,24,21,354,503,857,1267
3405-000,2018,10,24,22,248,320,568,857
3405-000,2018,10,24,23,134,205,339,568
3405-000,2018,10,24,24,90,155,245,339
3405-000,2018,10,25,1,30,111,141,245
3405-000,2018,10,25,2,11,61,72,141
3405-000,2018,10,25,3,5,69,74,72
3405-000,2018,10,25,4,21,64,85,74
3405-000,2018,10,25,5,94,114,208,85
3405-000,2018,10,25,6,255,211,466,208
3405-000,2018,10,25,7,819,545,1364,466
3405-000,2018,10,25,8,1679,1266,2945,1364
3405-000,2018,10,25,9,1768,1361,3129,2945
3405-000,2018,10,25,10,1196,1081,2277,3129
3405-000,2018,10,25,11,1044,1037,2081,2277
3405-000,2018,10,25,12,1056,979,2035,2081
3405-000,2018,10,25,13,906,950,1856,2035
3405-000,2018,10,25,14,1108,1066,2174,1856
3405-000,2018,10,25,15,1083,1202,2285,2174
3405-000,2018,10,25,16,1198,1177,2375,2285
3405-000,2018,10,25,17,1254,1141,2395,2375
3405-000,2018,10,25,18,1489,1234,2723,2395
3405-000,2018,10,25,19,1446,1097,2543,2723
3405-000,2018,10,25,20,715,698,1413,2543
3405-000,2018,10,25,21,384,574,958,1413
3405-000,2018,10,25,22,325,409,734,958
3405-000,2018,10,25,23,240,215,455,734
3405-000,2018,10,25,24,115,148,263,455
3405-000,2018,10,26,1,38,116,154,263
3405-000,2018,10,26,2,25,64,89,154
3405-000,2018,10,26,3,13,63,76,89
3405-000,2018,10,26,4,34,76,110,76
3405-000,2018,10,26,5,67,131,198,110
3405-000,2018,10,26,6,221,197,418,198
3405-000,2018,10,26,7,559,460,1019,418
3405-000,2018,10,26,8,1550,1267,2817,1019
3405-000,2018,10,26,9,1814,1377,3191,2817
3405-000,2018,10,26,10,1179,1039,2218,3191
3405-000,2018,10,26,11,1189,1118,2307,2218
3405-000,2018,10,26,12,1077,927,2004,2307
3405-000,2018,10,26,13,898,858,1756,2004
3405-000,2018,10,26,14,1067,997,2064,1756
3405-000,2018,10,26,15,1169,1055,2224,2064
3405-000,2018,10,26,16,1258,1036,2294,2224
3405-000,2018,10,26,17,1298,1139,2437,2294
3405-000,2018,10,26,18,1791,1217,3008,2437
3405-000,2018,10,26,19,1702,1119,2821,3008
3405-000,2018,10,26,20,904,739,1643,2821
3405-000,2018,10,26,21,504,528,1032,1643
3405-000,2018,10,26,22,302,342,644,1032
3405-000,2018,10,26,23,167,212,379,644
3405-000,2018,10,26,24,92,138,230,379
3405-000,2018,10,27,1,65,101,166,230
3405-000,2018,10,27,2,38,72,110,166
3405-000,2018,10,27,3,25,50,75,110
3405-000,2018,10,27,4,32,69,101,75
3405-000,2018,10,27,5,65,108,173,101
3405-000,2018,10,27,6,192,172,364,173
3405-000,2018,10,27,7,502,346,848,364
3405-000,2018,10,27,8,817,597,1414,848
3405-000,2018,10,27,9,1044,801,1845,1414
3405-000,2018,10,27,10,1023,847,1870,1845
3405-000,2018,10,27,11,1083,1081,2164,1870
3405-000,2018,10,27,12,1156,952,2108,2164
3405-000,2018,10,27,13,931,897,1828,2108
3405-000,2018,10,27,14,969,773,1742,1828
3405-000,2018,10,27,15,983,817,1800,1742
3405-000,2018,10,27,16,1079,797,1876,1800
3405-000,2018,10,27,17,858,771,1629,1876
3405-000,2018,10,27,18,1031,964,1995,1629
3405-000,2018,10,27,19,833,695,1528,1995
3405-000,2018,10,27,20,417,509,926,1528
3405-000,2018,10,27,21,286,390,676,926
3405-000,2018,10,27,22,194,280,474,676
3405-000,2018,10,27,23,128,203,331,474
3405-000,2018,10,27,24,46,158,204,331
3405-000,2018,10,28,1,30,88,118,204
3405-000,2018,10,28,2,25,56,81,118
3405-000,2018,10,28,3,19,41,60,81
3405-000,2018,10,28,4,17,26,43,60
3405-000,2018,10,28,5,40,52,92,43
3405-000,2018,10,28,6,117,97,214,92
3405-000,2018,10,28,7,175,141,316,214
3405-000,2018,10,28,8,300,256,556,316
3405-000,2018,10,28,9,386,326,712,556
3405-000,2018,10,28,10,427,400,827,712
3405-000,2018,10,28,11,559,504,1063,827
3405-000,2018,10,28,12,515,502,1017,1063
3405-000,2018,10,28,13,586,544,1130,1017
3405-000,2018,10,28,14,544,662,1206,1130
3405-000,2018,10,28,15,652,621,1273,1206
3405-000,2018,10,28,16,671,676,1347,1273
3405-000,2018,10,28,17,687,750,1437,1347
3405-000,2018,10,28,18,648,739,1387,1437
3405-000,2018,10,28,19,484,638,1122,1387
3405-000,2018,10,28,20,411,558,969,1122
3405-000,2018,10,28,21,294,430,724,969
3405-000,2018,10,28,22,169,369,538,724
3405-000,2018,10,28,23,123,372,495,538
3405-000,2018,10,28,24,63,180,243,495
3405-000,2018,10,29,1,36,74,110,243
3405-000,2018,10,29,2,17,25,42,110
3405-000,2018,10,29,3,21,52,73,42
3405-000,2018,10,29,4,34,56,90,73
3405-000,2018,10,29,5,67,107,174,90
3405-000,2018,10,29,6,275,250,525,174
3405-000,2018,10,29,7,763,620,1383,525
3405-000,2018,10,29,8,1804,1427,3231,1383
3405-000,2018,10,29,9,1832,1404,3236,3231
3405-000,2018,10,29,10,1198,1007,2205,3236
3405-000,2018,10,29,11,1015,1077,2092,2205
3405-000,2018,10,29,12,1008,915,1923,2092
3405-000,2018,10,29,13,983,818,1801,1923
3405-000,2018,10,29,14,1144,1021,2165,1801
3405-000,2018,10,29,15,1112,1169,2281,2165
3405-000,2018,10,29,16,1042,1289,2331,2281
3405-000,2018,10,29,17,1135,1023,2158,2331
3405-000,2018,10,29,18,1502,1174,2676,2158
3405-000,2018,10,29,19,1312,1053,2365,2676
3405-000,2018,10,29,20,646,730,1376,2365
3405-000,2018,10,29,21,428,591,1019,1376
3405-000,2018,10,29,22,295,370,665,1019
3405-000,2018,10,29,23,188,206,394,665
3405-000,2018,10,29,24,109,129,238,394
3405-000,2018,10,30,1,36,93,129,238
3405-000,2018,10,30,2,17,71,88,129
3405-000,2018,10,30,3,11,63,74,88
3405-000,2018,10,30,4,44,66,110,74
3405-000,2018,10,30,5,67,121,188,110
3405-000,2018,10,30,6,227,215,442,188
3405-000,2018,10,30,7,754,501,1255,442
3405-000,2018,10,30,8,1700,1324,3024,1255
3405-000,2018,10,30,9,1780,1340,3120,3024
3405-000,2018,10,30,10,1244,1008,2252,3120
3405-000,2018,10,30,11,1075,1107,2182,2252
3405-000,2018,10,30,12,1050,966,2016,2182
3405-000,2018,10,30,13,881,848,1729,2016
3405-000,2018,10,30,14,948,1007,1955,1729
3405-000,2018,10,30,15,1135,1124,2259,1955
3405-000,2018,10,30,16,1075,1091,2166,2259
3405-000,2018,10,30,17,1025,1131,2156,2166
3405-000,2018,10,30,18,1514,1262,2776,2156
3405-000,2018,10,30,19,1244,1077,2321,2776
3405-000,2018,10,30,20,671,685,1356,2321
3405-000,2018,10,30,21,415,593,1008,1356
3405-000,2018,10,30,22,280,344,624,1008
3405-000,2018,10,30,23,230,239,469,624
3405-000,2018,10,30,24,100,145,245,469
3405-000,2018,10,31,1,34,89,123,245
3405-000,2018,10,31,2,25,69,94,123
3405-000,2018,10,31,3,15,67,82,94
3405-000,2018,10,31,4,36,71,107,82
3405-000,2018,10,31,5,65,108,173,107
3405-000,2018,10,31,6,188,234,422,173
3405-000,2018,10,31,7,663,476,1139,422
3405-000,2018,10,31,8,1748,1235,2983,1139
3405-000,2018,10,31,9,1794,1342,3136,2983
3405-000,2018,10,31,10,1127,974,2101,3136
3405-000,2018,10,31,11,1079,1015,2094,2101
3405-000,2018,10,31,12,1008,988,1996,2094
3405-000,2018,10,31,13,802,864,1666,1996
3405-000,2018,10,31,14,1004,978,1982,1666
3405-000,2018,10,31,15,1062,1075,2137,1982
3405-000,2018,10,31,16,1035,1147,2182,2137
3405-000,2018,10,31,17,1058,1029,2087,2182
3405-000,2018,10,31,18,1516,1238,2754,2087
3405-000,2018,10,31,19,1298,1106,2404,2754
3405-000,2018,10,31,20,627,658,1285,2404
3405-000,2018,10,31,21,361,483,844,1285
3405-000,2018,10,31,22,267,306,573,844
3405-000,2018,10,31,23,177,181,358,573
3405-000,2018,10,31,24,88,127,215,358
3405-000,2018,11,1,1,31,92,123,215
3405-000,2018,11,1,2,29,74,103,123
3405-000,2018,11,1,3,18,75,93,103
3405-000,2018,11,1,4,18,81,99,93
3405-000,2018,11,1,5,69,117,186,99
3405-000,2018,11,1,6,195,209,404,186
3405-000,2018,11,1,7,604,493,1097,404
3405-000,2018,11,1,8,1494,1252,2746,1097
3405-000,2018,11,1,9,1615,1312,2927,2746
3405-000,2018,11,1,10,1196,1039,2235,2927
3405-000,2018,11,1,11,969,1085,2054,2235
3405-000,2018,11,1,12,1053,995,2048,2054
3405-000,2018,11,1,13,814,875,1689,2048
3405-000,2018,11,1,14,948,1049,1997,1689
3405-000,2018,11,1,15,1085,1141,2226,1997
3405-000,2018,11,1,16,1009,1152,2161,2226
3405-000,2018,11,1,17,1076,1104,2180,2161
3405-000,2018,11,1,18,1463,1230,2693,2180
3405-000,2018,11,1,19,1270,1069,2339,2693
3405-000,2018,11,1,20,652,660,1312,2339
3405-000,2018,11,1,21,394,541,935,1312
3405-000,2018,11,1,22,249,345,594,935
3405-000,2018,11,1,23,180,219,399,594
3405-000,2018,11,1,24,86,136,222,399
3405-000,2018,11,2,1,25,98,123,222
3405-000,2018,11,2,2,31,60,91,123
3405-000,2018,11,2,3,27,59,86,91
3405-000,2018,11,2,4,27,79,106,86
3405-000,2018,11,2,5,60,122,182,106
3405-000,2018,11,2,6,220,218,438,182
3405-000,2018,11,2,7,633,513,1146,438
3405-000,2018,11,2,8,1456,1322,2778,1146
3405-000,2018,11,2,9,1616,1345,2961,2778
3405-000,2018,11,2,10,1098,997,2095,2961
3405-000,2018,11,2,11,1070,1033,2103,2095
3405-000,2018,11,2,12,995,1028,2023,2103
3405-000,2018,11,2,13,929,900,1829,2023
3405-000,2018,11,2,14,1034,1059,2093,1829
3405-000,2018,11,2,15,1081,1097,2178,2093
3405-000,2018,11,2,16,1009,1228,2237,2178
3405-000,2018,11,2,17,1322,1102,2424,2237
3405-000,2018,11,2,18,1776,1275,3051,2424
3405-000,2018,11,2,19,1631,1162,2793,3051
3405-000,2018,11,2,20,871,1136,2007,2793
3405-000,2018,11,2,21,524,564,1088,2007
3405-000,2018,11,2,22,285,370,655,1088
3405-000,2018,11,2,23,172,227,399,655
3405-000,2018,11,2,24,69,158,227,399
3405-000,2018,11,3,1,58,90,148,227
3405-000,2018,11,3,2,33,81,114,148
3405-000,2018,11,3,3,25,59,84,114
3405-000,2018,11,3,4,23,73,96,84
3405-000,2018,11,3,5,67,101,168,96
3405-000,2018,11,3,6,153,181,334,168
3405-000,2018,11,3,7,401,314,715,334
3405-000,2018,11,3,8,781,579,1360,715
3405-000,2018,11,3,9,856,771,1627,1360
3405-000,2018,11,3,10,917,870,1787,1627
3405-000,2018,11,3,11,962,894,1856,1787
3405-000,2018,11,3,12,875,920,1795,1856
3405-000,2018,11,3,13,720,925,1645,1795
3405-000,2018,11,3,14,810,828,1638,1645
3405-000,2018,11,3,15,869,842,1711,1638
3405-000,2018,11,3,16,869,866,1735,1711
3405-000,2018,11,3,17,841,880,1721,1735
3405-000,2018,11,3,18,919,927,1846,1721
3405-000,2018,11,3,19,736,749,1485,1846
3405-000,2018,11,3,20,432,579,1011,1485
3405-000,2018,11,3,21,306,424,730,1011
3405-000,2018,11,3,22,144,303,447,730
3405-000,2018,11,3,23,127,236,363,447
3405-000,2018,11,3,24,54,160,214,363
3405-000,2018,11,4,1,27,77,104,214
3405-000,2018,11,4,2,18,47,65,104
3405-000,2018,11,4,3,14,47,61,65
3405-000,2018,11,4,4,25,36,61,61
3405-000,2018,11,4,5,31,65,96,61
3405-000,2018,11,4,6,69,80,149,96
3405-000,2018,11,4,7,155,148,303,149
3405-000,2018,11,4,8,275,262,537,303
3405-000,2018,11,4,9,428,326,754,537
3405-000,2018,11,4,10,489,386,875,754
3405-000,2018,11,4,11,596,479,1075,875
3405-000,2018,11,4,12,529,537,1066,1075
3405-000,2018,11,4,13,459,592,1051,1066
3405-000,2018,11,4,14,547,662,1209,1051
3405-000,2018,11,4,15,591,674,1265,1209
3405-000,2018,11,4,16,699,733,1432,1265
3405-000,2018,11,4,17,766,860,1626,1432
3405-000,2018,11,4,18,760,844,1604,1626
3405-000,2018,11,4,19,657,827,1484,1604
3405-000,2018,11,4,20,453,668,1121,1484
3405-000,2018,11,4,21,380,460,840,1121
3405-000,2018,11,4,22,251,444,695,840
3405-000,2018,11,4,23,119,406,525,695
3405-000,2018,11,4,24,73,180,253,525
3405-000,2018,11,5,1,31,50,81,253
3405-000,2018,11,5,2,12,49,61,81
3405-000,2018,11,5,3,29,48,77,61
3405-000,2018,11,5,4,16,63,79,77
3405-000,2018,11,5,5,75,116,191,79
3405-000,2018,11,5,6,256,264,520,191
3405-000,2018,11,5,7,755,640,1395,520
3405-000,2018,11,5,8,1695,1470,3165,1395
3405-000,2018,11,5,9,1662,1407,3069,3165
3405-000,2018,11,5,10,1001,1010,2011,3069
3405-000,2018,11,5,11,1135,1056,2191,2011
3405-000,2018,11,5,12,1014,938,1952,2191
3405-000,2018,11,5,13,871,848,1719,1952
3405-000,2018,11,5,14,1047,1027,2074,1719
3405-000,2018,11,5,15,971,1091,2062,2074
3405-000,2018,11,5,16,908,1133,2041,2062
3405-000,2018,11,5,17,1001,1064,2065,2041
3405-000,2018,11,5,18,1297,1232,2529,2065
3405-000,2018,11,5,19,1179,1077,2256,2529
3405-000,2018,11,5,20,531,728,1259,2256
3405-000,2018,11,5,21,369,600,969,1259
3405-000,2018,11,5,22,277,325,602,969
3405-000,2018,11,5,23,144,209,353,602
3405-000,2018,11,5,24,75,130,205,353
3405-000,2018,11,6,1,29,99,128,205
3405-000,2018,11,6,2,18,69,87,128
3405-000,2018,11,6,3,16,60,76,87
3405-000,2018,11,6,4,31,71,102,76
3405-000,2018,11,6,5,43,116,159,102
3405-000,2018,11,6,6,220,228,448,159
3405-000,2018,11,6,7,570,506,1076,448
3405-000,2018,11,6,8,1603,1357,2960,1076
3405-000,2018,11,6,9,1629,1358,2987,2960
3405-000,2018,11,6,10,1100,1034,2134,2987
3405-000,2018,11,6,11,1150,1067,2217,2134
3405-000,2018,11,6,12,961,968,1929,2217
3405-000,2018,11,6,13,825,865,1690,1929
3405-000,2018,11,6,14,909,1102,2011,1690
3405-000,2018,11,6,15,1032,1159,2191,2011
3405-000,2018,11,6,16,1013,1107,2120,2191
3405-000,2018,11,6,17,1037,1060,2097,2120
3405-000,2018,11,6,18,1394,1211,2605,2097
3405-000,2018,11,6,19,1184,1088,2272,2605
3405-000,2018,11,6,20,554,693,1247,2272
3405-000,2018,11,6,21,346,607,953,1247
3405-000,2018,11,6,22,226,360,586,953
3405-000,2018,11,6,23,161,218,379,586
3405-000,2018,11,6,24,71,120,191,379
3405-000,2018,11,7,1,23,86,109,191
3405-000,2018,11,7,2,8,63,71,109
3405-000,2018,11,7,3,22,62,84,71
3405-000,2018,11,7,4,27,84,111,84
3405-000,2018,11,7,5,60,111,171,111
3405-000,2018,11,7,6,222,196,418,171
3405-000,2018,11,7,7,598,488,1086,418
3405-000,2018,11,7,8,1507,1282,2789,1086
3405-000,2018,11,7,9,1644,1412,3056,2789
3405-000,2018,11,7,10,1095,1021,2116,3056
3405-000,2018,11,7,11,1005,1104,2109,2116
3405-000,2018,11,7,12,999,1031,2030,2109
3405-000,2018,11,7,13,764,885,1649,2030
3405-000,2018,11,7,14,959,1117,2076,1649
3405-000,2018,11,7,15,1160,1081,2241,2076
3405-000,2018,11,7,16,1011,1091,2102,2241
3405-000,2018,11,7,17,1114,1050,2164,2102
3405-000,2018,11,7,18,1452,1240,2692,2164
3405-000,2018,11,7,19,1251,1063,2314,2692
3405-000,2018,11,7,20,604,639,1243,2314
3405-000,2018,11,7,21,300,487,787,1243
3405-000,2018,11,7,22,218,327,545,787
3405-000,2018,11,7,23,136,224,360,545
3405-000,2018,11,7,24,69,119,188,360
3405-000,2018,11,8,1,33,98,131,188
3405-000,2018,11,8,2,20,68,88,131
3405-000,2018,11,8,3,16,52,68,88
3405-000,2018,11,8,4,33,65,98,68
3405-000,2018,11,8,5,56,128,184,98
3405-000,2018,11,8,6,163,172,335,184
3405-000,2018,11,8,7,531,436,967,335
3405-000,2018,11,8,8,1387,1194,2581,967
3405-000,2018,11,8,9,1540,1303,2843,2581
3405-000,2018,11,8,10,1058,950,2008,2843
3405-000,2018,11,8,11,890,986,1876,2008
3405-000,2018,11,8,12,732,862,1594,1876
3405-000,2018,11,8,13,812,795,1607,1594
3405-000,2018,11,8,14,823,908,1731,1607
3405-000,2018,11,8,15,993,1016,2009,1731
3405-000,2018,11,8,16,936,968,1904,2009
3405-000,2018,11,8,17,781,978,1759,1904
3405-000,2018,11,8,18,1179,1047,2226,1759
3405-000,2018,11,8,19,1091,958,2049,2226
3405-000,2018,11,8,20,507,595,1102,2049
3405-000,2018,11,8,21,348,492,840,1102
3405-000,2018,11,8,22,254,314,568,840
3405-000,2018,11,8,23,149,203,352,568
3405-000,2018,11,8,24,83,127,210,352
3405-000,2018,11,9,1,44,82,126,210
3405-000,2018,11,9,2,12,55,67,126
3405-000,2018,11,9,3,18,61,79,67
3405-000,2018,11,9,4,22,74,96,79
3405-000,2018,11,9,5,56,121,177,96
3405-000,2018,11,9,6,199,224,423,177
3405-000,2018,11,9,7,547,443,990,423
3405-000,2018,11,9,8,1436,1274,2710,990
3405-000,2018,11,9,9,1677,1326,3003,2710
3405-000,2018,11,9,10,1016,1029,2045,3003
3405-000,2018,11,9,11,1108,1071,2179,2045
3405-000,2018,11,9,12,957,1003,1960,2179
3405-000,2018,11,9,13,873,933,1806,1960
3405-000,2018,11,9,14,887,1083,1970,1806
3405-000,2018,11,9,15,1154,1206,2360,1970
3405-000,2018,11,9,16,1190,1155,2345,2360
3405-000,2018,11,9,17,1202,1095,2297,2345
3405-000,2018,11,9,18,1670,1266,2936,2297
3405-000,2018,11,9,19,1538,1181,2719,2936
3405-000,2018,11,9,20,814,776,1590,2719
3405-000,2018,11,9,21,497,609,1106,1590
3405-000,2018,11,9,22,300,359,659,1106
3405-000,2018,11,9,23,224,219,443,659
3405-000,2018,11,9,24,77,146,223,443
3405-000,2018,11,10,1,62,45,107,223
3405-000,2018,11,10,2,27,41,68,107
3405-000,2018,11,10,3,33,30,63,68
3405-000,2018,11,10,4,23,37,60,63
3405-000,2018,11,10,5,79,51,130,60
3405-000,2018,11,10,6,170,91,261,130
3405-000,2018,11,10,7,436,157,593,261
3405-000,2018,11,10,8,711,290,1001,593
3405-000,2018,11,10,9,902,386,1288,1001
3405-000,2018,11,10,10,915,435,1350,1288
3405-000,2018,11,10,11,1100,447,1547,1350
3405-000,2018,11,10,12,873,460,1333,1547
3405-000,2018,11,10,13,730,556,1286,1333
3405-000,2018,11,10,14,699,854,1553,1286
3405-000,2018,11,10,15,846,858,1704,1553
3405-000,2018,11,10,16,787,852,1639,1704
3405-000,2018,11,10,17,904,863,1767,1639
3405-000,2018,11,10,18,1022,964,1986,1767
3405-000,2018,11,10,19,760,738,1498,1986
3405-000,2018,11,10,20,417,563,980,1498
3405-000,2018,11,10,21,201,360,561,980
3405-000,2018,11,10,22,163,152,315,561
3405-000,2018,11,10,23,169,118,287,315
3405-000,2018,11,10,24,54,80,134,287
3405-000,2018,11,11,1,50,47,97,134
3405-000,2018,11,11,2,18,46,64,97
3405-000,2018,11,11,3,12,44,56,64
3405-000,2018,11,11,4,18,39,57,56
3405-000,2018,11,11,5,43,63,106,57
3405-000,2018,11,11,6,69,79,148,106
3405-000,2018,11,11,7,163,148,311,148
3405-000,2018,11,11,8,291,279,570,311
3405-000,2018,11,11,9,403,347,750,570
3405-000,2018,11,11,10,444,385,829,750
3405-000,2018,11,11,11,522,485,1007,829
3405-000,2018,11,11,12,516,398,914,1007
3405-000,2018,11,11,13,447,380,827,914
3405-000,2018,11,11,14,453,638,1091,827
3405-000,2018,11,11,15,558,655,1213,1091
3405-000,2018,11,11,16,640,722,1362,1213
3405-000,2018,11,11,17,654,868,1522,1362
3405-000,2018,11,11,18,647,874,1521,1522
3405-000,2018,11,11,19,528,856,1384,1521
3405-000,2018,11,11,20,390,713,1103,1384
3405-000,2018,11,11,21,285,360,645,1103
3405-000,2018,11,11,22,235,222,457,645
3405-000,2018,11,11,23,127,177,304,457
3405-000,2018,11,11,24,62,88,150,304
3405-000,2018,11,12,1,41,57,98,150
3405-000,2018,11,12,2,18,31,49,98
3405-000,2018,11,12,3,8,26,34,49
3405-000,2018,11,12,4,18,38,56,34
3405-000,2018,11,12,5,58,62,120,56
3405-000,2018,11,12,6,251,141,392,120
3405-000,2018,11,12,7,648,367,1015,392
3405-000,2018,11,12,8,1608,752,2360,1015
3405-000,2018,11,12,9,1639,707,2346,2360
3405-000,2018,11,12,10,1009,1008,2017,2346
3405-000,2018,11,12,11,900,1066,1966,2017
3405-000,2018,11,12,12,913,982,1895,1966
3405-000,2018,11,12,13,675,833,1508,1895
3405-000,2018,11,12,14,858,1024,1882,1508
3405-000,2018,11,12,15,894,1078,1972,1882
3405-000,2018,11,12,16,971,1109,2080,1972
3405-000,2018,11,12,17,951,1068,2019,2080
3405-000,2018,11,12,18,1400,1196,2596,2019
3405-000,2018,11,12,19,986,1074,2060,2596
3405-000,2018,11,12,20,640,702,1342,2060
3405-000,2018,11,12,21,375,578,953,1342
3405-000,2018,11,12,22,264,331,595,953
3405-000,2018,11,12,23,123,201,324,595
3405-000,2018,11,12,24,62,65,127,324
3405-000,2018,11,13,1,48,83,131,127
3405-000,2018,11,13,2,14,60,74,131
3405-000,2018,11,13,3,18,66,84,74
3405-000,2018,11,13,4,29,74,103,84
3405-000,2018,11,13,5,52,123,175,103
3405-000,2018,11,13,6,209,220,429,175
3405-000,2018,11,13,7,617,482,1099,429
3405-000,2018,11,13,8,1515,1344,2859,1099
3405-000,2018,11,13,9,1658,1377,3035,2859
3405-000,2018,11,13,10,978,1056,2034,3035
3405-000,2018,11,13,11,1091,1087,2178,2034
3405-000,2018,11,13,12,940,967,1907,2178
3405-000,2018,11,13,13,713,923,1636,1907
3405-000,2018,11,13,14,867,1036,1903,1636
3405-000,2018,11,13,15,1043,1045,2088,1903
3405-000,2018,11,13,16,1001,1099,2100,2088
3405-000,2018,11,13,17,942,1142,2084,2100
3405-000,2018,11,13,18,1349,1164,2513,2084
3405-000,2018,11,13,19,1077,1026,2103,2513
3405-000,2018,11,13,20,610,696,1306,2103
3405-000,2018,11,13,21,346,574,920,1306
3405-000,2018,11,13,22,241,369,610,920
3405-000,2018,11,13,23,151,192,343,610
3405-000,2018,11,13,24,86,20,106,343
3405-000,2018,11,14,1,37,76,113,106
3405-000,2018,11,14,2,22,71,93,113
3405-000,2018,11,14,3,12,55,67,93
3405-000,2018,11,14,4,29,80,109,67
3405-000,2018,11,14,5,50,121,171,109
3405-000,2018,11,14,6,211,206,417,171
3405-000,2018,11,14,7,612,496,1108,417
3405-000,2018,11,14,8,1482,1341,2823,1108
3405-000,2018,11,14,9,1693,1372,3065,2823
3405-000,2018,11,14,10,1083,1077,2160,3065
3405-000,2018,11,14,11,1039,1177,2216,2160
3405-000,2018,11,14,12,913,977,1890,2216
3405-000,2018,11,14,13,888,934,1822,1890
3405-000,2018,11,14,14,963,1051,2014,1822
3405-000,2018,11,14,15,1097,1142,2239,2014
3405-000,2018,11,14,16,1076,1137,2213,2239
3405-000,2018,11,14,17,1056,1112,2168,2213
3405-000,2018,11,14,18,1417,1231,2648,2168
3405-000,2018,11,14,19,1307,620,1927,2648
3405-000,2018,11,14,20,558,666,1224,1927
3405-000,2018,11,14,21,392,485,877,1224
3405-000,2018,11,14,22,291,316,607,877
3405-000,2018,11,14,23,163,202,365,607
3405-000,2018,11,14,24,96,123,219,365
3405-000,2018,11,15,1,27,89,116,219
3405-000,2018,11,15,2,25,75,100,116
3405-000,2018,11,15,3,27,55,82,100
3405-000,2018,11,15,4,25,66,91,82
3405-000,2018,11,15,5,62,117,179,91
3405-000,2018,11,15,6,211,184,395,179
3405-000,2018,11,15,7,671,456,1127,395
3405-000,2018,11,15,8,1509,1225,2734,1127
3405-000,2018,11,15,9,1547,1316,2863,2734
3405-000,2018,11,15,10,1076,970,2046,2863
3405-000,2018,11,15,11,1068,1060,2128,2046
3405-000,2018,11,15,12,915,914,1829,2128
3405-000,2018,11,15,13,739,824,1563,1829
3405-000,2018,11,15,14,953,962,1915,1563
3405-000,2018,11,15,15,1032,1054,2086,1915
3405-000,2018,11,15,16,1137,1021,2158,2086
3405-000,2018,11,15,17,1049,1058,2107,2158
3405-000,2018,11,15,18,1423,1145,2568,2107
3405-000,2018,11,15,19,1278,1004,2282,2568
3405-000,2018,11,15,20,608,620,1228,2282
3405-000,2018,11,15,21,375,525,900,1228
3405-000,2018,11,15,22,275,333,608,900
3405-000,2018,11,15,23,136,215,351,608
3405-000,2018,11,15,24,65,138,203,351
3405-000,2018,11,16,1,41,86,127,203
3405-000,2018,11,16,2,25,57,82,127
3405-000,2018,11,16,3,25,61,86,82
3405-000,2018,11,16,4,31,85,116,86
3405-000,2018,11,16,5,69,119,188,116
3405-000,2018,11,16,6,199,216,415,188
3405-000,2018,11,16,7,568,459,1027,415
3405-000,2018,11,16,8,1482,1287,2769,1027
3405-000,2018,11,16,9,1501,1354,2855,2769
3405-000,2018,11,16,10,1104,1048,2152,2855
3405-000,2018,11,16,11,1121,1068,2189,2152
3405-000,2018,11,16,12,1064,989,2053,2189
3405-000,2018,11,16,13,827,931,1758,2053
3405-000,2018,11,16,14,976,1092,2068,1758
3405-000,2018,11,16,15,1129,1197,2326,2068
3405-000,2018,11,16,16,1184,1168,2352,2326
3405-000,2018,11,16,17,1282,1145,2427,2352
3405-000,2018,11,16,18,1879,1326,3205,2427
3405-000,2018,11,16,19,1750,1262,3012,3205
3405-000,2018,11,16,20,965,867,1832,3012
3405-000,2018,11,16,21,566,615,1181,1832
3405-000,2018,11,16,22,342,379,721,1181
3405-000,2018,11,16,23,220,243,463,721
3405-000,2018,11,16,24,73,147,220,463
3405-000,2018,11,17,1,46,71,117,220
3405-000,2018,11,17,2,44,61,105,117
3405-000,2018,11,17,3,16,48,64,105
3405-000,2018,11,17,4,20,58,78,64
3405-000,2018,11,17,5,60,70,130,78
3405-000,2018,11,17,6,188,119,307,130
3405-000,2018,11,17,7,474,232,706,307
3405-000,2018,11,17,8,747,402,1149,706
3405-000,2018,11,17,9,932,535,1467,1149
3405-000,2018,11,17,10,925,614,1539,1467
3405-000,2018,11,17,11,1034,581,1615,1539
3405-000,2018,11,17,12,1284,637,1921,1615
3405-000,2018,11,17,13,1039,730,1769,1921
3405-000,2018,11,17,14,992,877,1869,1769
3405-000,2018,11,17,15,972,829,1801,1869
3405-000,2018,11,17,16,875,846,1721,1801
3405-000,2018,11,17,17,848,807,1655,1721
3405-000,2018,11,17,18,1051,897,1948,1655
3405-000,2018,11,17,19,762,666,1428,1948
3405-000,2018,11,17,20,390,508,898,1428
3405-000,2018,11,17,21,233,333,566,898
3405-000,2018,11,17,22,159,203,362,566
3405-000,2018,11,17,23,107,148,255,362
3405-000,2018,11,17,24,73,99,172,255
3405-000,2018,11,18,1,41,17,58,172
3405-000,2018,11,18,2,29,44,73,58
3405-000,2018,11,18,3,25,41,66,73
3405-000,2018,11,18,4,18,41,59,66
3405-000,2018,11,18,5,27,61,88,59
3405-000,2018,11,18,6,111,78,189,88
3405-000,2018,11,18,7,226,147,373,189
3405-000,2018,11,18,8,253,295,548,373
3405-000,2018,11,18,9,363,367,730,548
3405-000,2018,11,18,10,401,383,784,730
3405-000,2018,11,18,11,547,490,1037,784
3405-000,2018,11,18,12,505,468,973,1037
3405-000,2018,11,18,13,489,486,975,973
3405-000,2018,11,18,14,612,613,1225,975
3405-000,2018,11,18,15,715,635,1350,1225
3405-000,2018,11,18,16,675,710,1385,1350
3405-000,2018,11,18,17,743,876,1619,1385
3405-000,2018,11,18,18,762,904,1666,1619
3405-000,2018,11,18,19,629,885,1514,1666
3405-000,2018,11,18,20,564,757,1321,1514
3405-000,2018,11,18,21,419,556,975,1321
3405-000,2018,11,18,22,228,443,671,975
3405-000,2018,11,18,23,136,353,489,671
3405-000,2018,11,18,24,65,175,240,489
3405-000,2018,11,19,1,29,114,143,240
3405-000,2018,11,19,2,18,62,80,143
3405-000,2018,11,19,3,8,51,59,80
3405-000,2018,11,19,4,31,73,104,59
3405-000,2018,11,19,5,69,123,192,104
3405-000,2018,11,19,6,230,272,502,192
3405-000,2018,11,19,7,741,594,1335,502
3405-000,2018,11,19,8,1524,1503,3027,1335
3405-000,2018,11,19,9,1639,1413,3052,3027
3405-000,2018,11,19,10,1028,903,1931,3052
3405-000,2018,11,19,11,997,1049,2046,1931
3405-000,2018,11,19,12,908,983,1891,2046
3405-000,2018,11,19,13,675,905,1580,1891
3405-000,2018,11,19,14,938,1024,1962,1580
3405-000,2018,11,19,15,1085,1064,2149,1962
3405-000,2018,11,19,16,1129,1084,2213,2149
3405-000,2018,11,19,17,1135,1071,2206,2213
3405-000,2018,11,19,18,1442,1159,2601,2206
3405-000,2018,11,19,19,1091,1070,2161,2601
3405-000,2018,11,19,20,524,675,1199,2161
3405-000,2018,11,19,21,384,556,940,1199
3405-000,2018,11,19,22,224,336,560,940
3405-000,2018,11,19,23,128,233,361,560
3405-000,2018,11,19,24,44,129,173,361
3405-000,2018,11,20,1,25,93,118,173
3405-000,2018,11,20,2,12,57,69,118
3405-000,2018,11,20,3,6,61,67,69
3405-000,2018,11,20,4,20,71,91,67
3405-000,2018,11,20,5,58,114,172,91
3405-000,2018,11,20,6,178,218,396,172
3405-000,2018,11,20,7,585,496,1081,396
3405-000,2018,11,20,8,1580,1310,2890,1081
3405-000,2018,11,20,9,1684,1355,3039,2890
3405-000,2018,11,20,10,1087,994,2081,3039
3405-000,2018,11,20,11,1087,1063,2150,2081
3405-000,2018,11,20,12,875,958,1833,2150
3405-000,2018,11,20,13,726,896,1622,1833
3405-000,2018,11,20,14,890,1099,1989,1622
3405-000,2018,11,20,15,997,1170,2167,1989
3405-000,2018,11,20,16,934,1099,2033,2167
3405-000,2018,11,20,17,957,1155,2112,2033
3405-000,2018,11,20,18,1412,1162,2574,2112
3405-000,2018,11,20,19,1161,1019,2180,2574
3405-000,2018,11,20,20,589,681,1270,2180
3405-000,2018,11,20,21,400,578,978,1270
3405-000,2018,11,20,22,266,365,631,978
3405-000,2018,11,20,23,172,231,403,631
3405-000,2018,11,20,24,85,125,210,403
3405-000,2018,11,21,1,29,79,108,210
3405-000,2018,11,21,2,20,61,81,108
3405-000,2018,11,21,3,20,64,84,81
3405-000,2018,11,21,4,31,79,110,84
3405-000,2018,11,21,5,44,123,167,110
3405-000,2018,11,21,6,224,216,440,167
3405-000,2018,11,21,7,581,456,1037,440
3405-000,2018,11,21,8,1475,1256,2731,1037
3405-000,2018,11,21,9,1688,1403,3091,2731
3405-000,2018,11,21,10,1213,975,2188,3091
3405-000,2018,11,21,11,1032,1054,2086,2188
3405-000,2018,11,21,12,890,875,1765,2086
3405-000,2018,11,21,13,823,861,1684,1765
3405-000,2018,11,21,14,896,1037,1933,1684
3405-000,2018,11,21,15,1110,1079,2189,1933
3405-000,2018,11,21,16,978,1034,2012,2189
3405-000,2018,11,21,17,971,1051,2022,2012
3405-000,2018,11,21,18,1393,1116,2509,2022
3405-000,2018,11,21,19,1053,951,2004,2509
3405-000,2018,11,21,20,516,673,1189,2004
3405-000,2018,11,21,21,308,475,783,1189
3405-000,2018,11,21,22,188,325,513,783
3405-000,2018,11,21,23,140,202,342,513
3405-000,2018,11,21,24,69,131,200,342
3405-000,2018,11,22,1,50,79,129,200
3405-000,2018,11,22,2,20,81,101,129
3405-000,2018,11,22,3,8,57,65,101
3405-000,2018,11,22,4,12,67,79,65
3405-000,2018,11,22,5,54,106,160,79
3405-000,2018,11,22,6,191,195,386,160
3405-000,2018,11,22,7,568,476,1044,386
3405-000,2018,11,22,8,1498,1255,2753,1044
3405-000,2018,11,22,9,1569,1329,2898,2753
3405-000,2018,11,22,10,1028,990,2018,2898
3405-000,2018,11,22,11,1102,1133,2235,2018
3405-000,2018,11,22,12,892,965,1857,2235
3405-000,2018,11,22,13,703,852,1555,1857
3405-000,2018,11,22,14,967,1016,1983,1555
3405-000,2018,11,22,15,1119,1092,2211,1983
3405-000,2018,11,22,16,1165,1074,2239,2211
3405-000,2018,11,22,17,1009,1137,2146,2239
3405-000,2018,11,22,18,1410,1243,2653,2146
3405-000,2018,11,22,19,1244,1050,2294,2653
3405-000,2018,11,22,20,501,644,1145,2294
3405-000,2018,11,22,21,438,557,995,1145
3405-000,2018,11,22,22,218,352,570,995
3405-000,2018,11,22,23,96,226,322,570
3405-000,2018,11,22,24,77,148,225,322
3405-000,2018,11,23,1,33,90,123,225
3405-000,2018,11,23,2,20,59,79,123
3405-000,2018,11,23,3,18,60,78,79
3405-000,2018,11,23,4,25,96,121,78
3405-000,2018,11,23,5,52,117,169,121
3405-000,2018,11,23,6,203,208,411,169
3405-000,2018,11,23,7,594,474,1068,411
3405-000,2018,11,23,8,1431,1299,2730,1068
3405-000,2018,11,23,9,1578,1382,2960,2730
3405-000,2018,11,23,10,1074,1066,2140,2960
3405-000,2018,11,23,11,1089,1064,2153,2140
3405-000,2018,11,23,12,948,975,1923,2153
3405-000,2018,11,23,13,810,929,1739,1923
3405-000,2018,11,23,14,1047,1101,2148,1739
3405-000,2018,11,23,15,1146,1187,2333,2148
3405-000,2018,11,23,16,1188,1180,2368,2333
3405-000,2018,11,23,17,1217,1194,2411,2368
3405-000,2018,11,23,18,1806,1385,3191,2411
3405-000,2018,11,23,19,1805,1342,3147,3191
3405-000,2018,11,23,20,802,957,1759,3147
3405-000,2018,11,23,21,522,621,1143,1759
3405-000,2018,11,23,22,310,399,709,1143
3405-000,2018,11,23,23,186,266,452,709
3405-000,2018,11,23,24,85,148,233,452
3405-000,2018,11,24,1,54,97,151,233
3405-000,2018,11,24,2,41,81,122,151
3405-000,2018,11,24,3,18,66,84,122
3405-000,2018,11,24,4,14,78,92,84
3405-000,2018,11,24,5,60,88,148,92
3405-000,2018,11,24,6,167,146,313,148
3405-000,2018,11,24,7,342,307,649,313
3405-000,2018,11,24,8,556,513,1069,649
3405-000,2018,11,24,9,781,683,1464,1069
3405-000,2018,11,24,10,696,792,1488,1464
3405-000,2018,11,24,11,682,715,1397,1488
3405-000,2018,11,24,12,759,813,1572,1397
3405-000,2018,11,24,13,694,903,1597,1572
3405-000,2018,11,24,14,684,899,1583,1597
3405-000,2018,11,24,15,755,800,1555,1583
3405-000,2018,11,24,16,757,840,1597,1555
3405-000,2018,11,24,17,791,750,1541,1597
3405-000,2018,11,24,18,787,830,1617,1541
3405-000,2018,11,24,19,612,593,1205,1617
3405-000,2018,11,24,20,354,452,806,1205
3405-000,2018,11,24,21,258,305,563,806
3405-000,2018,11,24,22,125,253,378,563
3405-000,2018,11,24,23,104,178,282,378
3405-000,2018,11,24,24,60,118,178,282
3405-000,2018,11,25,1,37,74,111,178
3405-000,2018,11,25,2,29,48,77,111
3405-000,2018,11,25,3,14,35,49,77
3405-000,2018,11,25,4,23,39,62,49
3405-000,2018,11,25,5,23,46,69,62
3405-000,2018,11,25,6,75,61,136,69
3405-000,2018,11,25,7,205,164,369,136
3405-000,2018,11,25,8,211,262,473,369
3405-000,2018,11,25,9,254,298,552,473
3405-000,2018,11,25,10,333,381,714,552
3405-000,2018,11,25,11,478,439,917,714
3405-000,2018,11,25,12,518,513,1031,917
3405-000,2018,11,25,13,447,529,976,1031
3405-000,2018,11,25,14,505,561,1066,976
3405-000,2018,11,25,15,581,627,1208,1066
3405-000,2018,11,25,16,671,729,1400,1208
3405-000,2018,11,25,17,695,755,1450,1400
3405-000,2018,11,25,18,697,772,1469,1450
3405-000,2018,11,25,19,604,691,1295,1469
3405-000,2018,11,25,20,533,610,1143,1295
3405-000,2018,11,25,21,354,419,773,1143
3405-000,2018,11,25,22,211,330,541,773
3405-000,2018,11,25,23,172,259,431,541
3405-000,2018,11,25,24,125,184,309,431
3405-000,2018,11,26,1,27,112,139,309
3405-000,2018,11,26,2,12,52,64,139
3405-000,2018,11,26,3,12,40,52,64
3405-000,2018,11,26,4,10,61,71,52
3405-000,2018,11,26,5,81,110,191,71
3405-000,2018,11,26,6,212,265,477,191
3405-000,2018,11,26,7,715,603,1318,477
3405-000,2018,11,26,8,1515,1495,3010,1318
3405-000,2018,11,26,9,1587,1396,2983,3010
3405-000,2018,11,26,10,974,991,1965,2983
3405-000,2018,11,26,11,906,1093,1999,1965
3405-000,2018,11,26,12,925,1019,1944,1999
3405-000,2018,11,26,13,730,900,1630,1944
3405-000,2018,11,26,14,938,1047,1985,1630
3405-000,2018,11,26,15,1091,1142,2233,1985
3405-000,2018,11,26,16,1097,1086,2183,2233
3405-000,2018,11,26,17,946,1092,2038,2183
3405-000,2018,11,26,18,1351,1192,2543,2038
3405-000,2018,11,26,19,1119,1048,2167,2543
3405-000,2018,11,26,20,568,654,1222,2167
3405-000,2018,11,26,21,373,550,923,1222
3405-000,2018,11,26,22,251,348,599,923
3405-000,2018,11,26,23,151,216,367,599
3405-000,2018,11,26,24,90,110,200,367
3405-000,2018,11,27,1,31,92,123,200
3405-000,2018,11,27,2,8,76,84,123
3405-000,2018,11,27,3,20,73,93,84
3405-000,2018,11,27,4,23,71,94,93
3405-000,2018,11,27,5,50,123,173,94
3405-000,2018,11,27,6,169,220,389,173
3405-000,2018,11,27,7,613,528,1141,389
3405-000,2018,11,27,8,1568,1348,2916,1141
3405-000,2018,11,27,9,1571,1315,2886,2916
3405-000,2018,11,27,10,1140,1036,2176,2886
3405-000,2018,11,27,11,1089,1164,2253,2176
3405-000,2018,11,27,12,908,1091,1999,2253
3405-000,2018,11,27,13,720,1014,1734,1999
3405-000,2018,11,27,14,878,1120,1998,1734
3405-000,2018,11,27,15,1102,1169,2271,1998
3405-000,2018,11,27,16,1032,1043,2075,2271
3405-000,2018,11,27,17,967,1106,2073,2075
3405-000,2018,11,27,18,1366,1210,2576,2073
3405-000,2018,11,27,19,1081,1032,2113,2576
3405-000,2018,11,27,20,537,669,1206,2113
3405-000,2018,11,27,21,444,589,1033,1206
3405-000,2018,11,27,22,237,317,554,1033
3405-000,2018,11,27,23,138,224,362,554
3405-000,2018,11,27,24,83,136,219,362
3405-000,2018,11,28,1,43,85,128,219
3405-000,2018,11,28,2,18,75,93,128
3405-000,2018,11,28,3,10,70,80,93
3405-000,2018,11,28,4,16,79,95,80
3405-000,2018,11,28,5,69,141,210,95
3405-000,2018,11,28,6,199,214,413,210
3405-000,2018,11,28,7,610,496,1106,413
3405-000,2018,11,28,8,1557,1336,2893,1106
3405-000,2018,11,28,9,1685,1370,3055,2893
3405-000,2018,11,28,10,1060,1048,2108,3055
3405-000,2018,11,28,11,1032,1067,2099,2108
3405-000,2018,11,28,12,984,1089,2073,2099
3405-000,2018,11,28,13,694,1051,1745,2073
3405-000,2018,11,28,14,906,1085,1991,1745
3405-000,2018,11,28,15,1011,1141,2152,1991
3405-000,2018,11,28,16,1068,1091,2159,2152
3405-000,2018,11,28,17,1007,1081,2088,2159
3405-000,2018,11,28,18,1570,1288,2858,2088
3405-000,2018,11,28,19,1259,1037,2296,2858
3405-000,2018,11,28,20,552,629,1181,2296
3405-000,2018,11,28,21,342,500,842,1181
3405-000,2018,11,28,22,197,360,557,842
3405-000,2018,11,28,23,146,208,354,557
3405-000,2018,11,28,24,96,131,227,354
3405-000,2018,11,29,1,31,111,142,227
3405-000,2018,11,29,2,23,58,81,142
3405-000,2018,11,29,3,10,59,69,81
3405-000,2018,11,29,4,25,77,102,69
3405-000,2018,11,29,5,35,120,155,102
3405-000,2018,11,29,6,182,211,393,155
3405-000,2018,11,29,7,638,505,1143,393
3405-000,2018,11,29,8,1564,1324,2888,1143
3405-000,2018,11,29,9,1596,1391,2987,2888
3405-000,2018,11,29,10,1154,1079,2233,2987
3405-000,2018,11,29,11,1030,1116,2146,2233
3405-000,2018,11,29,12,892,1111,2003,2146
3405-000,2018,11,29,13,703,1023,1726,2003
3405-000,2018,11,29,14,848,1057,1905,1726
3405-000,2018,11,29,15,1045,1164,2209,1905
3405-000,2018,11,29,16,1013,1043,2056,2209
3405-000,2018,11,29,17,1062,1122,2184,2056
3405-000,2018,11,29,18,1419,1217,2636,2184
3405-000,2018,11,29,19,1140,991,2131,2636
3405-000,2018,11,29,20,510,650,1160,2131
3405-000,2018,11,29,21,382,517,899,1160
3405-000,2018,11,29,22,254,362,616,899
3405-000,2018,11,29,23,161,200,361,616
3405-000,2018,11,29,24,94,146,240,361
3405-000,2018,11,30,1,48,116,164,240
3405-000,2018,11,30,2,14,66,80,164
3405-000,2018,11,30,3,18,68,86,80
3405-000,2018,11,30,4,20,90,110,86
3405-000,2018,11,30,5,64,120,184,110
3405-000,2018,11,30,6,155,191,346,184
3405-000,2018,11,30,7,581,471,1052,346
3405-000,2018,11,30,8,1499,1298,2797,1052
3405-000,2018,11,30,9,1601,1323,2924,2797
3405-000,2018,11,30,10,1100,1033,2133,2924
3405-000,2018,11,30,11,992,1005,1997,2133
3405-000,2018,11,30,12,1007,942,1949,1997
3405-000,2018,11,30,13,724,869,1593,1949
3405-000,2018,11,30,14,864,1048,1912,1593
3405-000,2018,11,30,15,1202,1164,2366,1912
3405-000,2018,11,30,16,1158,1127,2285,2366
3405-000,2018,11,30,17,1226,1118,2344,2285
3405-000,2018,11,30,18,1857,1348,3205,2344
3405-000,2018,11,30,19,1637,1302,2939,3205
3405-000,2018,11,30,20,835,912,1747,2939
3405-000,2018,11,30,21,526,618,1144,1747
3405-000,2018,11,30,22,325,389,714,1144
3405-000,2018,11,30,23,172,237,409,714
3405-000,2018,11,30,24,86,144,230,409
3405-000,2018,12,1,1,64,135,199,230
3405-000,2018,12,1,2,44,69,113,199
3405-000,2018,12,1,3,19,78,97,113
3405-000,2018,12,1,4,34,72,106,97
3405-000,2018,12,1,5,53,114,167,106
3405-000,2018,12,1,6,169,163,332,167
3405-000,2018,12,1,7,414,301,715,332
3405-000,2018,12,1,8,713,592,1305,715
3405-000,2018,12,1,9,775,701,1476,1305
3405-000,2018,12,1,10,851,772,1623,1476
3405-000,2018,12,1,11,885,872,1757,1623
3405-000,2018,12,1,12,810,844,1654,1757
3405-000,2018,12,1,13,694,856,1550,1654
3405-000,2018,12,1,14,664,767,1431,1550
3405-000,2018,12,1,15,747,750,1497,1431
3405-000,2018,12,1,16,844,792,1636,1497
3405-000,2018,12,1,17,906,774,1680,1636
3405-000,2018,12,1,18,962,871,1833,1680
3405-000,2018,12,1,19,651,670,1321,1833
3405-000,2018,12,1,20,326,462,788,1321
3405-000,2018,12,1,21,217,352,569,788
3405-000,2018,12,1,22,143,278,421,569
3405-000,2018,12,1,23,105,185,290,421
3405-000,2018,12,1,24,64,156,220,290
3405-000,2018,12,2,1,40,74,114,220
3405-000,2018,12,2,2,21,49,70,114
3405-000,2018,12,2,3,19,40,59,70
3405-000,2018,12,2,4,25,32,57,59
3405-000,2018,12,2,5,25,51,76,57
3405-000,2018,12,2,6,42,67,109,76
3405-000,2018,12,2,7,159,147,306,109
3405-000,2018,12,2,8,303,273,576,306
3405-000,2018,12,2,9,328,324,652,576
3405-000,2018,12,2,10,391,377,768,652
3405-000,2018,12,2,11,520,545,1065,768
3405-000,2018,12,2,12,451,527,978,1065
3405-000,2018,12,2,13,429,604,1033,978
3405-000,2018,12,2,14,498,657,1155,1033
3405-000,2018,12,2,15,560,711,1271,1155
3405-000,2018,12,2,16,720,692,1412,1271
3405-000,2018,12,2,17,685,716,1401,1412
3405-000,2018,12,2,18,648,736,1384,1401
3405-000,2018,12,2,19,470,615,1085,1384
3405-000,2018,12,2,20,335,500,835,1085
3405-000,2018,12,2,21,247,382,629,835
3405-000,2018,12,2,22,188,316,504,629
3405-000,2018,12,2,23,113,262,375,504
3405-000,2018,12,2,24,66,166,232,375
3405-000,2018,12,3,1,27,99,126,232
3405-000,2018,12,3,2,14,56,70,126
3405-000,2018,12,3,3,10,71,81,70
3405-000,2018,12,3,4,29,48,77,81
3405-000,2018,12,3,5,60,115,175,77
3405-000,2018,12,3,6,214,209,423,175
3405-000,2018,12,3,7,563,530,1093,423
3405-000,2018,12,3,8,1349,1374,2723,1093
3405-000,2018,12,3,9,1544,1328,2872,2723
3405-000,2018,12,3,10,911,967,1878,2872
3405-000,2018,12,3,11,988,960,1948,1878
3405-000,2018,12,3,12,782,973,1755,1948
3405-000,2018,12,3,13,726,835,1561,1755
3405-000,2018,12,3,14,767,983,1750,1561
3405-000,2018,12,3,15,1007,1076,2083,1750
3405-000,2018,12,3,16,1033,1047,2080,2083
3405-000,2018,12,3,17,784,931,1715,2080
3405-000,2018,12,3,18,1173,1078,2251,1715
3405-000,2018,12,3,19,1014,944,1958,2251
3405-000,2018,12,3,20,438,642,1080,1958
3405-000,2018,12,3,21,337,505,842,1080
3405-000,2018,12,3,22,191,343,534,842
3405-000,2018,12,3,23,107,201,308,534
3405-000,2018,12,3,24,30,124,154,308
3405-000,2018,12,4,1,23,91,114,154
3405-000,2018,12,4,2,21,72,93,114
3405-000,2018,12,4,3,8,59,67,93
3405-000,2018,12,4,4,19,78,97,67
3405-000,2018,12,4,5,60,89,149,97
3405-000,2018,12,4,6,131,195,326,149
3405-000,2018,12,4,7,520,414,934,326
3405-000,2018,12,4,8,1364,1169,2533,934
3405-000,2018,12,4,9,1475,1332,2807,2533
3405-000,2018,12,4,10,1003,1018,2021,2807
3405-000,2018,12,4,11,962,1020,1982,2021
3405-000,2018,12,4,12,906,1052,1958,1982
3405-000,2018,12,4,13,773,950,1723,1958
3405-000,2018,12,4,14,969,1064,2033,1723
3405-000,2018,12,4,15,1040,1093,2133,2033
3405-000,2018,12,4,16,952,1064,2016,2133
3405-000,2018,12,4,17,883,1032,1915,2016
3405-000,2018,12,4,18,1240,1185,2425,1915
3405-000,2018,12,4,19,1003,988,1991,2425
3405-000,2018,12,4,20,519,641,1160,1991
3405-000,2018,12,4,21,378,496,874,1160
3405-000,2018,12,4,22,214,350,564,874
3405-000,2018,12,4,23,120,194,314,564
3405-000,2018,12,4,24,72,132,204,314
3405-000,2018,12,5,1,34,88,122,204
3405-000,2018,12,5,2,25,73,98,122
3405-000,2018,12,5,3,21,68,89,98
3405-000,2018,12,5,4,21,66,87,89
3405-000,2018,12,5,5,49,110,159,87
3405-000,2018,12,5,6,180,194,374,159
3405-000,2018,12,5,7,541,428,969,374
3405-000,2018,12,5,8,1532,994,2526,969
3405-000,2018,12,5,9,1668,1337,3005,2526
3405-000,2018,12,5,10,1087,1070,2157,3005
3405-000,2018,12,5,11,1038,1080,2118,2157
3405-000,2018,12,5,12,914,1131,2045,2118
3405-000,2018,12,5,13,754,1066,1820,2045
3405-000,2018,12,5,14,913,1145,2058,1820
3405-000,2018,12,5,15,1065,1110,2175,2058
3405-000,2018,12,5,16,1022,1082,2104,2175
3405-000,2018,12,5,17,1001,1132,2133,2104
3405-000,2018,12,5,18,1399,1292,2691,2133
3405-000,2018,12,5,19,1121,1033,2154,2691
3405-000,2018,12,5,20,522,640,1162,2154
3405-000,2018,12,5,21,313,486,799,1162
3405-000,2018,12,5,22,247,358,605,799
3405-000,2018,12,5,23,120,188,308,605
3405-000,2018,12,5,24,73,139,212,308
3405-000,2018,12,6,1,29,86,115,212
3405-000,2018,12,6,2,17,74,91,115
3405-000,2018,12,6,3,2,76,78,91
3405-000,2018,12,6,4,15,54,69,78
3405-000,2018,12,6,5,47,132,179,69
3405-000,2018,12,6,6,148,192,340,179
3405-000,2018,12,6,7,575,443,1018,340
3405-000,2018,12,6,8,1472,1325,2797,1018
3405-000,2018,12,6,9,1720,1335,3055,2797
3405-000,2018,12,6,10,1141,1018,2159,3055
3405-000,2018,12,6,11,1057,1052,2109,2159
3405-000,2018,12,6,12,923,1008,1931,2109
3405-000,2018,12,6,13,734,901,1635,1931
3405-000,2018,12,6,14,857,1003,1860,1635
3405-000,2018,12,6,15,936,1126,2062,1860
3405-000,2018,12,6,16,1007,1103,2110,2062
3405-000,2018,12,6,17,1014,1139,2153,2110
3405-000,2018,12,6,18,1334,1186,2520,2153
3405-000,2018,12,6,19,988,1029,2017,2520
3405-000,2018,12,6,20,479,634,1113,2017
3405-000,2018,12,6,21,337,533,870,1113
3405-000,2018,12,6,22,238,354,592,870
3405-000,2018,12,6,23,105,211,316,592
3405-000,2018,12,6,24,75,148,223,316
3405-000,2018,12,7,1,36,103,139,223
3405-000,2018,12,7,2,19,62,81,139
3405-000,2018,12,7,3,19,68,87,81
3405-000,2018,12,7,4,15,71,86,87
3405-000,2018,12,7,5,44,128,172,86
3405-000,2018,12,7,6,143,175,318,172
3405-000,2018,12,7,7,490,456,946,318
3405-000,2018,12,7,8,1390,1213,2603,946
3405-000,2018,12,7,9,1549,1270,2819,2603
3405-000,2018,12,7,10,973,956,1929,2819
3405-000,2018,12,7,11,954,1036,1990,1929
3405-000,2018,12,7,12,825,970,1795,1990
3405-000,2018,12,7,13,721,920,1641,1795
3405-000,2018,12,7,14,818,1014,1832,1641
3405-000,2018,12,7,15,934,1078,2012,1832
3405-000,2018,12,7,16,1025,1073,2098,2012
3405-000,2018,12,7,17,1156,1103,2259,2098
3405-000,2018,12,7,18,1666,1253,2919,2259
3405-000,2018,12,7,19,1398,1131,2529,2919
3405-000,2018,12,7,20,795,746,1541,2529
3405-000,2018,12,7,21,421,531,952,1541
3405-000,2018,12,7,22,249,377,626,952
3405-000,2018,12,7,23,159,202,361,626
3405-000,2018,12,7,24,75,153,228,361
3405-000,2018,12,8,1,58,98,156,228
3405-000,2018,12,8,2,30,70,100,156
3405-000,2018,12,8,3,23,51,74,100
3405-000,2018,12,8,4,27,59,86,74
3405-000,2018,12,8,5,45,97,142,86
3405-000,2018,12,8,6,98,131,229,142
3405-000,2018,12,8,7,313,250,563,229
3405-000,2018,12,8,8,537,515,1052,563
3405-000,2018,12,8,9,704,621,1325,1052
3405-000,2018,12,8,10,728,631,1359,1325
3405-000,2018,12,8,11,713,704,1417,1359
3405-000,2018,12,8,12,734,721,1455,1417
3405-000,2018,12,8,13,582,661,1243,1455
3405-000,2018,12,8,14,532,688,1220,1243
3405-000,2018,12,8,15,666,752,1418,1220
3405-000,2018,12,8,16,754,735,1489,1418
3405-000,2018,12,8,17,775,778,1553,1489
3405-000,2018,12,8,18,815,748,1563,1553
3405-000,2018,12,8,19,556,563,1119,1563
3405-000,2018,12,8,20,360,384,744,1119
3405-000,2018,12,8,21,184,277,461,744
3405-000,2018,12,8,22,146,256,402,461
3405-000,2018,12,8,23,85,171,256,402
3405-000,2018,12,8,24,64,143,207,256
3405-000,2018,12,9,1,45,84,129,207
3405-000,2018,12,9,2,27,55,82,129
3405-000,2018,12,9,3,10,30,40,82
3405-000,2018,12,9,4,15,36,51,40
3405-000,2018,12,9,5,23,50,73,51
3405-000,2018,12,9,6,49,49,98,73
3405-000,2018,12,9,7,107,114,221,98
3405-000,2018,12,9,8,199,201,400,221
3405-000,2018,12,9,9,229,259,488,400
3405-000,2018,12,9,10,303,328,631,488
3405-000,2018,12,9,11,390,455,845,631
3405-000,2018,12,9,12,401,532,933,845
3405-000,2018,12,9,13,375,475,850,933
3405-000,2018,12,9,14,449,526,975,850
3405-000,2018,12,9,15,498,602,1100,975
3405-000,2018,12,9,16,502,641,1143,1100
3405-000,2018,12,9,17,531,676,1207,1143
3405-000,2018,12,9,18,513,701,1214,1207
3405-000,2018,12,9,19,363,539,902,1214
3405-000,2018,12,9,20,247,389,636,902
3405-000,2018,12,9,21,240,346,586,636
3405-000,2018,12,9,22,173,302,475,586
3405-000,2018,12,9,23,73,264,337,475
3405-000,2018,12,9,24,75,147,222,337
3405-000,2018,12,10,1,32,80,112,222
3405-000,2018,12,10,2,17,56,73,112
3405-000,2018,12,10,3,12,39,51,73
3405-000,2018,12,10,4,21,45,66,51
3405-000,2018,12,10,5,62,108,170,66
3405-000,2018,12,10,6,193,215,408,170
3405-000,2018,12,10,7,621,560,1181,408
3405-000,2018,12,10,8,1472,1451,2923,1181
3405-000,2018,12,10,9,1542,1359,2901,2923
3405-000,2018,12,10,10,990,897,1887,2901
3405-000,2018,12,10,11,915,1050,1965,1887
3405-000,2018,12,10,12,838,1003,1841,1965
3405-000,2018,12,10,13,631,889,1520,1841
3405-000,2018,12,10,14,823,994,1817,1520
3405-000,2018,12,10,15,958,1088,2046,1817
3405-000,2018,12,10,16,1001,1053,2054,2046
3405-000,2018,12,10,17,930,1046,1976,2054
3405-000,2018,12,10,18,1244,1199,2443,1976
3405-000,2018,12,10,19,1005,1065,2070,2443
3405-000,2018,12,10,20,580,649,1229,2070
3405-000,2018,12,10,21,382,535,917,1229
3405-000,2018,12,10,22,227,383,610,917
3405-000,2018,12,10,23,143,196,339,610
3405-000,2018,12,10,24,66,122,188,339
3405-000,2018,12,11,1,23,79,102,188
3405-000,2018,12,11,2,15,69,84,102
3405-000,2018,12,11,3,10,59,69,84
3405-000,2018,12,11,4,14,93,107,69
3405-000,2018,12,11,5,47,133,180,107
3405-000,2018,12,11,6,163,178,341,180
3405-000,2018,12,11,7,500,433,933,341
3405-000,2018,12,11,8,1495,1298,2793,933
3405-000,2018,12,11,9,1563,1306,2869,2793
3405-000,2018,12,11,10,1083,1014,2097,2869
3405-000,2018,12,11,11,952,1057,2009,2097
3405-000,2018,12,11,12,913,1003,1916,2009
3405-000,2018,12,11,13,700,897,1597,1916
3405-000,2018,12,11,14,908,1103,2011,1597
3405-000,2018,12,11,15,977,1064,2041,2011
3405-000,2018,12,11,16,932,1009,1941,2041
3405-000,2018,12,11,17,928,977,1905,1941
3405-000,2018,12,11,18,1171,1084,2255,1905
3405-000,2018,12,11,19,1029,947,1976,2255
3405-000,2018,12,11,20,489,584,1073,1976
3405-000,2018,12,11,21,363,516,879,1073
3405-000,2018,12,11,22,212,347,559,879
3405-000,2018,12,11,23,154,192,346,559
3405-000,2018,12,11,24,57,139,196,346
3405-000,2018,12,12,1,25,87,112,196
3405-000,2018,12,12,2,23,65,88,112
3405-000,2018,12,12,3,19,61,80,88
3405-000,2018,12,12,4,27,62,89,80
3405-000,2018,12,12,5,45,116,161,89
3405-000,2018,12,12,6,161,172,333,161
3405-000,2018,12,12,7,481,452,933,333
3405-000,2018,12,12,8,1446,1260,2706,933
3405-000,2018,12,12,9,1526,1291,2817,2706
3405-000,2018,12,12,10,1085,1004,2089,2817
3405-000,2018,12,12,11,943,1163,2106,2089
3405-000,2018,12,12,12,808,1067,1875,2106
3405-000,2018,12,12,13,771,993,1764,1875
3405-000,2018,12,12,14,889,1008,1897,1764
3405-000,2018,12,12,15,994,1130,2124,1897
3405-000,2018,12,12,16,1009,1072,2081,2124
3405-000,2018,12,12,17,971,1108,2079,2081
3405-000,2018,12,12,18,1435,1237,2672,2079
3405-000,2018,12,12,19,1022,1064,2086,2672
3405-000,2018,12,12,20,571,621,1192,2086
3405-000,2018,12,12,21,339,477,816,1192
3405-000,2018,12,12,22,204,322,526,816
3405-000,2018,12,12,23,137,211,348,526
3405-000,2018,12,12,24,66,126,192,348
3405-000,2018,12,13,1,21,106,127,192
3405-000,2018,12,13,2,27,70,97,127
3405-000,2018,12,13,3,25,71,96,97
3405-000,2018,12,13,4,21,55,76,96
3405-000,2018,12,13,5,36,121,157,76
3405-000,2018,12,13,6,182,179,361,157
3405-000,2018,12,13,7,449,437,886,361
3405-000,2018,12,13,8,1355,1248,2603,886
3405-000,2018,12,13,9,1489,1338,2827,2603
3405-000,2018,12,13,10,1022,1011,2033,2827
3405-000,2018,12,13,11,889,974,1863,2033
3405-000,2018,12,13,12,829,982,1811,1863
3405-000,2018,12,13,13,691,841,1532,1811
3405-000,2018,12,13,14,820,1042,1862,1532
3405-000,2018,12,13,15,1083,1067,2150,1862
3405-000,2018,12,13,16,1018,998,2016,2150
3405-000,2018,12,13,17,863,958,1821,2016
3405-000,2018,12,13,18,1209,1071,2280,1821
3405-000,2018,12,13,19,1007,917,1924,2280
3405-000,2018,12,13,20,489,576,1065,1924
3405-000,2018,12,13,21,348,500,848,1065
3405-000,2018,12,13,22,189,307,496,848
3405-000,2018,12,13,23,85,224,309,496
3405-000,2018,12,13,24,85,130,215,309
3405-000,2018,12,14,1,42,87,129,215
3405-000,2018,12,14,2,27,67,94,129
3405-000,2018,12,14,3,12,41,53,94
3405-000,2018,12,14,4,15,68,83,53
3405-000,2018,12,14,5,40,128,168,83
3405-000,2018,12,14,6,145,176,321,168
3405-000,2018,12,14,7,440,399,839,321
3405-000,2018,12,14,8,1306,1182,2488,839
3405-000,2018,12,14,9,1540,1283,2823,2488
3405-000,2018,12,14,10,1046,1039,2085,2823
3405-000,2018,12,14,11,986,1049,2035,2085
3405-000,2018,12,14,12,936,998,1934,2035
3405-000,2018,12,14,13,769,965,1734,1934
3405-000,2018,12,14,14,973,1000,1973,1734
3405-000,2018,12,14,15,1068,1097,2165,1973
3405-000,2018,12,14,16,1106,1071,2177,2165
3405-000,2018,12,14,17,1104,1128,2232,2177
3405-000,2018,12,14,18,1768,1323,3091,2232
3405-000,2018,12,14,19,1560,1093,2653,3091
3405-000,2018,12,14,20,765,711,1476,2653
3405-000,2018,12,14,21,474,555,1029,1476
3405-000,2018,12,14,22,262,351,613,1029
3405-000,2018,12,14,23,158,187,345,613
3405-000,2018,12,14,24,73,156,229,345
3405-000,2018,12,15,1,45,94,139,229
3405-000,2018,12,15,2,21,77,98,139
3405-000,2018,12,15,3,21,63,84,98
3405-000,2018,12,15,4,21,57,78,84
3405-000,2018,12,15,5,44,96,140,78
3405-000,2018,12,15,6,118,124,242,140
3405-000,2018,12,15,7,328,294,622,242
3405-000,2018,12,15,8,573,507,1080,622
3405-000,2018,12,15,9,765,644,1409,1080
3405-000,2018,12,15,10,694,669,1363,1409
3405-000,2018,12,15,11,844,793,1637,1363
3405-000,2018,12,15,12,814,752,1566,1637
3405-000,2018,12,15,13,687,728,1415,1566
3405-000,2018,12,15,14,747,685,1432,1415
3405-000,2018,12,15,15,711,771,1482,1432
3405-000,2018,12,15,16,745,818,1563,1482
3405-000,2018,12,15,17,812,833,1645,1563
3405-000,2018,12,15,18,907,822,1729,1645
3405-000,2018,12,15,19,534,606,1140,1729
3405-000,2018,12,15,20,311,431,742,1140
3405-000,2018,12,15,21,206,303,509,742
3405-000,2018,12,15,22,150,247,397,509
3405-000,2018,12,15,23,101,167,268,397
3405-000,2018,12,15,24,57,132,189,268
3405-000,2018,12,16,1,38,83,121,189
3405-000,2018,12,16,2,21,63,84,121
3405-000,2018,12,16,3,12,45,57,84
3405-000,2018,12,16,4,14,45,59,57
3405-000,2018,12,16,5,14,64,78,59
3405-000,2018,12,16,6,40,71,111,78
3405-000,2018,12,16,7,133,134,267,111
3405-000,2018,12,16,8,210,201,411,267
3405-000,2018,12,16,9,255,279,534,411
3405-000,2018,12,16,10,324,340,664,534
3405-000,2018,12,16,11,352,443,795,664
3405-000,2018,12,16,12,367,471,838,795
3405-000,2018,12,16,13,346,504,850,838
3405-000,2018,12,16,14,397,580,977,850
3405-000,2018,12,16,15,481,590,1071,977
3405-000,2018,12,16,16,577,628,1205,1071
3405-000,2018,12,16,17,570,716,1286,1205
3405-000,2018,12,16,18,519,644,1163,1286
3405-000,2018,12,16,19,335,497,832,1163
3405-000,2018,12,16,20,292,389,681,832
3405-000,2018,12,16,21,204,314,518,681
3405-000,2018,12,16,22,148,258,406,518
3405-000,2018,12,16,23,94,195,289,406
3405-000,2018,12,16,24,49,172,221,289
3405-000,2018,12,17,1,25,95,120,221
3405-000,2018,12,17,2,8,64,72,120
3405-000,2018,12,17,3,23,42,65,72
3405-000,2018,12,17,4,21,73,94,65
3405-000,2018,12,17,5,77,129,206,94
3405-000,2018,12,17,6,214,201,415,206
3405-000,2018,12,17,7,640,575,1215,415
3405-000,2018,12,17,8,1345,1465,2810,1215
3405-000,2018,12,17,9,1410,1407,2817,2810
3405-000,2018,12,17,10,1141,990,2131,2817
3405-000,2018,12,17,11,853,1075,1928,2131
3405-000,2018,12,17,12,846,1133,1979,1928
3405-000,2018,12,17,13,664,1045,1709,1979
3405-000,2018,12,17,14,885,1081,1966,1709
3405-000,2018,12,17,15,1016,1057,2073,1966
3405-000,2018,12,17,16,971,1094,2065,2073
3405-000,2018,12,17,17,1037,1108,2145,2065
3405-000,2018,12,17,18,1257,1196,2453,2145
3405-000,2018,12,17,19,1046,1027,2073,2453
3405-000,2018,12,17,20,511,606,1117,2073
3405-000,2018,12,17,21,361,490,851,1117
3405-000,2018,12,17,22,217,344,561,851
3405-000,2018,12,17,23,135,217,352,561
3405-000,2018,12,17,24,72,146,218,352
3405-000,2018,12,18,1,32,76,108,218
3405-000,2018,12,18,2,23,77,100,108
3405-000,2018,12,18,3,12,78,90,100
3405-000,2018,12,18,4,23,86,109,90
3405-000,2018,12,18,5,58,134,192,109
3405-000,2018,12,18,6,191,214,405,192
3405-000,2018,12,18,7,537,498,1035,405
3405-000,2018,12,18,8,1450,1291,2741,1035
3405-000,2018,12,18,9,1545,1397,2942,2741
3405-000,2018,12,18,10,1055,920,1975,2942
3405-000,2018,12,18,11,1012,1018,2030,1975
3405-000,2018,12,18,12,835,1000,1835,2030
3405-000,2018,12,18,13,747,883,1630,1835
3405-000,2018,12,18,14,866,1036,1902,1630
3405-000,2018,12,18,15,967,1103,2070,1902
3405-000,2018,12,18,16,1059,1036,2095,2070
3405-000,2018,12,18,17,1005,1004,2009,2095
3405-000,2018,12,18,18,1315,1134,2449,2009
3405-000,2018,12,18,19,1119,968,2087,2449
3405-000,2018,12,18,20,498,612,1110,2087
3405-000,2018,12,18,21,363,506,869,1110
3405-000,2018,12,18,22,240,348,588,869
3405-000,2018,12,18,23,161,193,354,588
3405-000,2018,12,18,24,75,136,211,354
3405-000,2018,12,19,1,38,123,161,211
3405-000,2018,12,19,2,19,62,81,161
3405-000,2018,12,19,3,8,66,74,81
3405-000,2018,12,19,4,27,81,108,74
3405-000,2018,12,19,5,58,135,193,108
3405-000,2018,12,19,6,178,202,380,193
3405-000,2018,12,19,7,524,472,996,380
3405-000,2018,12,19,8,1398,1262,2660,996
3405-000,2018,12,19,9,1625,1358,2983,2660
3405-000,2018,12,19,10,1009,1011,2020,2983
3405-000,2018,12,19,11,1007,1006,2013,2020
3405-000,2018,12,19,12,885,1025,1910,2013
3405-000,2018,12,19,13,737,845,1582,1910
3405-000,2018,12,19,14,870,1006,1876,1582
3405-000,2018,12,19,15,1063,1060,2123,1876
3405-000,2018,12,19,16,1067,1012,2079,2123
3405-000,2018,12,19,17,945,997,1942,2079
3405-000,2018,12,19,18,1377,1144,2521,1942
3405-000,2018,12,19,19,1169,976,2145,2521
3405-000,2018,12,19,20,509,662,1171,2145
3405-000,2018,12,19,21,318,464,782,1171
3405-000,2018,12,19,22,227,304,531,782
3405-000,2018,12,19,23,118,194,312,531
3405-000,2018,12,19,24,66,146,212,312
3405-000,2018,12,20,1,46,62,108,212
3405-000,2018,12,20,2,23,31,54,108
3405-000,2018,12,20,3,19,58,77,54
3405-000,2018,12,20,4,28,82,110,77
3405-000,2018,12,20,5,45,157,202,110
3405-000,2018,12,20,6,152,170,322,202
3405-000,2018,12,20,7,511,487,998,322
3405-000,2018,12,20,8,1442,1268,2710,998
3405-000,2018,12,20,9,1576,1334,2910,2710
3405-000,2018,12,20,10,1102,1036,2138,2910
3405-000,2018,12,20,11,943,1223,2166,2138
3405-000,2018,12,20,12,967,1239,2206,2166
3405-000,2018,12,20,13,807,1120,1927,2206
3405-000,2018,12,20,14,825,1072,1897,1927
3405-000,2018,12,20,15,1057,1038,2095,1897
3405-000,2018,12,20,16,1061,1054,2115,2095
3405-000,2018,12,20,17,1035,1056,2091,2115
3405-000,2018,12,20,18,1343,1198,2541,2091
3405-000,2018,12,20,19,1067,984,2051,2541
3405-000,2018,12,20,20,490,644,1134,2051
3405-000,2018,12,20,21,348,560,908,1134
3405-000,2018,12,20,22,229,356,585,908
3405-000,2018,12,20,23,128,36,164,585
3405-000,2018,12,20,24,62,25,87,164
3405-000,2018,12,21,1,53,102,155,87
3405-000,2018,12,21,2,27,74,101,155
3405-000,2018,12,21,3,30,51,81,101
3405-000,2018,12,21,4,30,83,113,81
3405-000,2018,12,21,5,45,128,173,113
3405-000,2018,12,21,6,188,183,371,173
3405-000,2018,12,21,7,569,470,1039,371
3405-000,2018,12,21,8,1388,1263,2651,1039
3405-000,2018,12,21,9,1600,1359,2959,2651
3405-000,2018,12,21,10,1029,1039,2068,2959
3405-000,2018,12,21,11,1087,1089,2176,2068
3405-000,2018,12,21,12,943,1046,1989,2176
3405-000,2018,12,21,13,850,946,1796,1989
3405-000,2018,12,21,14,1020,1006,2026,1796
3405-000,2018,12,21,15,1164,1169,2333,2026
3405-000,2018,12,21,16,1188,1120,2308,2333
3405-000,2018,12,21,17,918,1121,2039,2308
3405-000,2018,12,21,18,1304,1234,2538,2039
3405-000,2018,12,21,19,1330,1044,2374,2538
3405-000,2018,12,21,20,605,691,1296,2374
3405-000,2018,12,21,21,420,486,906,1296
3405-000,2018,12,21,22,288,360,648,906
3405-000,2018,12,21,23,155,194,349,648
3405-000,2018,12,21,24,82,156,238,349
3405-000,2018,12,22,1,58,100,158,238
3405-000,2018,12,22,2,42,72,114,158
3405-000,2018,12,22,3,27,66,93,114
3405-000,2018,12,22,4,40,66,106,93
3405-000,2018,12,22,5,40,99,139,106
3405-000,2018,12,22,6,128,127,255,139
3405-000,2018,12,22,7,348,270,618,255
3405-000,2018,12,22,8,560,458,1018,618
3405-000,2018,12,22,9,696,606,1302,1018
3405-000,2018,12,22,10,681,634,1315,1302
3405-000,2018,12,22,11,778,728,1506,1315
3405-000,2018,12,22,12,778,742,1520,1506
3405-000,2018,12,22,13,700,742,1442,1520
3405-000,2018,12,22,14,704,716,1420,1442
3405-000,2018,12,22,15,780,741,1521,1420
3405-000,2018,12,22,16,765,746,1511,1521
3405-000,2018,12,22,17,767,766,1533,1511
3405-000,2018,12,22,18,848,788,1636,1533
3405-000,2018,12,22,19,543,581,1124,1636
3405-000,2018,12,22,20,341,414,755,1124
3405-000,2018,12,22,21,216,278,494,755
3405-000,2018,12,22,22,154,239,393,494
3405-000,2018,12,22,23,96,146,242,393
3405-000,2018,12,22,24,64,136,200,242
3405-000,2018,12,23,1,38,78,116,200
3405-000,2018,12,23,2,40,57,97,116
3405-000,2018,12,23,3,21,39,60,97
3405-000,2018,12,23,4,23,44,67,60
3405-000,2018,12,23,5,17,58,75,67
3405-000,2018,12,23,6,42,62,104,75
3405-000,2018,12,23,7,115,128,243,104
3405-000,2018,12,23,8,214,184,398,243
3405-000,2018,12,23,9,298,252,550,398
3405-000,2018,12,23,10,386,353,739,550
3405-000,2018,12,23,11,470,439,909,739
3405-000,2018,12,23,12,438,470,908,909
3405-000,2018,12,23,13,378,510,888,908
3405-000,2018,12,23,14,438,562,1000,888
3405-000,2018,12,23,15,505,596,1101,1000
3405-000,2018,12,23,16,498,614,1112,1101
3405-000,2018,12,23,17,468,689,1157,1112
3405-000,2018,12,23,18,512,622,1134,1157
3405-000,2018,12,23,19,363,490,853,1134
3405-000,2018,12,23,20,275,374,649,853
3405-000,2018,12,23,21,180,295,475,649
3405-000,2018,12,23,22,176,240,416,475
3405-000,2018,12,23,23,103,184,287,416
3405-000,2018,12,23,24,58,141,199,287
3405-000,2018,12,24,1,34,93,127,199
3405-000,2018,12,24,2,12,50,62,127
3405-000,2018,12,24,3,19,46,65,62
3405-000,2018,12,24,4,19,68,87,65
3405-000,2018,12,24,5,72,106,178,87
3405-000,2018,12,24,6,159,159,318,178
3405-000,2018,12,24,7,575,494,1069,318
3405-000,2018,12,24,8,1280,1199,2479,1069
3405-000,2018,12,24,9,1280,1134,2414,2479
3405-000,2018,12,24,10,827,869,1696,2414
3405-000,2018,12,24,11,857,946,1803,1696
3405-000,2018,12,24,12,872,942,1814,1803
3405-000,2018,12,24,13,735,893,1628,1814
3405-000,2018,12,24,14,876,956,1832,1628
3405-000,2018,12,24,15,904,1072,1976,1832
3405-000,2018,12,24,16,930,1074,2004,1976
3405-000,2018,12,24,17,962,1077,2039,2004
3405-000,2018,12,24,18,1310,1198,2508,2039
3405-000,2018,12,24,19,1255,1046,2301,2508
3405-000,2018,12,24,20,556,628,1184,2301
3405-000,2018,12,24,21,373,512,885,1184
3405-000,2018,12,24,22,214,278,492,885
3405-000,2018,12,24,23,150,206,356,492
3405-000,2018,12,24,24,49,111,160,356
3405-000,2018,12,25,1,45,96,141,160
3405-000,2018,12,25,2,27,54,81,141
3405-000,2018,12,25,3,19,54,73,81
3405-000,2018,12,25,4,21,71,92,73
3405-000,2018,12,25,5,29,103,132,92
3405-000,2018,12,25,6,103,115,218,132
3405-000,2018,12,25,7,208,207,415,218
3405-000,2018,12,25,8,404,338,742,415
3405-000,2018,12,25,9,386,431,817,742
3405-000,2018,12,25,10,429,460,889,817
3405-000,2018,12,25,11,526,476,1002,889
3405-000,2018,12,25,12,418,477,895,1002
3405-000,2018,12,25,13,455,541,996,895
3405-000,2018,12,25,14,485,638,1123,996
3405-000,2018,12,25,15,470,589,1059,1123
3405-000,2018,12,25,16,549,647,1196,1059
3405-000,2018,12,25,17,552,662,1214,1196
3405-000,2018,12,25,18,504,677,1181,1214
3405-000,2018,12,25,19,373,523,896,1181
3405-000,2018,12,25,20,275,363,638,896
3405-000,2018,12,25,21,208,295,503,638
3405-000,2018,12,25,22,137,275,412,503
3405-000,2018,12,25,23,87,225,312,412
3405-000,2018,12,25,24,60,138,198,312
3405-000,2018,12,26,1,27,105,132,198
3405-000,2018,12,26,2,14,41,55,132
3405-000,2018,12,26,3,15,37,52,55
3405-000,2018,12,26,4,25,67,92,52
3405-000,2018,12,26,5,40,128,168,92
3405-000,2018,12,26,6,173,205,378,168
3405-000,2018,12,26,7,563,518,1081,378
3405-000,2018,12,26,8,1547,1396,2943,1081
3405-000,2018,12,26,9,1519,1392,2911,2943
3405-000,2018,12,26,10,951,990,1941,2911
3405-000,2018,12,26,11,975,1040,2015,1941
3405-000,2018,12,26,12,848,995,1843,2015
3405-000,2018,12,26,13,687,841,1528,1843
3405-000,2018,12,26,14,945,1039,1984,1528
3405-000,2018,12,26,15,1081,1177,2258,1984
3405-000,2018,12,26,16,1087,1049,2136,2258
3405-000,2018,12,26,17,868,1124,1992,2136
3405-000,2018,12,26,18,1248,1184,2432,1992
3405-000,2018,12,26,19,1134,1038,2172,2432
3405-000,2018,12,26,20,545,571,1116,2172
3405-000,2018,12,26,21,305,447,752,1116
3405-000,2018,12,26,22,202,320,522,752
3405-000,2018,12,26,23,128,220,348,522
3405-000,2018,12,26,24,85,146,231,348
3405-000,2018,12,27,1,36,99,135,231
3405-000,2018,12,27,2,30,61,91,135
3405-000,2018,12,27,3,12,78,90,91
3405-000,2018,12,27,4,19,63,82,90
3405-000,2018,12,27,5,38,146,184,82
3405-000,2018,12,27,6,111,194,305,184
3405-000,2018,12,27,7,526,390,916,305
3405-000,2018,12,27,8,1343,1230,2573,916
3405-000,2018,12,27,9,1454,1228,2682,2573
3405-000,2018,12,27,10,999,912,1911,2682
3405-000,2018,12,27,11,846,1043,1889,1911
3405-000,2018,12,27,12,827,960,1787,1889
3405-000,2018,12,27,13,700,878,1578,1787
3405-000,2018,12,27,14,855,1001,1856,1578
3405-000,2018,12,27,15,876,1094,1970,1856
3405-000,2018,12,27,16,984,1059,2043,1970
3405-000,2018,12,27,17,977,1011,1988,2043
3405-000,2018,12,27,18,1068,1125,2193,1988
3405-000,2018,12,27,19,1074,983,2057,2193
3405-000,2018,12,27,20,496,603,1099,2057
3405-000,2018,12,27,21,369,504,873,1099
3405-000,2018,12,27,22,244,341,585,873
3405-000,2018,12,27,23,116,212,328,585
3405-000,2018,12,27,24,53,141,194,328
3405-000,2018,12,28,1,36,116,152,194
3405-000,2018,12,28,2,21,82,103,152
3405-000,2018,12,28,3,10,53,63,103
3405-000,2018,12,28,4,29,70,99,63
3405-000,2018,12,28,5,30,105,135,99
3405-000,2018,12,28,6,133,160,293,135
3405-000,2018,12,28,7,461,387,848,293
3405-000,2018,12,28,8,1317,1103,2420,848
3405-000,2018,12,28,9,1358,1208,2566,2420
3405-000,2018,12,28,10,913,919,1832,2566
3405-000,2018,12,28,11,840,982,1822,1832
3405-000,2018,12,28,12,739,910,1649,1822
3405-000,2018,12,28,13,760,798,1558,1649
3405-000,2018,12,28,14,932,974,1906,1558
3405-000,2018,12,28,15,966,991,1957,1906
3405-000,2018,12,28,16,1042,1027,2069,1957
3405-000,2018,12,28,17,1093,1114,2207,2069
3405-000,2018,12,28,18,1533,1145,2678,2207
3405-000,2018,12,28,19,1285,994,2279,2678
3405-000,2018,12,28,20,616,671,1287,2279
3405-000,2018,12,28,21,367,417,784,1287
3405-000,2018,12,28,22,315,368,683,784
3405-000,2018,12,28,23,152,200,352,683
3405-000,2018,12,28,24,90,155,245,352
3405-000,2018,12,29,1,62,107,169,245
3405-000,2018,12,29,2,29,66,95,169
3405-000,2018,12,29,3,29,68,97,95
3405-000,2018,12,29,4,29,76,105,97
3405-000,2018,12,29,5,38,102,140,105
3405-000,2018,12,29,6,77,130,207,140
3405-000,2018,12,29,7,294,246,540,207
3405-000,2018,12,29,8,547,408,955,540
3405-000,2018,12,29,9,627,569,1196,955
3405-000,2018,12,29,10,668,599,1267,1196
3405-000,2018,12,29,11,713,662,1375,1267
3405-000,2018,12,29,12,741,732,1473,1375
3405-000,2018,12,29,13,760,755,1515,1473
3405-000,2018,12,29,14,655,746,1401,1515
3405-000,2018,12,29,15,732,711,1443,1401
3405-000,2018,12,29,16,664,675,1339,1443
3405-000,2018,12,29,17,649,699,1348,1339
3405-000,2018,12,29,18,776,754,1530,1348
3405-000,2018,12,29,19,511,556,1067,1530
3405-000,2018,12,29,20,255,396,651,1067
3405-000,2018,12,29,21,191,252,443,651
3405-000,2018,12,29,22,150,231,381,443
3405-000,2018,12,29,23,103,125,228,381
3405-000,2018,12,29,24,40,140,180,228
3405-000,2018,12,30,1,32,73,105,180
3405-000,2018,12,30,2,21,51,72,105
3405-000,2018,12,30,3,12,33,45,72
3405-000,2018,12,30,4,19,42,61,45
3405-000,2018,12,30,5,19,52,71,61
3405-000,2018,12,30,6,47,54,101,71
3405-000,2018,12,30,7,83,123,206,101
3405-000,2018,12,30,8,210,168,378,206
3405-000,2018,12,30,9,204,226,430,378
3405-000,2018,12,30,10,320,366,686,430
3405-000,2018,12,30,11,380,435,815,686
3405-000,2018,12,30,12,410,468,878,815
3405-000,2018,12,30,13,378,517,895,878
3405-000,2018,12,30,14,391,543,934,895
3405-000,2018,12,30,15,431,601,1032,934
3405-000,2018,12,30,16,522,599,1121,1032
3405-000,2018,12,30,17,557,662,1219,1121
3405-000,2018,12,30,18,419,601,1020,1219
3405-000,2018,12,30,19,404,483,887,1020
3405-000,2018,12,30,20,229,358,587,887
3405-000,2018,12,30,21,217,276,493,587
3405-000,2018,12,30,22,128,223,351,493
3405-000,2018,12,30,23,115,172,287,351
3405-000,2018,12,30,24,72,110,182,287
3405-000,2018,12,31,1,17,91,108,182
3405-000,2018,12,31,2,19,35,54,108
3405-000,2018,12,31,3,8,50,58,54
3405-000,2018,12,31,4,10,62,72,58
3405-000,2018,12,31,5,32,82,114,72
3405-000,2018,12,31,6,92,139,231,114
3405-000,2018,12,31,7,322,312,634,231
3405-000,2018,12,31,8,902,809,1711,634
3405-000,2018,12,31,9,911,818,1729,1711
3405-000,2018,12,31,10,653,649,1302,1729
3405-000,2018,12,31,11,692,777,1469,1302
3405-000,2018,12,31,12,732,813,1545,1469
3405-000,2018,12,31,13,644,677,1321,1545
3405-000,2018,12,31,14,668,517,1185,1321
3405-000,2018,12,31,15,779,813,1592,1185
3405-000,2018,12,31,16,909,859,1768,1592
3405-000,2018,12,31,17,876,906,1782,1768
3405-000,2018,12,31,18,1011,866,1877,1782
3405-000,2018,12,31,19,792,799,1591,1877
3405-000,2018,12,31,20,455,493,948,1591
3405-000,2018,12,31,21,257,342,599,948
3405-000,2018,12,31,22,195,249,444,599
3405-000,2018,12,31,23,150,179,329,444
3405-000,2018,12,31,24,60,109,169,329
